,Unnamed: 0,level,page_num,block_num,par_num,line_num,word_num,left,top,width,height,conf,text,x,y,label,target,right,bottom
0,0,1,1,0,0,0,0,0,0,1653,2328,-1,,0.125,0.5,,,1653,2328
1,1,2,1,1,0,0,0,144,1905,31,328,-1,,0.02412280701754386,0.8887457044673539,,,175,2233
2,2,3,1,1,1,0,0,144,1905,31,328,-1,,0.02412280701754386,0.8887457044673539,,,175,2233
3,3,4,1,1,1,1,0,144,1905,31,328,-1,,0.02412280701754386,0.8887457044673539,,,175,2233
4,4,5,1,1,1,1,1,144,2179,30,54,96,EP,0.024047186932849365,0.947594501718213,,,174,2233
5,5,5,1,1,1,1,2,144,2142,31,21,95,3,0.02412280701754386,0.9246134020618557,,,175,2163
6,6,5,1,1,1,1,3,144,2055,31,71,95,388,0.02412280701754386,0.8979810996563574,,,175,2126
7,7,5,1,1,1,1,4,144,1974,30,64,92,171,0.024047186932849365,0.8616838487972509,,,174,2038
8,8,5,1,1,1,1,5,144,1905,30,50,87,A1,0.024047186932849365,0.8290378006872853,,,174,1955
9,9,2,1,2,0,0,0,429,153,88,28,-1,,0.07153660012099214,0.07173539518900343,,,517,181
10,10,3,1,2,1,0,0,429,153,88,28,-1,,0.07153660012099214,0.07173539518900343,,,517,181
11,11,4,1,2,1,1,0,429,153,88,16,-1,,0.07153660012099214,0.06915807560137457,,,517,169
12,12,5,1,2,1,1,1,429,153,88,16,84,Europaisches,0.07153660012099214,0.06915807560137457,,,517,169
13,13,4,1,2,1,2,0,429,170,71,11,-1,,0.07025105868118572,0.07538659793814433,,,500,181
14,14,5,1,2,1,2,1,429,170,71,11,96,Patentamt,0.07025105868118572,0.07538659793814433,,,500,181
15,15,2,1,3,0,0,0,429,196,89,28,-1,,0.07161222020568662,0.09020618556701031,,,518,224
16,16,3,1,3,1,0,0,429,196,89,28,-1,,0.07161222020568662,0.09020618556701031,,,518,224
17,17,4,1,3,1,1,0,429,196,63,15,-1,,0.06964609800362977,0.08741408934707903,,,492,211
18,18,5,1,3,1,1,1,429,196,63,15,95,European,0.06964609800362977,0.08741408934707903,,,492,211
19,19,4,1,3,1,2,0,429,212,89,12,-1,,0.07161222020568662,0.0936426116838488,,,518,224
20,20,5,1,3,1,2,1,429,213,43,11,96,Patent,0.06813369630973987,0.0938573883161512,,,472,224
21,21,5,1,3,1,2,2,478,212,40,12,90,Office,0.07531760435571688,0.0936426116838488,,,518,224
22,22,2,1,4,0,0,0,429,239,109,28,-1,,0.07312462189957653,0.10867697594501718,,,538,267
23,23,3,1,4,1,0,0,429,239,109,28,-1,,0.07312462189957653,0.10867697594501718,,,538,267
24,24,4,1,4,1,1,0,429,239,109,15,-1,,0.07312462189957653,0.10588487972508591,,,538,254
25,25,5,1,4,1,1,1,429,239,40,12,93,Office,0.06790683605565638,0.1052405498281787,,,469,251
26,26,5,1,4,1,1,2,474,239,64,15,93,europ√©en,0.0765275257108288,0.10588487972508591,,,538,254
27,27,4,1,4,1,2,0,429,255,77,12,-1,,0.0707047791893527,0.11211340206185567,,,506,267
28,28,5,1,4,1,2,1,429,255,22,12,95,des,0.06654567453115548,0.11211340206185567,,,451,267
29,29,5,1,4,1,2,2,457,255,49,12,82,brevets,0.07282214156079855,0.11211340206185567,,,506,267
30,30,2,1,5,0,0,0,281,136,274,150,-1,,0.06321839080459771,0.09063573883161512,,,555,286
31,31,3,1,5,1,0,0,281,136,274,150,-1,,0.06321839080459771,0.09063573883161512,,,555,286
32,32,4,1,5,1,1,0,281,136,274,150,-1,,0.06321839080459771,0.09063573883161512,,,555,286
33,33,5,1,5,1,1,1,281,136,274,150,95, ,0.06321839080459771,0.09063573883161512,,,555,286
34,34,2,1,6,0,0,0,225,324,45,26,-1,,0.037431941923774956,0.14475945017182132,,,270,350
35,35,3,1,6,1,0,0,225,324,45,26,-1,,0.037431941923774956,0.14475945017182132,,,270,350
36,36,4,1,6,1,1,0,225,324,45,26,-1,,0.037431941923774956,0.14475945017182132,,,270,350
37,37,5,1,6,1,1,1,225,324,45,26,96,(12),0.037431941923774956,0.14475945017182132,,,270,350
38,38,2,1,7,0,0,0,225,395,415,53,-1,,0.06541137326073805,0.18105670103092783,,,640,448
39,39,3,1,7,1,0,0,225,395,415,53,-1,,0.06541137326073805,0.18105670103092783,,,640,448
40,40,4,1,7,1,1,0,225,395,282,26,-1,,0.05535390199637023,0.17525773195876287,,,507,421
41,41,5,1,7,1,1,1,225,395,45,26,92,(43),0.037431941923774956,0.17525773195876287,,,270,421
42,42,5,1,7,1,1,2,285,397,222,23,90,Verdffentlichungstag:,0.05989110707803993,0.17547250859106528,,,507,420
43,43,4,1,7,1,2,0,287,430,353,18,-1,,0.07009981851179674,0.18857388316151202,,,640,448
44,44,5,1,7,1,2,1,287,430,116,18,92,17.10.2018,0.052177858439201454,0.18857388316151202,publication_date,17.10.2018,403,448
45,45,5,1,7,1,2,2,426,430,121,18,92,Patentblatt,0.0735783424077435,0.18857388316151202,,,547,448
46,46,5,1,7,1,2,3,555,430,85,18,96,2018/42,0.09036600120992136,0.18857388316151202,,,640,448
47,47,2,1,8,0,0,0,225,493,379,26,-1,,0.06268905021173624,0.21735395189003437,,,604,519
48,48,3,1,8,1,0,0,225,493,379,26,-1,,0.06268905021173624,0.21735395189003437,,,604,519
49,49,4,1,8,1,1,0,225,493,379,26,-1,,0.06268905021173624,0.21735395189003437,,,604,519
50,50,5,1,8,1,1,1,225,493,45,26,91,(21),0.037431941923774956,0.21735395189003437,,,270,519
51,51,5,1,8,1,1,2,285,495,186,18,91,Anmeldenummer:,0.05716878402903811,0.21649484536082475,,,471,513
52,52,5,1,8,1,1,3,481,495,123,18,92,18164168.9,0.08204779189352691,0.21649484536082475,application_number,18164168.9,604,513
53,53,2,1,9,0,0,0,225,559,319,26,-1,,0.05815184513006655,0.24570446735395188,,,544,585
54,54,3,1,9,1,0,0,225,559,319,26,-1,,0.05815184513006655,0.24570446735395188,,,544,585
55,55,4,1,9,1,1,0,225,559,319,26,-1,,0.05815184513006655,0.24570446735395188,,,544,585
56,56,5,1,9,1,1,1,225,559,45,26,93,(22),0.037431941923774956,0.24570446735395188,,,270,585
57,57,5,1,9,1,1,2,285,561,131,23,92,Anmeldetag:,0.0530096793708409,0.24591924398625428,,,416,584
58,58,5,1,9,1,1,3,426,561,118,18,96,27.03.2018,0.07335148215366001,0.24484536082474226,filing_date,27.03.2018,544,579
59,59,2,1,10,0,0,0,1002,245,458,38,-1,,0.18617664851784635,0.1134020618556701,,,1460,283
60,60,3,1,10,1,0,0,1002,245,458,38,-1,,0.18617664851784635,0.1134020618556701,,,1460,283
61,61,4,1,10,1,1,0,1002,245,458,38,-1,,0.18617664851784635,0.1134020618556701,,,1460,283
62,62,5,1,10,1,1,1,1002,256,44,27,74,(11),0.15486993345432548,0.11576460481099657,,,1046,283
63,63,5,1,10,1,1,2,1146,245,52,32,94,EP,0.17725347852389595,0.11211340206185567,number,EP,1198,277
64,64,5,1,10,1,1,3,1214,245,20,32,94,3,0.1851179673321234,0.11211340206185567,number,3,1234,277
65,65,5,1,10,1,1,4,1249,245,68,32,95,388,0.1940411373260738,0.11211340206185567,number,388,1317,277
66,66,5,1,10,1,1,5,1333,245,61,32,86,171,0.20621597096188748,0.11211340206185567,number,171,1394,277
67,67,5,1,10,1,1,6,1413,245,47,32,86,A1,0.21725650332728372,0.11211340206185567,number,A1,1460,277
68,68,2,1,11,0,0,0,559,314,573,31,-1,,0.1278735632183908,0.14153780068728522,,,1132,345
69,69,3,1,11,1,0,0,559,314,573,31,-1,,0.1278735632183908,0.14153780068728522,,,1132,345
70,70,4,1,11,1,1,0,559,314,573,31,-1,,0.1278735632183908,0.14153780068728522,,,1132,345
71,71,5,1,11,1,1,1,559,314,230,31,92,EUROPAISCHE,0.10193587416817906,0.14153780068728522,,,789,345
72,72,5,1,11,1,1,2,802,319,330,26,91,PATENTANMELDUNG,0.14624924379915305,0.14261168384879724,,,1132,345
73,73,2,1,12,0,0,0,862,395,543,173,-1,,0.17143073200241984,0.20682989690721648,,,1405,568
74,74,3,1,12,1,0,0,862,395,543,173,-1,,0.17143073200241984,0.20682989690721648,,,1405,568
75,75,4,1,12,1,1,0,862,395,126,26,-1,,0.13989715668481548,0.17525773195876287,,,988,421
76,76,5,1,12,1,1,1,862,395,44,26,93,(51),0.1336963097398669,0.17525773195876287,,,906,421
77,77,5,1,12,1,1,2,923,397,25,18,93,Int,0.1414851784633999,0.17439862542955326,,,948,415
78,78,5,1,12,1,1,3,955,397,33,18,78,Cl:,0.14692982456140352,0.17439862542955326,,,988,415
79,79,4,1,12,1,2,0,922,425,468,21,-1,,0.17483363581367212,0.1870704467353952,,,1390,446
80,80,5,1,12,1,2,1,922,428,59,18,89,B22F,0.14390502117362372,0.1877147766323024,class_international,B22F,981,446
81,81,5,1,12,1,2,2,987,428,46,18,73,3/24,0.15275257108287962,0.1877147766323024,class_international,3/24,1033,446
82,82,5,1,12,1,2,3,1038,425,67,16,67,(2006.01),0.16205384150030247,0.18599656357388317,,,1105,441
83,83,5,1,12,1,2,4,1193,428,59,18,89,B22F,0.18489110707803993,0.1877147766323024,,,1252,446
84,84,5,1,12,1,2,5,1258,428,59,18,88,31105,0.19472171808832425,0.1877147766323024,,,1317,446
85,85,5,1,12,1,2,6,1323,425,67,16,83,(2006.01),0.20515728977616454,0.18599656357388317,,,1390,441
86,86,4,1,12,1,3,0,922,455,469,21,-1,,0.17490925589836662,0.19995704467353953,,,1391,476
87,87,5,1,12,1,3,1,922,458,61,18,91,B33Y,0.1440562613430127,0.20060137457044674,,,983,476
88,88,5,1,12,1,3,2,991,458,57,18,87,10100,0.154189352692075,0.20060137457044674,,,1048,476
89,89,5,1,12,1,3,3,1052,455,67,16,58,(2015.9),0.16417120387174833,0.19888316151202748,,,1119,471
90,90,5,1,12,1,3,4,1193,458,61,18,92,B33Y,0.1850423472474289,0.20060137457044674,,,1254,476
91,91,5,1,12,1,3,5,1260,458,59,18,74,30/00,0.19502419842710225,0.20060137457044674,,,1319,476
92,92,5,1,12,1,3,6,1324,455,67,16,58,2015-01),0.20530852994555354,0.19888316151202748,,,1391,471
93,93,4,1,12,1,4,0,922,486,483,21,-1,,0.17596793708408953,0.21327319587628865,,,1405,507
94,94,5,1,12,1,4,1,922,488,61,19,91,B33Y,0.1440562613430127,0.21370274914089346,,,983,507
95,95,5,1,12,1,4,2,989,488,59,19,86,50102,0.15403811252268604,0.21370274914089346,,,1048,507
96,96,5,1,12,1,4,3,1052,486,67,15,60,(2015.01),0.16417120387174833,0.21198453608247422,,,1119,501
97,97,5,1,12,1,4,4,1193,488,61,19,92,B23K,0.1850423472474289,0.21370274914089346,,,1254,507
98,98,5,1,12,1,4,5,1261,488,59,19,80,261342,0.19517543859649122,0.21370274914089346,,,1320,507
99,99,5,1,12,1,4,6,1321,486,84,21,80,(2014.91),0.20614035087719298,0.21327319587628865,,,1405,507
100,100,4,1,12,1,5,0,922,516,483,21,-1,,0.17596793708408953,0.226159793814433,,,1405,537
101,101,5,1,12,1,5,1,922,519,60,18,92,B29C,0.14398064125831822,0.2268041237113402,,,982,537
102,102,5,1,12,1,5,2,991,519,58,18,66,641393,0.1542649727767695,0.2268041237113402,,,1049,537
103,103,5,1,12,1,5,3,1050,516,84,21,86,(2017.01),0.16515426497277677,0.226159793814433,,,1134,537
104,104,5,1,12,1,5,4,1193,519,60,18,92,B29C,0.18496672716273443,0.2268041237113402,,,1253,537
105,105,5,1,12,1,5,5,1262,519,71,18,81,64/118,0.19623411978221417,0.2268041237113402,,,1333,537
106,106,5,1,12,1,5,6,1338,516,67,16,81,(2017.01),0.2074258923169994,0.22508591065292097,,,1405,532
107,107,4,1,12,1,6,0,923,547,468,21,-1,,0.1749848759830611,0.23947594501718214,,,1391,568
108,108,5,1,12,1,6,1,923,550,60,18,86,GO5B,0.1441318814277072,0.24012027491408935,,,983,568
109,109,5,1,12,1,6,2,993,550,84,18,85,19/4097,0.15653357531760437,0.24012027491408935,,,1077,568
110,110,5,1,12,1,6,3,1082,547,66,16,45,299501),0.16863278886872354,0.23840206185567012,,,1148,563
111,111,5,1,12,1,6,4,0,0,1653,2328,45,=,0.125,0.5,,,1653,2328
112,112,5,1,12,1,6,5,1194,550,60,18,41,GOGF,0.1851179673321234,0.24012027491408935,,,1254,568
113,113,5,1,12,1,6,6,1262,550,57,18,90,17/50,0.19517543859649122,0.24012027491408935,,,1319,568
114,114,5,1,12,1,6,7,1324,547,67,16,67,(2006.01),0.20530852994555354,0.23840206185567012,,,1391,563
115,115,2,1,13,0,0,0,224,613,1243,4,-1,,0.1278735632183908,0.26417525773195877,,,1467,617
116,116,3,1,13,1,0,0,224,613,1243,4,-1,,0.1278735632183908,0.26417525773195877,,,1467,617
117,117,4,1,13,1,1,0,224,613,1243,4,-1,,0.1278735632183908,0.26417525773195877,,,1467,617
118,118,5,1,13,1,1,1,224,613,1243,4,95, ,0.1278735632183908,0.26417525773195877,,,1467,617
119,119,2,1,14,0,0,0,225,631,599,250,-1,,0.07932546884452511,0.3247422680412371,,,824,881
120,120,3,1,14,1,0,0,225,631,599,250,-1,,0.07932546884452511,0.3247422680412371,,,824,881
121,121,4,1,14,1,1,0,225,631,342,27,-1,,0.05989110707803993,0.2768470790378007,,,567,658
122,122,5,1,14,1,1,1,225,631,45,27,93,(84),0.037431941923774956,0.2768470790378007,,,270,658
123,123,5,1,14,1,1,2,286,633,100,19,93,Benannte,0.050816696914700546,0.2759879725085911,,,386,652
124,124,5,1,14,1,1,3,393,633,174,23,92,Vertragsstaaten:,0.07259528130671507,0.2768470790378007,,,567,656
125,125,4,1,14,1,2,0,285,666,537,18,-1,,0.08371143375680581,0.28994845360824745,,,822,684
126,126,5,1,14,1,2,1,285,666,31,18,94,AL,0.04544767090139141,0.28994845360824745,,,316,684
127,127,5,1,14,1,2,2,323,666,31,18,94,AT,0.05119479733817302,0.28994845360824745,,,354,684
128,128,5,1,14,1,2,3,363,666,30,18,95,BE,0.05716878402903811,0.28994845360824745,,,393,684
129,129,5,1,14,1,2,4,403,666,32,18,95,BG,0.0633696309739867,0.28994845360824745,,,435,684
130,130,5,1,14,1,2,5,445,666,31,18,95,CH,0.06964609800362977,0.28994845360824745,,,476,684
131,131,5,1,14,1,2,6,486,666,32,18,96,CY,0.07592256503327284,0.28994845360824745,,,518,684
132,132,5,1,14,1,2,7,526,666,30,18,96,CZ,0.08182093163944344,0.28994845360824745,,,556,684
133,133,5,1,14,1,2,8,565,666,30,18,96,DE,0.08771929824561403,0.28994845360824745,,,595,684
134,134,5,1,14,1,2,9,605,666,32,18,93,DK,0.09392014519056262,0.28994845360824745,,,637,684
135,135,5,1,14,1,2,10,646,666,29,18,93,EE,0.0998941318814277,0.28994845360824745,,,675,684
136,136,5,1,14,1,2,11,684,666,29,18,93,ES,0.10564125831820932,0.28994845360824745,,,713,684
137,137,5,1,14,1,2,12,723,666,99,18,86,FIFRGB,0.11683303085299455,0.28994845360824745,,,822,684
138,138,4,1,14,1,3,0,285,699,539,18,-1,,0.0838626739261948,0.30412371134020616,,,824,717
139,139,5,1,14,1,3,1,285,699,35,18,94,GR,0.04575015124016939,0.30412371134020616,,,320,717
140,140,5,1,14,1,3,2,328,699,32,18,94,HR,0.05202661826981246,0.30412371134020616,,,360,717
141,141,5,1,14,1,3,3,368,699,14,18,41,HU,0.05671506352087114,0.30412371134020616,,,382,717
142,142,5,1,14,1,3,4,385,699,43,18,41,IE,0.06147912885662432,0.30412371134020616,,,428,717
143,143,5,1,14,1,3,5,436,699,20,18,47,IS,0.06745311554748941,0.30412371134020616,,,456,717
144,144,5,1,14,1,3,6,464,699,20,18,47,IT,0.07168784029038112,0.30412371134020616,,,484,717
145,145,5,1,14,1,3,7,492,699,54,18,83,LILT,0.07849364791288566,0.30412371134020616,,,546,717
146,146,5,1,14,1,3,8,554,699,28,18,75,LU,0.08590441621294616,0.30412371134020616,,,582,717
147,147,5,1,14,1,3,9,591,699,28,18,75,LV,0.09150030248033877,0.30412371134020616,,,619,717
148,148,5,1,14,1,3,10,627,699,35,18,95,MC,0.09747428917120388,0.30412371134020616,,,662,717
149,149,5,1,14,1,3,11,670,699,35,18,94,MK,0.10397761645493044,0.30412371134020616,,,705,717
150,150,5,1,14,1,3,12,713,699,32,18,93,MT,0.11025408348457351,0.30412371134020616,,,745,717
151,151,5,1,14,1,3,13,753,699,29,18,20,NL,0.11607683000604961,0.30412371134020616,,,782,717
152,152,5,1,14,1,3,14,791,699,33,18,20,NO,0.1221264367816092,0.30412371134020616,,,824,717
153,153,4,1,14,1,4,0,286,732,336,18,-1,,0.06866303690260134,0.31829896907216493,,,622,750
154,154,5,1,14,1,4,1,286,732,28,18,95,PL,0.045372050816696916,0.31829896907216493,,,314,750
155,155,5,1,14,1,4,2,323,732,29,18,92,PT,0.05104355716878403,0.31829896907216493,,,352,750
156,156,5,1,14,1,4,3,360,732,58,18,92,RORS,0.058832425892317,0.31829896907216493,,,418,750
157,157,5,1,14,1,4,4,420,732,52,18,96,SE,0.06745311554748941,0.31829896907216493,,,472,750
158,158,5,1,14,1,4,5,480,732,20,18,91,SI,0.07410768300060495,0.31829896907216493,,,500,750
159,159,5,1,14,1,4,6,510,732,31,18,91,SK,0.0794767090139141,0.31829896907216493,,,541,750
160,160,5,1,14,1,4,7,550,732,72,18,91,SMTR,0.08862673926194797,0.31829896907216493,,,622,750
161,161,4,1,14,1,5,0,286,765,330,23,-1,,0.06820931639443437,0.3335481099656357,,,616,788
162,162,5,1,14,1,5,1,286,765,100,18,92,Benannte,0.050816696914700546,0.3324742268041237,,,386,783
163,163,5,1,14,1,5,2,395,765,221,23,91,Erstreckungsstaaten:,0.0764519056261343,0.3335481099656357,,,616,788
164,164,4,1,14,1,6,0,286,797,74,19,-1,,0.04885057471264368,0.34643470790378006,,,360,816
165,165,5,1,14,1,6,1,286,797,33,19,96,BA,0.04575015124016939,0.34643470790378006,,,319,816
166,166,5,1,14,1,6,2,327,797,33,19,96,ME,0.05195099818511797,0.34643470790378006,,,360,816
167,167,4,1,14,1,7,0,286,830,322,23,-1,,0.06760435571687841,0.36146907216494845,,,608,853
168,168,5,1,14,1,7,1,286,830,100,18,92,Benannte,0.050816696914700546,0.3603951890034364,,,386,848
169,169,5,1,14,1,7,2,393,830,215,23,92,Validierungsstaaten:,0.07569570477918935,0.36146907216494845,,,608,853
170,170,4,1,14,1,8,0,286,863,157,18,-1,,0.055127041742286755,0.3745704467353952,,,443,881
171,171,5,1,14,1,8,1,286,863,31,18,95,KH,0.0455989110707804,0.3745704467353952,,,317,881
172,172,5,1,14,1,8,2,327,863,35,18,96,MA,0.052102238354506954,0.3745704467353952,,,362,881
173,173,5,1,14,1,8,3,371,863,34,18,95,MD,0.05868118572292801,0.3745704467353952,,,405,881
174,174,5,1,14,1,8,4,413,863,30,18,95,TN,0.0647307924984876,0.3745704467353952,,,443,881
175,175,2,1,15,0,0,0,225,927,488,26,-1,,0.07093163944343618,0.40378006872852235,,,713,953
176,176,3,1,15,1,0,0,225,927,488,26,-1,,0.07093163944343618,0.40378006872852235,,,713,953
177,177,4,1,15,1,1,0,225,927,488,26,-1,,0.07093163944343618,0.40378006872852235,,,713,953
178,178,5,1,15,1,1,1,225,927,45,26,92,(30),0.037431941923774956,0.40378006872852235,,,270,953
179,179,5,1,15,1,1,2,286,929,86,18,65,Prioritat:,0.04975801572897762,0.4029209621993127,,,372,947
180,180,5,1,15,1,1,3,384,929,117,18,95,13.04.2017,0.06692377495462795,0.4029209621993127,priority_date_eu,13.04.2017,501,947
181,181,5,1,15,1,1,4,520,929,30,18,95,DE,0.0809134906231095,0.4029209621993127,,,550,947
182,182,5,1,15,1,1,5,559,929,154,18,96,102017108031,0.09618874773139746,0.4029209621993127,,,713,947
183,183,2,1,16,0,0,0,225,992,381,58,-1,,0.06284029038112522,0.438573883161512,,,606,1050
184,184,3,1,16,1,0,0,225,992,381,58,-1,,0.06284029038112522,0.438573883161512,,,606,1050
185,185,4,1,16,1,1,0,225,992,381,26,-1,,0.06284029038112522,0.43170103092783507,,,606,1018
186,186,5,1,16,1,1,1,225,992,45,26,93,(71),0.037431941923774956,0.43170103092783507,,,270,1018
187,187,5,1,16,1,1,2,285,994,106,18,89,Anmelder:,0.051119177253478525,0.43084192439862545,,,391,1012
188,188,5,1,16,1,1,3,401,994,128,18,91,GEFERTEC,0.07032667876588022,0.43084192439862545,applicant_line_1,GEFERTEC,529,1012
189,189,5,1,16,1,1,4,537,994,69,18,95,GmbH,0.08643375680580763,0.43084192439862545,applicant_line_1,GmbH,606,1012
190,190,4,1,16,1,2,0,286,1027,193,23,-1,,0.05784936479128856,0.44609106529209624,,,479,1050
191,191,5,1,16,1,2,1,286,1027,61,18,92,12681,0.047867513611615245,0.44501718213058417,,,347,1045
192,192,5,1,16,1,2,2,359,1027,64,18,96,Berlin,0.05913490623109498,0.44501718213058417,,,423,1045
193,193,5,1,16,1,2,3,433,1027,46,23,96,(DE),0.06896551724137931,0.44609106529209624,,,479,1050
194,194,2,1,17,0,0,0,844,614,4,468,-1,,0.1279491833030853,0.3642611683848797,,,848,1082
195,195,3,1,17,1,0,0,844,614,4,468,-1,,0.1279491833030853,0.3642611683848797,,,848,1082
196,196,4,1,17,1,1,0,844,614,4,468,-1,,0.1279491833030853,0.3642611683848797,,,848,1082
197,197,5,1,17,1,1,1,844,614,4,468,95, ,0.1279491833030853,0.3642611683848797,,,848,1082
198,198,2,1,18,0,0,0,862,631,372,222,-1,,0.15849969751966123,0.31872852233676974,,,1234,853
199,199,3,1,18,1,0,0,862,631,372,222,-1,,0.15849969751966123,0.31872852233676974,,,1234,853
200,200,4,1,18,1,1,0,862,631,147,27,-1,,0.1414851784633999,0.2768470790378007,,,1009,658
201,201,5,1,18,1,1,1,862,631,44,27,90,(72),0.1336963097398669,0.2768470790378007,,,906,658
202,202,5,1,18,1,1,2,923,633,86,19,89,Erfinder:,0.14609800362976408,0.2759879725085911,,,1009,652
203,203,4,1,18,1,2,0,898,666,190,23,-1,,0.1501814882032668,0.29102233676975947,,,1088,689
204,204,5,1,18,1,2,1,898,671,7,8,39,¬¢,0.13634301270417423,0.28994845360824745,,,905,679
205,205,5,1,18,1,2,2,923,666,88,22,96,"Fischer,",0.14624924379915305,0.29080756013745707,inventor_line_1,"Fischer,",1011,688
206,206,5,1,18,1,2,3,1020,666,68,23,96,Georg,0.15940713853599517,0.29102233676975947,inventor_line_1,Georg,1088,689
207,207,4,1,18,1,3,0,923,699,193,23,-1,,0.154189352692075,0.30519759450171824,,,1116,722
208,208,5,1,18,1,3,1,923,699,63,18,96,13129,0.1443587416817907,0.30412371134020616,,,986,717
209,209,5,1,18,1,3,2,996,699,64,18,96,Berlin,0.15547489413188142,0.30412371134020616,,,1060,717
210,210,5,1,18,1,3,3,1070,699,46,23,96,(DE),0.16530550514216577,0.30519759450171824,,,1116,722
211,211,4,1,18,1,4,0,898,732,203,22,-1,,0.1511645493042952,0.31915807560137455,,,1101,754
212,212,5,1,18,1,4,1,898,737,7,8,55,¬¢,0.13634301270417423,0.31829896907216493,,,905,745
213,213,5,1,18,1,4,2,923,732,93,22,86,"Rohrich,",0.14662734422262552,0.31915807560137455,,,1016,754
214,214,5,1,18,1,4,3,1025,732,76,18,96,Tobias,0.16076830006049606,0.31829896907216493,,,1101,750
215,215,4,1,18,1,5,0,922,765,312,23,-1,,0.1630369026013309,0.3335481099656357,,,1234,788
216,216,5,1,18,1,5,1,922,765,64,18,92,03185,0.1442831215970962,0.3324742268041237,,,986,783
217,217,5,1,18,1,5,2,994,765,186,18,91,Turnow-Preilack,0.16439806412583183,0.3324742268041237,,,1180,783
218,218,5,1,18,1,5,3,1188,765,46,23,96,(DE),0.18315184513006655,0.3335481099656357,,,1234,788
219,219,4,1,18,1,6,0,898,797,180,23,-1,,0.14942528735632185,0.3472938144329897,,,1078,820
220,220,5,1,18,1,6,1,898,803,7,7,63,*,0.13634301270417423,0.34643470790378006,,,905,810
221,221,5,1,18,1,6,2,923,797,95,19,90,"Haschke,",0.14677858439201452,0.34643470790378006,,,1018,816
222,222,5,1,18,1,6,3,1021,797,57,23,93,Igor,0.1587265577737447,0.3472938144329897,,,1078,820
223,223,4,1,18,1,7,0,923,830,193,23,-1,,0.154189352692075,0.36146907216494845,,,1116,853
224,224,5,1,18,1,7,1,923,830,63,18,96,10437,0.1443587416817907,0.3603951890034364,,,986,848
225,225,5,1,18,1,7,2,996,830,64,18,96,Berlin,0.15547489413188142,0.3603951890034364,,,1060,848
226,226,5,1,18,1,7,3,1070,830,46,23,96,(DE),0.16530550514216577,0.36146907216494845,,,1116,853
227,227,2,1,19,0,0,0,862,893,369,157,-1,,0.15827283726557773,0.4173109965635739,,,1231,1050
228,228,3,1,19,1,0,0,862,893,369,157,-1,,0.15827283726557773,0.4173109965635739,,,1231,1050
229,229,4,1,19,1,1,0,862,893,369,27,-1,,0.15827283726557773,0.3893900343642612,,,1231,920
230,230,5,1,19,1,1,1,862,893,44,27,92,(74),0.1336963097398669,0.3893900343642612,,,906,920
231,231,5,1,19,1,1,2,921,895,97,19,90,Vertreter:,0.14662734422262552,0.38853092783505155,,,1018,914
232,232,5,1,19,1,1,3,1029,895,113,19,93,"Kaufmann,",0.16417120387174833,0.38853092783505155,representative_line_1_eu,"Kaufmann,",1142,914
233,233,5,1,19,1,1,4,1146,895,85,23,92,Sigfrid,0.17974894131881428,0.3893900343642612,representative_line_1_eu,Sigfrid,1231,918
234,234,4,1,19,1,2,0,923,929,113,18,-1,,0.14813974591651544,0.4029209621993127,,,1036,947
235,235,5,1,19,1,2,1,923,929,113,18,95,Kaufmann,0.14813974591651544,0.4029209621993127,,,1036,947
236,236,4,1,19,1,3,0,923,961,302,19,-1,,0.16243194192377494,0.4168814432989691,,,1225,980
237,237,5,1,19,1,3,1,923,961,78,19,93,Patent-,0.1454930429522081,0.4168814432989691,,,1001,980
238,238,5,1,19,1,3,2,1010,961,41,19,93,und,0.1558529945553539,0.4168814432989691,,,1051,980
239,239,5,1,19,1,3,3,1061,961,164,19,80,Rechtsanwalte,0.17286751361161526,0.4168814432989691,,,1225,980
240,240,4,1,19,1,4,0,923,994,249,18,-1,,0.15842407743496673,0.43084192439862545,,,1172,1012
241,241,5,1,19,1,4,1,923,994,136,18,91,Loschwitzer,0.1498790078644888,0.43084192439862545,,,1059,1012
242,242,5,1,19,1,4,2,1066,994,73,18,91,StraBe,0.16674228675136116,0.43084192439862545,,,1139,1012
243,243,5,1,19,1,4,3,1147,994,25,18,97,42,0.1753629764065336,0.43084192439862545,,,1172,1012
244,244,4,1,19,1,5,0,922,1027,222,23,-1,,0.15623109497882637,0.44609106529209624,,,1144,1050
245,245,5,1,19,1,5,1,922,1027,64,18,96,01309,0.1442831215970962,0.44501718213058417,,,986,1045
246,246,5,1,19,1,5,2,996,1027,92,18,96,Dresden,0.15759225650332728,0.44501718213058417,,,1088,1045
247,247,5,1,19,1,5,3,1097,1027,47,23,96,(DE),0.169464609800363,0.44609106529209624,,,1144,1050
248,248,2,1,20,0,0,0,224,1079,1243,4,-1,,0.1278735632183908,0.4643470790378007,,,1467,1083
249,249,3,1,20,1,0,0,224,1079,1243,4,-1,,0.1278735632183908,0.4643470790378007,,,1467,1083
250,250,4,1,20,1,1,0,224,1079,1243,4,-1,,0.1278735632183908,0.4643470790378007,,,1467,1083
251,251,5,1,20,1,1,1,224,1079,1243,4,95, ,0.1278735632183908,0.4643470790378007,,,1467,1083
252,252,2,1,21,0,0,0,225,1099,45,26,-1,,0.037431941923774956,0.47766323024054985,,,270,1125
253,253,3,1,21,1,0,0,225,1099,45,26,-1,,0.037431941923774956,0.47766323024054985,,,270,1125
254,254,4,1,21,1,1,0,225,1099,45,26,-1,,0.037431941923774956,0.47766323024054985,,,270,1125
255,255,5,1,21,1,1,1,225,1099,45,26,96,(54),0.037431941923774956,0.47766323024054985,,,270,1125
256,256,2,1,22,0,0,0,315,1099,1085,21,-1,,0.1296884452510587,0.47658934707903783,,,1400,1120
257,257,3,1,22,1,0,0,315,1099,1085,21,-1,,0.1296884452510587,0.47658934707903783,,,1400,1120
258,258,4,1,22,1,1,0,315,1099,1085,21,-1,,0.1296884452510587,0.47658934707903783,,,1400,1120
259,259,5,1,22,1,1,1,315,1099,163,20,92,VERFAHREN,0.05996672716273442,0.47637457044673537,title_line_1,VERFAHREN,478,1119
260,260,5,1,22,1,1,2,489,1099,55,21,93,UND,0.07811554748941318,0.47658934707903783,title_line_1,UND,544,1120
261,261,5,1,22,1,1,3,554,1099,368,21,90,FERTIGUNGSVORRICHTUNG,0.11161524500907441,0.47658934707903783,title_line_1,FERTIGUNGSVORRICHTUNG,922,1120
262,262,5,1,22,1,1,4,932,1099,54,21,92,ZUM,0.14503932244404114,0.47658934707903783,title_line_1,ZUM,986,1120
263,263,5,1,22,1,1,5,998,1099,194,21,92,LAGENWEISEN,0.16560798548094374,0.47658934707903783,title_line_1,LAGENWEISEN,1192,1120
264,264,5,1,22,1,1,6,1201,1099,111,21,92,AUFBAU,0.19003327283726557,0.47658934707903783,title_line_1,AUFBAU,1312,1120
265,265,5,1,22,1,1,7,1323,1099,77,21,95,EINES,0.20591349062310949,0.47658934707903783,title_line_1,EINES,1400,1120
266,266,2,1,23,0,0,0,316,1127,986,25,-1,,0.12235329703569268,0.4894759450171821,,,1302,1152
267,267,3,1,23,1,0,0,316,1127,986,25,-1,,0.12235329703569268,0.4894759450171821,,,1302,1152
268,268,4,1,23,1,1,0,316,1127,986,25,-1,,0.12235329703569268,0.4894759450171821,,,1302,1152
269,269,5,1,23,1,1,1,316,1131,93,21,93,DURCH,0.05482456140350877,0.49033505154639173,,,409,1152
270,270,5,1,23,1,1,2,419,1131,462,21,91,GEOMETRIEBESCHREIBUNGSDATEN,0.09830611010284332,0.49033505154639173,,,881,1152
271,271,5,1,23,1,1,3,885,1132,199,20,93,DEFINIERTEN,0.14889594676346038,0.49054982817869414,,,1084,1152
272,272,5,1,23,1,1,4,1095,1127,207,25,92,FORMKORPERS,0.18126134301270416,0.4894759450171821,,,1302,1152
273,273,2,1,24,0,0,0,224,1206,584,648,-1,,0.0780399274047187,0.6572164948453608,,,808,1854
274,274,3,1,24,1,0,0,224,1206,584,648,-1,,0.0780399274047187,0.6572164948453608,,,808,1854
275,275,4,1,24,1,1,0,225,1206,582,27,-1,,0.0780399274047187,0.523840206185567,,,807,1233
276,276,5,1,24,1,1,1,225,1206,45,27,87,(57),0.037431941923774956,0.523840206185567,,,270,1233
277,277,5,1,24,1,1,2,0,0,1653,2328,34,‚Äî,0.125,0.5,,,1653,2328
278,278,5,1,24,1,1,3,316,1208,33,19,93,Die,0.05028735632183908,0.5229810996563574,,,349,1227
279,279,5,1,24,1,1,4,364,1208,98,23,92,Erfindung,0.06246218995765275,0.523840206185567,,,462,1231
280,280,5,1,24,1,1,5,477,1208,64,19,91,betrifft,0.07698124621899577,0.5229810996563574,,,541,1227
281,281,5,1,24,1,1,6,553,1208,30,19,96,ein,0.08590441621294616,0.5229810996563574,,,583,1227
282,282,5,1,24,1,1,7,596,1208,103,19,92,Verfahren,0.09792800967937085,0.5229810996563574,,,699,1227
283,283,5,1,24,1,1,8,714,1208,36,19,96,und,0.11070780399274047,0.5229810996563574,,,750,1227
284,284,5,1,24,1,1,9,764,1208,43,19,96,eine,0.11879915305505143,0.5229810996563574,,,807,1227
285,285,4,1,24,1,2,0,224,1241,583,23,-1,,0.0779643073200242,0.5380154639175257,,,807,1264
286,286,5,1,24,1,2,1,224,1241,121,23,92,Vorrichtung,0.04302782819116757,0.5380154639175257,,,345,1264
287,287,5,1,24,1,2,2,353,1246,33,13,93,zur,0.0558832425892317,0.5380154639175257,,,386,1259
288,288,5,1,24,1,2,3,394,1241,97,23,92,Fertigung,0.06692377495462795,0.5380154639175257,,,491,1264
289,289,5,1,24,1,2,4,499,1241,56,18,93,eines,0.07970356926799758,0.5369415807560137,,,555,1259
290,290,5,1,24,1,2,5,564,1241,132,23,58,Formk√©rpers,0.09528130671506352,0.5380154639175257,,,696,1264
291,291,5,1,24,1,2,6,705,1241,26,23,93,(1),0.10859044162129462,0.5380154639175257,,,731,1264
292,292,5,1,24,1,2,7,741,1241,66,18,93,mittels,0.11705989110707804,0.5369415807560137,,,807,1259
293,293,4,1,24,1,3,0,225,1274,583,23,-1,,0.07811554748941318,0.5521907216494846,,,808,1297
294,294,5,1,24,1,3,1,225,1274,55,18,93,eines,0.038188142770719906,0.5511168384879725,,,280,1292
295,295,5,1,24,1,3,2,290,1274,93,18,91,additiven,0.05089231699939504,0.5511168384879725,,,383,1292
296,296,5,1,24,1,3,3,394,1274,228,23,91,"Fertigungsverfahrens,",0.07683000604960677,0.5521907216494846,,,622,1297
297,297,5,1,24,1,3,4,634,1274,28,18,93,bei,0.09800362976406533,0.5511168384879725,,,662,1292
298,298,5,1,24,1,3,5,672,1274,92,18,92,welchem,0.10859044162129462,0.5511168384879725,,,764,1292
299,299,5,1,24,1,3,6,774,1274,34,18,96,der,0.11963097398669087,0.5511168384879725,,,808,1292
300,300,4,1,24,1,4,0,226,1306,581,23,-1,,0.07811554748941318,0.5659364261168385,,,807,1329
301,301,5,1,24,1,4,1,226,1306,117,23,92,lagenweise,0.04302782819116757,0.5659364261168385,,,343,1329
302,302,5,1,24,1,4,2,353,1306,74,19,95,Aufbau,0.05898366606170599,0.5650773195876289,,,427,1325
303,303,5,1,24,1,4,3,438,1306,58,19,92,durch,0.0706291591046582,0.5650773195876289,,,496,1325
304,304,5,1,24,1,4,4,507,1306,148,19,92,Aufschmelzen,0.08787053841500303,0.5650773195876289,,,655,1325
305,305,5,1,24,1,4,5,668,1306,36,19,93,und,0.10375075620084695,0.5650773195876289,,,704,1325
306,306,5,1,24,1,4,6,715,1306,92,19,92,Abschei-,0.11509376890502117,0.5650773195876289,,,807,1325
307,307,4,1,24,1,5,0,225,1339,582,23,-1,,0.0780399274047187,0.5801116838487973,,,807,1362
308,308,5,1,24,1,5,1,225,1339,38,18,96,den,0.03690260133091349,0.5790378006872853,,,263,1357
309,309,5,1,24,1,5,2,273,1339,55,18,93,eines,0.04544767090139141,0.5790378006872853,,,328,1357
310,310,5,1,24,1,5,3,337,1339,144,23,92,vorzugsweise,0.06185722928009679,0.5801116838487973,,,481,1362
311,311,5,1,24,1,5,4,490,1339,145,23,90,drahtf√©rmigen,0.08507259528130671,0.5801116838487973,,,635,1362
312,312,5,1,24,1,5,5,645,1339,125,18,91,Werkstoffes,0.10700241984271022,0.5790378006872853,,,770,1357
313,313,5,1,24,1,5,6,780,1339,27,23,96,(2),0.12000907441016334,0.5801116838487973,,,807,1362
314,314,4,1,24,1,6,0,225,1372,582,23,-1,,0.0780399274047187,0.594286941580756,,,807,1395
315,315,5,1,24,1,6,1,225,1372,70,23,90,erfolgt.,0.03932244404113733,0.594286941580756,,,295,1395
316,316,5,1,24,1,6,2,304,1372,37,19,93,Der,0.04877495462794918,0.5934278350515464,,,341,1391
317,317,5,1,24,1,6,3,346,1372,102,19,93,Werkstoff,0.06004234724742892,0.5934278350515464,,,448,1391
318,318,5,1,24,1,6,4,454,1372,26,23,96,(2),0.0706291591046582,0.594286941580756,,,480,1395
319,319,5,1,24,1,6,5,487,1372,42,19,93,wird,0.07683000604960677,0.5934278350515464,,,529,1391
320,320,5,1,24,1,6,6,538,1372,63,19,92,hierbei,0.08613127646702964,0.5934278350515464,,,601,1391
321,321,5,1,24,1,6,7,604,1372,26,19,93,in,0.09331518451300666,0.5934278350515464,,,630,1391
322,322,5,1,24,1,6,8,638,1372,99,19,91,einzelnen,0.10397761645493044,0.5934278350515464,,,737,1391
323,323,5,1,24,1,6,9,744,1372,63,19,90,Werk-,0.11728675136116153,0.5934278350515464,,,807,1391
324,324,4,1,24,1,7,0,225,1405,582,23,-1,,0.0780399274047187,0.6084621993127147,,,807,1428
325,325,5,1,24,1,7,1,225,1405,122,18,90,stoffbahnen,0.04325468844525106,0.6073883161512027,,,347,1423
326,326,5,1,24,1,7,2,357,1405,26,23,92,(3),0.0559588626739262,0.6084621993127147,,,383,1428
327,327,5,1,24,1,7,3,391,1405,96,23,91,"abgelegt,",0.06639443436176648,0.6084621993127147,,,487,1428
328,328,5,1,24,1,7,4,495,1405,62,18,91,wobei,0.07955232909860858,0.6073883161512027,,,557,1423
329,329,5,1,24,1,7,5,566,1405,184,23,92,Prozessparameter,0.09951603145795523,0.6084621993127147,,,750,1428
330,330,5,1,24,1,7,6,752,1405,55,18,92,her-,0.11789171203871748,0.6073883161512027,,,807,1423
331,331,4,1,24,1,8,0,225,1438,583,23,-1,,0.07811554748941318,0.6226374570446735,,,808,1461
332,332,5,1,24,1,8,1,225,1442,116,19,92,angezogen,0.042800967937084086,0.6234965635738832,,,341,1461
333,333,5,1,24,1,8,2,348,1438,77,18,96,"werden,",0.05845432546884453,0.6215635738831615,,,425,1456
334,334,5,1,24,1,8,3,429,1438,42,21,93,die,0.06805807622504537,0.6222079037800687,,,471,1459
335,335,5,1,24,1,8,4,479,1438,77,18,92,anhand,0.07826678765880218,0.6215635738831615,,,556,1456
336,336,5,1,24,1,8,5,564,1442,24,14,96,von,0.08711433756805807,0.6224226804123711,,,588,1456
337,337,5,1,24,1,8,6,591,1438,34,18,96,in,0.09195402298850575,0.6215635738831615,,,625,1456
338,338,5,1,24,1,8,7,633,1438,53,18,93,einer,0.09974289171203872,0.6215635738831615,,,686,1456
339,339,5,1,24,1,8,8,694,1438,114,18,91,Datenbank,0.11358136721113128,0.6215635738831615,,,808,1456
340,340,4,1,24,1,9,0,225,1470,582,23,-1,,0.0780399274047187,0.6363831615120275,,,807,1493
341,341,5,1,24,1,9,1,225,1470,27,23,93,(6),0.03607078039927405,0.6363831615120275,,,252,1493
342,342,5,1,24,1,9,2,260,1470,148,23,91,gespeicherten,0.05051421657592257,0.6363831615120275,,,408,1493
343,343,5,1,24,1,9,3,417,1470,184,23,87,Zusammenhangen,0.07698124621899577,0.6363831615120275,,,601,1493
344,344,5,1,24,1,9,4,603,1470,115,19,92,zwischen,0.0998941318814277,0.6355240549828178,,,718,1489
345,345,5,1,24,1,9,5,727,1470,80,19,91,Prozes-,0.11600120992135511,0.6355240549828178,,,807,1489
346,346,4,1,24,1,10,0,225,1503,583,23,-1,,0.07811554748941318,0.6505584192439863,,,808,1526
347,347,5,1,24,1,10,1,225,1504,138,22,91,"sparametern,",0.04446460980036298,0.6507731958762887,,,363,1526
348,348,5,1,24,1,10,2,368,1503,249,23,91,Werkstoffeigenschaften,0.07448578342407744,0.6505584192439863,,,617,1526
349,349,5,1,24,1,10,3,623,1503,36,18,93,und,0.0969449485783424,0.6494845360824743,,,659,1521
350,350,5,1,24,1,10,4,666,1503,142,23,91,ausgebildeter,0.11146400483968542,0.6505584192439863,,,808,1526
351,351,4,1,24,1,11,0,225,1536,582,23,-1,,0.0780399274047187,0.664733676975945,,,807,1559
352,352,5,1,24,1,11,1,225,1536,110,18,92,Geometrie,0.04234724742891712,0.663659793814433,,,335,1554
353,353,5,1,24,1,11,2,345,1536,52,18,93,einer,0.056110102843315184,0.663659793814433,,,397,1554
354,354,5,1,24,1,11,3,406,1536,153,18,90,Werkstoffbahn,0.07297338173018754,0.663659793814433,,,559,1554
355,355,5,1,24,1,11,4,570,1536,27,23,96,(3),0.0882486388384755,0.664733676975945,,,597,1559
356,356,5,1,24,1,11,5,609,1536,45,18,96,bzw.,0.095508166969147,0.663659793814433,,,654,1554
357,357,5,1,24,1,11,6,665,1536,59,18,93,deren,0.10503629764065336,0.663659793814433,,,724,1554
358,358,5,1,24,1,11,7,735,1536,72,18,92,Abwei-,0.11660617059891107,0.663659793814433,,,807,1554
359,359,4,1,24,1,12,0,225,1569,582,23,-1,,0.0780399274047187,0.6789089347079038,,,807,1592
360,360,5,1,24,1,12,1,225,1569,62,23,96,chung,0.03871748336358137,0.6789089347079038,,,287,1592
361,361,5,1,24,1,12,2,297,1574,36,13,96,von,0.04764065335753176,0.6789089347079038,,,333,1587
362,362,5,1,24,1,12,3,342,1569,34,18,93,der,0.05429522081064731,0.6778350515463918,,,376,1587
363,363,5,1,24,1,12,4,384,1569,157,18,91,Soll-Geometrie,0.06994857834240774,0.6778350515463918,,,541,1587
364,364,5,1,24,1,12,5,550,1569,37,18,93,des,0.08598003629764066,0.6778350515463918,,,587,1587
365,365,5,1,24,1,12,6,596,1569,133,23,27,Formk√©rpers,0.10019661222020569,0.6789089347079038,,,729,1592
366,366,5,1,24,1,12,7,739,1569,26,23,93,(1),0.11373260738052027,0.6789089347079038,,,765,1592
367,367,5,1,24,1,12,8,775,1569,32,18,93,be-,0.11963097398669087,0.6778350515463918,,,807,1587
368,368,4,1,24,1,13,0,225,1602,581,23,-1,,0.0779643073200242,0.6930841924398625,,,806,1625
369,369,5,1,24,1,13,1,225,1602,69,18,92,stimmt,0.03924682395644283,0.6920103092783505,,,294,1620
370,370,5,1,24,1,13,2,302,1602,83,18,91,werden.,0.05195099818511797,0.6920103092783505,,,385,1620
371,371,5,1,24,1,13,3,395,1602,50,18,91,Jede,0.06352087114337568,0.6920103092783505,,,445,1620
372,372,5,1,24,1,13,4,453,1602,153,18,92,Werkstoffbahn,0.08008166969147006,0.6920103092783505,,,606,1620
373,373,5,1,24,1,13,5,616,1602,27,23,96,(3),0.09520568663036903,0.6930841924398625,,,643,1625
374,374,5,1,24,1,13,6,651,1602,42,18,95,wird,0.10163339382940109,0.6920103092783505,,,693,1620
375,375,5,1,24,1,13,7,704,1602,48,18,96,nach,0.11010284331518451,0.6920103092783505,,,752,1620
376,376,5,1,24,1,13,8,762,1602,44,18,96,dem,0.11857229280096794,0.6920103092783505,,,806,1620
377,377,4,1,24,1,14,0,224,1634,583,23,-1,,0.0779643073200242,0.7068298969072165,,,807,1657
378,378,5,1,24,1,14,1,224,1634,123,19,92,Abscheiden,0.043179068360556565,0.7059707903780069,,,347,1653
379,379,5,1,24,1,14,2,359,1634,66,19,92,mittels,0.05928614640048397,0.7059707903780069,,,425,1653
380,380,5,1,24,1,14,3,434,1634,56,19,92,eines,0.06987295825771325,0.7059707903780069,,,490,1653
381,381,5,1,24,1,14,4,499,1634,142,23,91,Messsystems,0.08620689655172414,0.7068298969072165,,,641,1657
382,382,5,1,24,1,14,5,651,1639,108,18,92,gemessen,0.10662431941923775,0.7079037800687286,,,759,1657
383,383,5,1,24,1,14,6,770,1634,37,19,96,und,0.11925287356321838,0.7059707903780069,,,807,1653
384,384,4,1,24,1,15,0,226,1667,581,23,-1,,0.07811554748941318,0.7210051546391752,,,807,1690
385,385,5,1,24,1,15,1,226,1667,37,18,93,ihre,0.036978221415607984,0.7199312714776632,,,263,1685
386,386,5,1,24,1,15,2,268,1667,129,23,92,Abweichung,0.05028735632183908,0.7210051546391752,,,397,1690
387,387,5,1,24,1,15,3,403,1672,24,13,96,von,0.06276467029643074,0.7210051546391752,,,427,1685
388,388,5,1,24,1,15,4,429,1667,42,18,93,der,0.06805807622504537,0.7199312714776632,,,471,1685
389,389,5,1,24,1,15,5,473,1667,112,18,92,Soll-Form,0.08000604960677556,0.7199312714776632,,,585,1685
390,390,5,1,24,1,15,6,593,1667,30,18,96,mit,0.09195402298850575,0.7199312714776632,,,623,1685
391,391,5,1,24,1,15,7,628,1667,38,18,93,den,0.09785238959467635,0.7199312714776632,,,666,1685
392,392,5,1,24,1,15,8,672,1667,135,18,91,verwendeten,0.1118421052631579,0.7199312714776632,,,807,1685
393,393,4,1,24,1,16,0,226,1700,581,23,-1,,0.07811554748941318,0.7351804123711341,,,807,1723
394,394,5,1,24,1,16,1,226,1700,205,23,91,Prozessparametern,0.049682395644283124,0.7351804123711341,,,431,1723
395,395,5,1,24,1,16,2,440,1700,16,18,96,in,0.0677555958862674,0.7341065292096219,,,456,1718
396,396,5,1,24,1,16,3,464,1700,34,18,93,der,0.07274652147610405,0.7341065292096219,,,498,1718
397,397,5,1,24,1,16,4,506,1700,100,18,92,Datenbank,0.08408953418027829,0.7341065292096219,,,606,1718
398,398,5,1,24,1,16,5,609,1700,147,23,90,eingetragen.,0.10322141560798548,0.7351804123711341,,,756,1723
399,399,5,1,24,1,16,6,766,1700,41,18,93,Die-,0.11895039322444041,0.7341065292096219,,,807,1718
400,400,4,1,24,1,17,0,225,1732,582,23,-1,,0.0780399274047187,0.748926116838488,,,807,1755
401,401,5,1,24,1,17,1,225,1737,36,14,96,ses,0.0367513611615245,0.7491408934707904,,,261,1751
402,402,5,1,24,1,17,2,265,1732,103,19,93,Verfahren,0.047867513611615245,0.7480670103092784,,,368,1751
403,403,5,1,24,1,17,3,374,1732,109,23,46,erm√©glicht,0.0648064125831821,0.748926116838488,,,483,1755
404,404,5,1,24,1,17,4,487,1732,31,19,93,die,0.07599818511796733,0.7480670103092784,,,518,1751
405,405,5,1,24,1,17,5,524,1732,117,23,92,lagenweise,0.08809739866908652,0.748926116838488,,,641,1755
406,406,5,1,24,1,17,6,647,1732,118,23,91,Herstellung,0.10677555958862674,0.748926116838488,,,765,1755
407,407,5,1,24,1,17,7,770,1737,37,14,96,von,0.11925287356321838,0.7491408934707904,,,807,1751
408,408,4,1,24,1,18,0,226,1766,581,23,-1,,0.07811554748941318,0.7635309278350515,,,807,1789
409,409,5,1,24,1,18,1,226,1766,134,23,42,Formk√©rpern,0.04431336963097399,0.7635309278350515,,,360,1789
410,410,5,1,24,1,18,2,371,1766,26,23,96,(1),0.05807622504537205,0.7635309278350515,,,397,1789
411,411,5,1,24,1,18,3,408,1766,57,18,96,direkt,0.06601633393829401,0.7624570446735395,,,465,1784
412,412,5,1,24,1,18,4,475,1770,36,14,96,aus,0.07456140350877193,0.7633161512027491,,,511,1784
413,413,5,1,24,1,18,5,521,1766,38,18,93,den,0.08166969147005444,0.7624570446735395,,,559,1784
414,414,5,1,24,1,18,6,570,1766,120,18,91,CAD-Daten,0.09528130671506352,0.7624570446735395,,,690,1784
415,415,5,1,24,1,18,7,702,1766,52,18,93,unter,0.11010284331518451,0.7624570446735395,,,754,1784
416,416,5,1,24,1,18,8,763,1766,44,18,92,Ver-,0.11872353297035693,0.7624570446735395,,,807,1784
417,417,4,1,24,1,19,0,225,1799,582,23,-1,,0.0780399274047187,0.7777061855670103,,,807,1822
418,418,5,1,24,1,19,1,225,1799,48,18,93,zicht,0.03765880217785844,0.7766323024054983,,,273,1817
419,419,5,1,24,1,19,2,279,1799,33,18,96,auf,0.04469147005444646,0.7766323024054983,,,312,1817
420,420,5,1,24,1,19,3,317,1799,44,18,93,eine,0.05127041742286751,0.7766323024054983,,,361,1817
421,421,5,1,24,1,19,4,367,1799,98,23,91,vorherige,0.06291591046581972,0.7777061855670103,,,465,1822
422,422,5,1,24,1,19,5,471,1799,106,23,91,Zerlegung,0.07924984875983061,0.7777061855670103,,,577,1822
423,423,5,1,24,1,19,6,584,1799,37,18,96,des,0.0911222020568663,0.7766323024054983,,,621,1817
424,424,5,1,24,1,19,7,628,1799,80,18,96,Modells,0.10102843315184513,0.7766323024054983,,,708,1817
425,425,5,1,24,1,19,8,716,1799,15,18,93,in,0.10942226255293407,0.7766323024054983,,,731,1817
426,426,5,1,24,1,19,9,738,1799,69,18,90,einzel-,0.11683303085299455,0.7766323024054983,,,807,1817
427,427,4,1,24,1,20,0,226,1831,207,23,-1,,0.04983363581367211,0.7914518900343642,,,433,1854
428,428,5,1,24,1,20,1,226,1836,24,14,93,ne,0.035995160314579555,0.7916666666666666,,,250,1850
429,429,5,1,24,1,20,2,259,1831,51,23,93,Lagen,0.04302782819116757,0.7914518900343642,,,310,1854
430,430,5,1,24,1,20,3,312,1831,121,23,62,"(""Slicen"").",0.05633696309739867,0.7914518900343642,,,433,1854
431,431,2,1,25,0,0,0,948,1249,432,637,-1,,0.17604355716878403,0.6733247422680413,,,1380,1886
432,432,3,1,25,1,0,0,948,1249,432,637,-1,,0.17604355716878403,0.6733247422680413,,,1380,1886
433,433,4,1,25,1,1,0,948,1249,432,637,-1,,0.17604355716878403,0.6733247422680413,,,1380,1886
434,434,5,1,25,1,1,1,948,1249,432,637,95, ,0.17604355716878403,0.6733247422680413,,,1380,1886
435,435,2,1,26,0,0,0,716,2270,259,16,-1,,0.1278735632183908,0.9785223367697594,,,975,2286
436,436,3,1,26,1,0,0,716,2270,259,16,-1,,0.1278735632183908,0.9785223367697594,,,975,2286
437,437,4,1,26,1,1,0,716,2270,259,16,-1,,0.1278735632183908,0.9785223367697594,,,975,2286
438,438,5,1,26,1,1,1,716,2270,49,12,96,Printed,0.11199334543254688,0.9776632302405498,,,765,2282
439,439,5,1,26,1,1,2,771,2270,15,16,96,by,0.1177404718693285,0.9785223367697594,,,786,2286
440,440,5,1,26,1,1,3,792,2270,45,14,96,"Jouve,",0.12318511796733213,0.9780927835051546,,,837,2284
441,441,5,1,26,1,1,4,843,2270,41,12,96,75001,0.13059588626739263,0.9776632302405498,,,884,2282
442,442,5,1,26,1,1,5,893,2270,46,12,96,PARIS,0.1385359951603146,0.9776632302405498,,,939,2282
443,443,5,1,26,1,1,6,945,2270,30,16,95,(FR),0.14519056261343014,0.9785223367697594,,,975,2286
