,Unnamed: 0,level,page_num,block_num,par_num,line_num,word_num,left,top,width,height,conf,text,x,y,label,target,right,bottom
0,0,1,1,0,0,0,0,0,0,1653,2328,-1,,0.125,0.5,,,1653,2328
1,1,2,1,1,0,0,0,144,1905,31,328,-1,,0.02412280701754386,0.8887457044673539,,,175,2233
2,2,3,1,1,1,0,0,144,1905,31,328,-1,,0.02412280701754386,0.8887457044673539,,,175,2233
3,3,4,1,1,1,1,0,144,1905,31,328,-1,,0.02412280701754386,0.8887457044673539,,,175,2233
4,4,5,1,1,1,1,1,144,2179,30,54,96,EP,0.024047186932849365,0.947594501718213,,,174,2233
5,5,5,1,1,1,1,2,144,2142,31,21,94,3,0.02412280701754386,0.9246134020618557,,,175,2163
6,6,5,1,1,1,1,3,144,2055,31,71,94,399,0.02412280701754386,0.8979810996563574,,,175,2126
7,7,5,1,1,1,1,4,144,1974,30,65,89,771,0.024047186932849365,0.8618986254295533,,,174,2039
8,8,5,1,1,1,1,5,144,1905,30,50,89,A1,0.024047186932849365,0.8290378006872853,,,174,1955
9,9,2,1,2,0,0,0,429,153,88,28,-1,,0.07153660012099214,0.07173539518900343,,,517,181
10,10,3,1,2,1,0,0,429,153,88,28,-1,,0.07153660012099214,0.07173539518900343,,,517,181
11,11,4,1,2,1,1,0,429,153,88,16,-1,,0.07153660012099214,0.06915807560137457,,,517,169
12,12,5,1,2,1,1,1,429,153,88,16,84,Europaisches,0.07153660012099214,0.06915807560137457,,,517,169
13,13,4,1,2,1,2,0,429,170,71,11,-1,,0.07025105868118572,0.07538659793814433,,,500,181
14,14,5,1,2,1,2,1,429,170,71,11,96,Patentamt,0.07025105868118572,0.07538659793814433,,,500,181
15,15,2,1,3,0,0,0,429,196,89,28,-1,,0.07161222020568662,0.09020618556701031,,,518,224
16,16,3,1,3,1,0,0,429,196,89,28,-1,,0.07161222020568662,0.09020618556701031,,,518,224
17,17,4,1,3,1,1,0,429,196,63,15,-1,,0.06964609800362977,0.08741408934707903,,,492,211
18,18,5,1,3,1,1,1,429,196,63,15,95,European,0.06964609800362977,0.08741408934707903,,,492,211
19,19,4,1,3,1,2,0,429,212,89,12,-1,,0.07161222020568662,0.0936426116838488,,,518,224
20,20,5,1,3,1,2,1,429,213,43,11,96,Patent,0.06813369630973987,0.0938573883161512,,,472,224
21,21,5,1,3,1,2,2,478,212,40,12,90,Office,0.07531760435571688,0.0936426116838488,,,518,224
22,22,2,1,4,0,0,0,429,239,109,28,-1,,0.07312462189957653,0.10867697594501718,,,538,267
23,23,3,1,4,1,0,0,429,239,109,28,-1,,0.07312462189957653,0.10867697594501718,,,538,267
24,24,4,1,4,1,1,0,429,239,109,15,-1,,0.07312462189957653,0.10588487972508591,,,538,254
25,25,5,1,4,1,1,1,429,239,40,12,93,Office,0.06790683605565638,0.1052405498281787,,,469,251
26,26,5,1,4,1,1,2,474,239,64,15,93,europ√©en,0.0765275257108288,0.10588487972508591,,,538,254
27,27,4,1,4,1,2,0,429,255,77,12,-1,,0.0707047791893527,0.11211340206185567,,,506,267
28,28,5,1,4,1,2,1,429,255,22,12,95,des,0.06654567453115548,0.11211340206185567,,,451,267
29,29,5,1,4,1,2,2,457,255,49,12,82,brevets,0.07282214156079855,0.11211340206185567,,,506,267
30,30,2,1,5,0,0,0,281,136,274,150,-1,,0.06321839080459771,0.09063573883161512,,,555,286
31,31,3,1,5,1,0,0,281,136,274,150,-1,,0.06321839080459771,0.09063573883161512,,,555,286
32,32,4,1,5,1,1,0,281,136,274,150,-1,,0.06321839080459771,0.09063573883161512,,,555,286
33,33,5,1,5,1,1,1,281,136,274,150,95, ,0.06321839080459771,0.09063573883161512,,,555,286
34,34,2,1,6,0,0,0,225,324,45,26,-1,,0.037431941923774956,0.14475945017182132,,,270,350
35,35,3,1,6,1,0,0,225,324,45,26,-1,,0.037431941923774956,0.14475945017182132,,,270,350
36,36,4,1,6,1,1,0,225,324,45,26,-1,,0.037431941923774956,0.14475945017182132,,,270,350
37,37,5,1,6,1,1,1,225,324,45,26,96,(12),0.037431941923774956,0.14475945017182132,,,270,350
38,38,2,1,7,0,0,0,225,395,378,53,-1,,0.06261343012704174,0.18105670103092783,,,603,448
39,39,3,1,7,1,0,0,225,395,378,53,-1,,0.06261343012704174,0.18105670103092783,,,603,448
40,40,4,1,7,1,1,0,225,395,262,26,-1,,0.05384150030248034,0.17525773195876287,,,487,421
41,41,5,1,7,1,1,1,225,395,45,26,95,(43),0.037431941923774956,0.17525773195876287,,,270,421
42,42,5,1,7,1,1,2,286,397,48,18,95,Date,0.04688445251058681,0.17439862542955326,,,334,415
43,43,5,1,7,1,1,3,342,397,20,18,96,of,0.05323653962492438,0.17439862542955326,,,362,415
44,44,5,1,7,1,1,4,370,397,117,23,96,publication:,0.0648064125831821,0.17547250859106528,,,487,420
45,45,4,1,7,1,2,0,286,430,317,18,-1,,0.06722625529340592,0.18857388316151202,,,603,448
46,46,5,1,7,1,2,1,286,430,117,18,96,07.11.2018,0.052102238354506954,0.18857388316151202,publication_date,07.11.2018,403,448
47,47,5,1,7,1,2,2,426,430,84,18,95,Bulletin,0.07078039927404718,0.18857388316151202,,,510,448
48,48,5,1,7,1,2,3,519,430,84,18,95,2018/45,0.08484573502722323,0.18857388316151202,,,603,448
49,49,2,1,8,0,0,0,225,493,402,26,-1,,0.06442831215970962,0.21735395189003437,,,627,519
50,50,3,1,8,1,0,0,225,493,402,26,-1,,0.06442831215970962,0.21735395189003437,,,627,519
51,51,4,1,8,1,1,0,225,493,402,26,-1,,0.06442831215970962,0.21735395189003437,,,627,519
52,52,5,1,8,1,1,1,225,493,45,26,96,(21),0.037431941923774956,0.21735395189003437,,,270,519
53,53,5,1,8,1,1,2,285,495,115,23,96,Application,0.051799758015728975,0.21756872852233677,,,400,518
54,54,5,1,8,1,1,3,410,495,83,18,93,number:,0.06828493647912885,0.21649484536082475,,,493,513
55,55,5,1,8,1,1,4,505,495,122,18,92,18179348.0,0.08560193587416817,0.21649484536082475,application_number,18179348,627,513
56,56,2,1,9,0,0,0,225,559,325,26,-1,,0.05860556563823351,0.24570446735395188,,,550,585
57,57,3,1,9,1,0,0,225,559,325,26,-1,,0.05860556563823351,0.24570446735395188,,,550,585
58,58,4,1,9,1,1,0,225,559,325,26,-1,,0.05860556563823351,0.24570446735395188,,,550,585
59,59,5,1,9,1,1,1,225,559,45,26,96,(22),0.037431941923774956,0.24570446735395188,,,270,585
60,60,5,1,9,1,1,2,286,561,48,18,96,Date,0.04688445251058681,0.24484536082474226,,,334,579
61,61,5,1,9,1,1,3,342,566,12,13,96,of,0.05263157894736842,0.24591924398625428,,,354,579
62,62,5,1,9,1,1,4,355,561,67,23,96,filing:,0.058756805807622506,0.24591924398625428,,,422,584
63,63,5,1,9,1,1,5,432,561,118,18,96,23.06.2015,0.07425892316999395,0.24484536082474226,filing_date,23.06.2015,550,579
64,64,2,1,10,0,0,0,1002,245,458,38,-1,,0.18617664851784635,0.1134020618556701,,,1460,283
65,65,3,1,10,1,0,0,1002,245,458,38,-1,,0.18617664851784635,0.1134020618556701,,,1460,283
66,66,4,1,10,1,1,0,1002,245,458,38,-1,,0.18617664851784635,0.1134020618556701,,,1460,283
67,67,5,1,10,1,1,1,1002,256,44,27,74,(11),0.15486993345432548,0.11576460481099657,,,1046,283
68,68,5,1,10,1,1,2,1146,245,52,32,96,EP,0.17725347852389595,0.11211340206185567,number,EP,1198,277
69,69,5,1,10,1,1,3,1214,245,20,32,92,3,0.1851179673321234,0.11211340206185567,number,3,1234,277
70,70,5,1,10,1,1,4,1249,245,68,32,92,399,0.1940411373260738,0.11211340206185567,number,399,1317,277
71,71,5,1,10,1,1,5,1332,245,62,32,91,771,0.20614035087719298,0.11211340206185567,number,771,1394,277
72,72,5,1,10,1,1,6,1413,245,47,32,84,A1,0.21725650332728372,0.11211340206185567,number,A1,1460,277
73,73,2,1,11,0,0,0,577,319,537,26,-1,,0.1278735632183908,0.14261168384879724,,,1114,345
74,74,3,1,11,1,0,0,577,319,537,26,-1,,0.1278735632183908,0.14261168384879724,,,1114,345
75,75,4,1,11,1,1,0,577,319,537,26,-1,,0.1278735632183908,0.14261168384879724,,,1114,345
76,76,5,1,11,1,1,1,577,319,156,26,95,EUROPEAN,0.09906231094978826,0.14261168384879724,,,733,345
77,77,5,1,11,1,1,2,735,320,135,24,95,PATENT,0.12137023593466424,0.14261168384879724,,,870,344
78,78,5,1,11,1,1,3,873,319,241,26,96,APPLICATION,0.1502571082879613,0.14261168384879724,,,1114,345
79,79,2,1,12,0,0,0,862,395,246,81,-1,,0.14897156684815488,0.1870704467353952,,,1108,476
80,80,3,1,12,1,0,0,862,395,246,81,-1,,0.14897156684815488,0.1870704467353952,,,1108,476
81,81,4,1,12,1,1,0,862,395,126,26,-1,,0.13989715668481548,0.17525773195876287,,,988,421
82,82,5,1,12,1,1,1,862,395,44,26,67,(51),0.1336963097398669,0.17525773195876287,,,906,421
83,83,5,1,12,1,1,2,923,397,25,18,93,Int,0.1414851784633999,0.17439862542955326,,,948,415
84,84,5,1,12,1,1,3,955,397,33,18,65,Cl:,0.14692982456140352,0.17439862542955326,,,988,415
85,85,4,1,12,1,2,0,922,425,186,21,-1,,0.15350877192982457,0.1870704467353952,,,1108,446
86,86,5,1,12,1,2,1,922,428,60,18,42,HO4R,0.14398064125831822,0.1877147766323024,class_international,H04R,982,446
87,87,5,1,12,1,2,2,992,428,44,18,95,1110,0.15335753176043557,0.1877147766323024,class_international,1/10,1036,446
88,88,5,1,12,1,2,3,1041,425,67,16,83,(2006.91),0.16250756200846944,0.18599656357388317,,,1108,441
89,89,4,1,12,1,3,0,922,455,186,21,-1,,0.15350877192982457,0.19995704467353953,,,1108,476
90,90,5,1,12,1,3,1,922,458,60,18,52,HOAR,0.14398064125831822,0.20060137457044674,,,982,476
91,91,5,1,12,1,3,2,991,458,44,18,64,5/04,0.1532062915910466,0.20060137457044674,,,1035,476
92,92,5,1,12,1,3,3,1041,455,67,16,64,(2006.00),0.16250756200846944,0.19888316151202748,,,1108,471
93,93,2,1,13,0,0,0,1194,425,197,21,-1,,0.1954779189352692,0.1870704467353952,,,1391,446
94,94,3,1,13,1,0,0,1194,425,197,21,-1,,0.1954779189352692,0.1870704467353952,,,1391,446
95,95,4,1,13,1,1,0,1194,425,197,21,-1,,0.1954779189352692,0.1870704467353952,,,1391,446
96,96,5,1,13,1,1,1,1194,428,60,18,69,GOGF,0.1851179673321234,0.1877147766323024,,,1254,446
97,97,5,1,13,1,1,2,1262,428,57,18,89,17130,0.19517543859649122,0.1877147766323024,,,1319,446
98,98,5,1,13,1,1,3,1324,425,67,16,79,(2006.01),0.20530852994555354,0.18599656357388317,,,1391,441
99,99,2,1,14,0,0,0,224,611,1243,8,-1,,0.1278735632183908,0.26417525773195877,,,1467,619
100,100,3,1,14,1,0,0,224,611,1243,8,-1,,0.1278735632183908,0.26417525773195877,,,1467,619
101,101,4,1,14,1,1,0,224,611,1243,8,-1,,0.1278735632183908,0.26417525773195877,,,1467,619
102,102,5,1,14,1,1,1,224,611,1243,8,95, ,0.1278735632183908,0.26417525773195877,,,1467,619
103,103,2,1,15,0,0,0,225,631,599,119,-1,,0.07932546884452511,0.296606529209622,,,824,750
104,104,3,1,15,1,0,0,225,631,599,119,-1,,0.07932546884452511,0.296606529209622,,,824,750
105,105,4,1,15,1,1,0,225,631,388,27,-1,,0.0633696309739867,0.2768470790378007,,,613,658
106,106,5,1,15,1,1,1,225,631,45,27,96,(84),0.037431941923774956,0.2768470790378007,,,270,658
107,107,5,1,15,1,1,2,286,633,118,23,96,Designated,0.052177858439201454,0.2768470790378007,,,404,656
108,108,5,1,15,1,1,3,413,633,119,23,96,Contracting,0.07146098003629764,0.2768470790378007,,,532,656
109,109,5,1,15,1,1,4,542,633,71,19,96,States:,0.08734119782214156,0.2759879725085911,,,613,652
110,110,4,1,15,1,2,0,285,666,537,18,-1,,0.08371143375680581,0.28994845360824745,,,822,684
111,111,5,1,15,1,2,1,285,666,31,18,94,AL,0.04544767090139141,0.28994845360824745,,,316,684
112,112,5,1,15,1,2,2,323,666,31,18,94,AT,0.05119479733817302,0.28994845360824745,,,354,684
113,113,5,1,15,1,2,3,363,666,30,18,96,BE,0.05716878402903811,0.28994845360824745,,,393,684
114,114,5,1,15,1,2,4,403,666,32,18,96,BG,0.0633696309739867,0.28994845360824745,,,435,684
115,115,5,1,15,1,2,5,445,666,31,18,96,CH,0.06964609800362977,0.28994845360824745,,,476,684
116,116,5,1,15,1,2,6,486,666,32,18,95,CY,0.07592256503327284,0.28994845360824745,,,518,684
117,117,5,1,15,1,2,7,526,666,30,18,93,CZ,0.08182093163944344,0.28994845360824745,,,556,684
118,118,5,1,15,1,2,8,565,666,30,18,93,DE,0.08771929824561403,0.28994845360824745,,,595,684
119,119,5,1,15,1,2,9,605,666,32,18,95,DK,0.09392014519056262,0.28994845360824745,,,637,684
120,120,5,1,15,1,2,10,646,666,29,18,95,EE,0.0998941318814277,0.28994845360824745,,,675,684
121,121,5,1,15,1,2,11,684,666,29,18,93,ES,0.10564125831820932,0.28994845360824745,,,713,684
122,122,5,1,15,1,2,12,723,666,57,18,90,FIFR,0.11365698729582577,0.28994845360824745,,,780,684
123,123,5,1,15,1,2,13,788,666,34,18,95,GB,0.12174833635813673,0.28994845360824745,,,822,684
124,124,4,1,15,1,3,0,285,699,539,18,-1,,0.0838626739261948,0.30412371134020616,,,824,717
125,125,5,1,15,1,3,1,285,699,297,18,83,GRHRHUIEISITLILTLU,0.06556261343012704,0.30412371134020616,,,582,717
126,126,5,1,15,1,3,2,591,699,28,18,85,LV,0.09150030248033877,0.30412371134020616,,,619,717
127,127,5,1,15,1,3,3,627,699,35,18,85,MC,0.09747428917120388,0.30412371134020616,,,662,717
128,128,5,1,15,1,3,4,670,699,35,18,94,MK,0.10397761645493044,0.30412371134020616,,,705,717
129,129,5,1,15,1,3,5,713,699,32,18,91,MT,0.11025408348457351,0.30412371134020616,,,745,717
130,130,5,1,15,1,3,6,753,699,29,18,49,NL,0.11607683000604961,0.30412371134020616,,,782,717
131,131,5,1,15,1,3,7,791,699,33,18,49,NO,0.1221264367816092,0.30412371134020616,,,824,717
132,132,4,1,15,1,4,0,286,732,336,18,-1,,0.06866303690260134,0.31829896907216493,,,622,750
133,133,5,1,15,1,4,1,286,732,28,18,93,PL,0.045372050816696916,0.31829896907216493,,,314,750
134,134,5,1,15,1,4,2,323,732,29,18,92,PT,0.05104355716878403,0.31829896907216493,,,352,750
135,135,5,1,15,1,4,3,360,732,58,18,92,RORS,0.058832425892317,0.31829896907216493,,,418,750
136,136,5,1,15,1,4,4,420,732,52,18,92,SE,0.06745311554748941,0.31829896907216493,,,472,750
137,137,5,1,15,1,4,5,480,732,20,18,95,SI,0.07410768300060495,0.31829896907216493,,,500,750
138,138,5,1,15,1,4,6,510,732,31,18,93,SK,0.0794767090139141,0.31829896907216493,,,541,750
139,139,5,1,15,1,4,7,550,732,72,18,90,SMTR,0.08862673926194797,0.31829896907216493,,,622,750
140,140,2,1,16,0,0,0,225,795,596,152,-1,,0.07909860859044163,0.3741408934707904,,,821,947
141,141,3,1,16,1,0,0,225,795,492,27,-1,,0.07123411978221415,0.3472938144329897,,,717,822
142,142,4,1,16,1,1,0,225,795,492,27,-1,,0.07123411978221415,0.3472938144329897,,,717,822
143,143,5,1,16,1,1,1,225,795,45,27,96,(30),0.037431941923774956,0.3472938144329897,,,270,822
144,144,5,1,16,1,1,2,286,797,77,23,94,Priority:,0.04907743496672716,0.3472938144329897,,,363,820
145,145,5,1,16,1,1,3,383,797,119,19,92,24.06.2014,0.06692377495462795,0.34643470790378006,priority_date_eu,24.06.2014,502,816
146,146,5,1,16,1,1,4,520,797,30,19,92,US,0.0809134906231095,0.34643470790378006,,,550,816
147,147,5,1,16,1,1,5,559,797,158,19,96,201414312914,0.09649122807017543,0.34643470790378006,,,717,816
148,148,3,1,16,2,0,0,225,861,596,86,-1,,0.07909860859044163,0.38831615120274915,,,821,947
149,149,4,1,16,2,1,0,225,861,596,26,-1,,0.07909860859044163,0.3754295532646048,,,821,887
150,150,5,1,16,2,1,1,225,861,45,26,96,(62),0.037431941923774956,0.3754295532646048,,,270,887
151,151,5,1,16,2,1,2,286,863,107,18,96,Document,0.05134603750756201,0.3745704467353952,,,393,881
152,152,5,1,16,2,1,3,402,863,105,23,96,number(s),0.06873865698729582,0.3756443298969072,,,507,886
153,153,5,1,16,2,1,4,516,863,20,18,96,of,0.07955232909860858,0.3745704467353952,,,536,881
154,154,5,1,16,2,1,5,542,863,32,18,96,the,0.08439201451905626,0.3745704467353952,,,574,881
155,155,5,1,16,2,1,6,583,863,65,18,96,earlier,0.09308832425892317,0.3745704467353952,,,648,881
156,156,5,1,16,2,1,7,655,863,140,23,94,application(s),0.10964912280701754,0.3756443298969072,,,795,886
157,157,5,1,16,2,1,8,805,863,16,18,96,in,0.12295825771324864,0.3745704467353952,,,821,881
158,158,4,1,16,2,2,0,286,895,308,19,-1,,0.06654567453115548,0.38853092783505155,,,594,914
159,159,5,1,16,2,2,1,286,895,109,19,96,accordance,0.051497277676950996,0.38853092783505155,,,395,914
160,160,5,1,16,2,2,2,395,895,60,19,96,with,0.06427707199032062,0.38853092783505155,,,455,914
161,161,5,1,16,2,2,3,464,895,35,19,96,Art.,0.07282214156079855,0.38853092783505155,,,499,914
162,162,5,1,16,2,2,4,508,895,25,19,96,76,0.07872050816696914,0.38853092783505155,,,533,914
163,163,5,1,16,2,2,5,542,895,52,19,96,EPC:,0.08590441621294616,0.38853092783505155,,,594,914
164,164,4,1,16,2,3,0,286,929,250,18,-1,,0.06215970961887477,0.4029209621993127,,,536,947
165,165,5,1,16,2,3,1,286,929,124,18,87,15173228.6,0.05263157894736842,0.4029209621993127,,,410,947
166,166,5,1,16,2,3,2,417,929,7,18,87,/,0.06359649122807018,0.4029209621993127,,,424,947
167,167,5,1,16,2,3,3,432,929,54,18,66,2961,0.06941923774954628,0.4029209621993127,,,486,947
168,168,5,1,16,2,3,4,499,929,37,18,96,194,0.07826678765880218,0.4029209621993127,,,536,947
169,169,2,1,17,0,0,0,225,992,584,58,-1,,0.07819116757410768,0.438573883161512,,,809,1050
170,170,3,1,17,1,0,0,225,992,584,58,-1,,0.07819116757410768,0.438573883161512,,,809,1050
171,171,4,1,17,1,1,0,225,992,584,26,-1,,0.07819116757410768,0.43170103092783507,,,809,1018
172,172,5,1,17,1,1,1,225,992,45,26,96,(71),0.037431941923774956,0.43170103092783507,,,270,1018
173,173,5,1,17,1,1,2,285,994,103,23,96,Applicant:,0.05089231699939504,0.4319158075601375,,,388,1017
174,174,5,1,17,1,1,3,397,994,72,18,96,Harman,0.06548699334543255,0.43084192439862545,applicant_line_1,Harman,469,1012
175,175,5,1,17,1,1,4,472,994,155,18,96,International,0.08310647307924984,0.43084192439862545,applicant_line_1,International,627,1012
176,176,5,1,17,1,1,5,630,994,131,22,96,"Industries,",0.10518753781004235,0.43170103092783507,applicant_line_1,"Industries,",761,1016
177,177,5,1,17,1,1,6,771,994,38,18,96,Inc.,0.11947973381730187,0.43084192439862545,applicant_line_1,Inc.,809,1012
178,178,4,1,17,1,2,0,286,1027,276,23,-1,,0.06412583182093164,0.44609106529209624,,,562,1050
179,179,5,1,17,1,2,1,286,1027,109,22,96,"Stamford,",0.051497277676950996,0.44587628865979384,,,395,1049
180,180,5,1,17,1,2,2,404,1027,30,18,96,CT,0.0633696309739867,0.44501718213058417,,,434,1045
181,181,5,1,17,1,2,3,442,1027,62,18,96,06901,0.07153660012099214,0.44501718213058417,,,504,1045
182,182,5,1,17,1,2,4,515,1027,47,23,96,(US),0.08144283121597096,0.44609106529209624,,,562,1050
183,183,2,1,18,0,0,0,844,614,4,468,-1,,0.1279491833030853,0.3642611683848797,,,848,1082
184,184,3,1,18,1,0,0,844,614,4,468,-1,,0.1279491833030853,0.3642611683848797,,,848,1082
185,185,4,1,18,1,1,0,844,614,4,468,-1,,0.1279491833030853,0.3642611683848797,,,848,1082
186,186,5,1,18,1,1,1,844,614,4,468,95, ,0.1279491833030853,0.3642611683848797,,,848,1082
187,187,2,1,19,0,0,0,862,631,374,58,-1,,0.15865093768905023,0.28350515463917525,,,1236,689
188,188,3,1,19,1,0,0,862,631,374,58,-1,,0.15865093768905023,0.28350515463917525,,,1236,689
189,189,4,1,19,1,1,0,862,631,336,27,-1,,0.1557773744706594,0.2768470790378007,,,1198,658
190,190,5,1,19,1,1,1,862,631,44,27,94,(72),0.1336963097398669,0.2768470790378007,,,906,658
191,191,5,1,19,1,1,2,923,633,89,19,93,Inventor:,0.14632486388384755,0.2759879725085911,,,1012,652
192,192,5,1,19,1,1,3,1022,633,101,23,93,"GELTER,",0.16220508166969147,0.2768470790378007,inventor_line_1,"GELTER,",1123,656
193,193,5,1,19,1,1,4,1131,633,67,19,96,Aaron,0.17611917725347853,0.2759879725085911,inventor_line_1,Aaron,1198,652
194,194,4,1,19,1,2,0,921,666,315,23,-1,,0.1631125226860254,0.29102233676975947,,,1236,689
195,195,5,1,19,1,2,1,921,666,57,18,96,West,0.14360254083484575,0.28994845360824745,,,978,684
196,196,5,1,19,1,2,2,985,666,84,22,96,"Jordan,",0.15532365396249243,0.29080756013745707,,,1069,688
197,197,5,1,19,1,2,3,1079,666,30,18,96,UT,0.16545674531155474,0.28994845360824745,,,1109,684
198,198,5,1,19,1,2,4,1117,666,62,18,96,84081,0.1736237144585602,0.28994845360824745,,,1179,684
199,199,5,1,19,1,2,5,1190,666,46,23,96,(US),0.18345432546884452,0.29102233676975947,,,1236,689
200,200,2,1,20,0,0,0,862,730,489,156,-1,,0.16734724742891713,0.3470790378006873,,,1351,886
201,201,3,1,20,1,0,0,862,730,489,156,-1,,0.16734724742891713,0.3470790378006873,,,1351,886
202,202,4,1,20,1,1,0,862,730,489,26,-1,,0.16734724742891713,0.31915807560137455,,,1351,756
203,203,5,1,20,1,1,1,862,730,44,26,96,(74),0.1336963097398669,0.31915807560137455,,,906,756
204,204,5,1,20,1,1,2,923,732,163,23,93,Representative:,0.15192075015124018,0.31937285223367695,,,1086,755
205,205,5,1,20,1,1,3,1095,732,120,18,84,Griinecker,0.17468239564428312,0.31829896907216493,representative_line_1_eu,Gr‚àö¬∫necker,1215,750
206,206,5,1,20,1,1,4,1223,732,78,18,92,Patent-,0.190865093768905,0.31829896907216493,representative_line_1_eu,Patent-,1301,750
207,207,5,1,20,1,1,5,1310,732,41,18,96,und,0.20122504537205083,0.31829896907216493,representative_line_1_eu,und,1351,750
208,208,4,1,20,1,2,0,923,765,164,18,-1,,0.15199637023593465,0.3324742268041237,,,1087,783
209,209,5,1,20,1,2,1,923,765,164,18,81,Rechtsanwalte,0.15199637023593465,0.3324742268041237,,,1087,783
210,210,4,1,20,1,3,0,923,797,121,19,-1,,0.14874470659407138,0.34643470790378006,,,1044,816
211,211,5,1,20,1,3,1,923,797,61,19,92,PartG,0.1442075015124017,0.34643470790378006,,,984,816
212,212,5,1,20,1,3,2,994,797,50,19,93,mbB,0.1541137326073805,0.34643470790378006,,,1044,816
213,213,4,1,20,1,4,0,923,830,182,23,-1,,0.15335753176043557,0.36146907216494845,,,1105,853
214,214,5,1,20,1,4,1,923,830,162,23,87,LeopoldstraRe,0.15184513006654568,0.36146907216494845,,,1085,853
215,215,5,1,20,1,4,2,1093,830,12,18,97,4,0.16621294615849969,0.3603951890034364,,,1105,848
216,216,4,1,20,1,5,0,922,863,231,23,-1,,0.15691167574107684,0.3756443298969072,,,1153,886
217,217,5,1,20,1,5,1,922,863,64,18,93,80802,0.1442831215970962,0.3745704467353952,,,986,881
218,218,5,1,20,1,5,2,996,863,101,18,85,Miinchen,0.15827283726557773,0.3745704467353952,,,1097,881
219,219,5,1,20,1,5,3,1107,863,46,23,95,(DE),0.17090139140955837,0.3756443298969072,,,1153,886
220,220,2,1,21,0,0,0,862,929,582,116,-1,,0.17437991530550515,0.42396907216494845,,,1444,1045
221,221,3,1,21,1,0,0,862,929,582,116,-1,,0.17437991530550515,0.42396907216494845,,,1444,1045
222,222,4,1,21,1,1,0,862,929,99,18,-1,,0.13785541439806412,0.4029209621993127,,,961,947
223,223,5,1,21,1,1,1,862,929,99,18,96,Remarks:,0.13785541439806412,0.4029209621993127,,,961,947
224,224,4,1,21,1,2,0,922,961,477,23,-1,,0.17551421657592256,0.4177405498281787,,,1399,984
225,225,5,1,21,1,2,1,922,961,43,19,96,This,0.1426950998185118,0.4168814432989691,,,965,980
226,226,5,1,21,1,2,2,974,961,111,23,96,application,0.15570175438596492,0.4177405498281787,,,1085,984
227,227,5,1,21,1,2,3,1093,966,42,14,96,was,0.16848154869933454,0.4179553264604811,,,1135,980
228,228,5,1,21,1,2,4,1142,961,43,19,96,filed,0.17596793708408953,0.4168814432989691,,,1185,980
229,229,5,1,21,1,2,5,1193,966,25,14,96,on,0.1823200241984271,0.4179553264604811,,,1218,980
230,230,5,1,21,1,2,6,1226,961,121,19,96,22-06-2018,0.19457047791893528,0.4168814432989691,,,1347,980
231,231,5,1,21,1,2,7,1356,966,23,14,95,as,0.20682093163944343,0.4179553264604811,,,1379,980
232,232,5,1,21,1,2,8,1388,966,11,14,95,a,0.21075317604355717,0.4179553264604811,,,1399,980
233,233,4,1,21,1,3,0,922,994,522,23,-1,,0.17891712038717483,0.4319158075601375,,,1444,1017
234,234,5,1,21,1,3,1,922,994,96,18,96,divisional,0.14670296430732002,0.43084192439862545,,,1018,1012
235,235,5,1,21,1,3,2,1026,994,112,23,96,application,0.16364186327888688,0.4319158075601375,,,1138,1017
236,236,5,1,21,1,3,3,1147,995,19,17,96,to,0.17490925589836662,0.43105670103092786,,,1166,1012
237,237,5,1,21,1,3,4,1174,994,31,18,96,the,0.17990018148820328,0.43084192439862545,,,1205,1012
238,238,5,1,21,1,3,5,1214,994,112,23,96,application,0.19207501512401695,0.4319158075601375,,,1326,1017
239,239,5,1,21,1,3,6,1336,994,108,18,96,mentioned,0.2102238354506957,0.43084192439862545,,,1444,1012
240,240,4,1,21,1,4,0,923,1027,209,18,-1,,0.15539927404718692,0.44501718213058417,,,1132,1045
241,241,5,1,21,1,4,1,923,1027,50,18,92,under,0.14337568058076225,0.44501718213058417,,,973,1045
242,242,5,1,21,1,4,2,975,1027,61,18,85,INID,0.15207199032062915,0.44501718213058417,,,1036,1045
243,243,5,1,21,1,4,3,1044,1027,50,18,96,code,0.16167574107683,0.44501718213058417,,,1094,1045
244,244,5,1,21,1,4,4,1103,1027,29,18,96,62.,0.16901088929219601,0.44501718213058417,,,1132,1045
245,245,2,1,22,0,0,0,224,1077,1243,8,-1,,0.1278735632183908,0.4643470790378007,,,1467,1085
246,246,3,1,22,1,0,0,224,1077,1243,8,-1,,0.1278735632183908,0.4643470790378007,,,1467,1085
247,247,4,1,22,1,1,0,224,1077,1243,8,-1,,0.1278735632183908,0.4643470790378007,,,1467,1085
248,248,5,1,22,1,1,1,224,1077,1243,8,95, ,0.1278735632183908,0.4643470790378007,,,1467,1085
249,249,2,1,23,0,0,0,225,1099,584,521,-1,,0.07819116757410768,0.5839776632302406,,,809,1620
250,250,3,1,23,1,0,0,225,1099,584,521,-1,,0.07819116757410768,0.5839776632302406,,,809,1620
251,251,4,1,23,1,1,0,225,1099,580,26,-1,,0.0778886872353297,0.47766323024054985,,,805,1125
252,252,5,1,23,1,1,1,225,1099,45,26,88,(54),0.037431941923774956,0.47766323024054985,,,270,1125
253,253,5,1,23,1,1,2,316,1099,167,21,88,HEADPHONE,0.06042044767090139,0.47658934707903783,title_line_1,HEADPHONE,483,1120
254,254,5,1,23,1,1,3,493,1099,138,21,96,LISTENING,0.08499697519661222,0.47658934707903783,title_line_1,LISTENING,631,1120
255,255,5,1,23,1,1,4,640,1099,165,21,95,APPARATUS,0.10927102238354507,0.47658934707903783,title_line_1,APPARATUS,805,1120
256,256,4,1,23,1,2,0,225,1173,582,27,-1,,0.0780399274047187,0.5096649484536082,,,807,1200
257,257,5,1,23,1,2,1,225,1173,45,27,93,(57),0.037431941923774956,0.5096649484536082,,,270,1200
258,258,5,1,23,1,2,2,316,1175,17,19,52,In,0.04907743496672716,0.5088058419243986,,,333,1194
259,259,5,1,23,1,2,3,345,1176,18,18,91,at,0.05353901996370236,0.509020618556701,,,363,1194
260,260,5,1,23,1,2,4,374,1175,49,19,96,least,0.0602692075015124,0.5088058419243986,,,423,1194
261,261,5,1,23,1,2,5,432,1180,39,14,96,one,0.06828493647912885,0.5098797250859106,,,471,1194
262,262,5,1,23,1,2,6,481,1175,135,22,96,"embodiment,",0.08295523290986086,0.5094501718213058,,,616,1197
263,263,5,1,23,1,2,7,628,1180,12,14,96,a,0.09588626739261948,0.5098797250859106,,,640,1194
264,264,5,1,23,1,2,8,651,1175,103,24,93,headphone,0.10624621899576528,0.5098797250859106,,,754,1199
265,265,5,1,23,1,2,9,756,1175,51,19,89,lis-,0.11819419237749547,0.5088058419243986,,,807,1194
266,266,4,1,23,1,3,0,225,1208,582,23,-1,,0.0780399274047187,0.523840206185567,,,807,1231
267,267,5,1,23,1,3,1,225,1208,62,23,92,tening,0.03871748336358137,0.523840206185567,,,287,1231
268,268,5,1,23,1,3,2,299,1209,104,22,96,apparatus,0.05308529945553539,0.5240549828178694,,,403,1231
269,269,5,1,23,1,3,3,414,1208,91,23,96,including,0.06949485783424078,0.523840206185567,,,505,1231
270,270,5,1,23,1,3,4,516,1213,24,14,96,an,0.07985480943738657,0.5240549828178694,,,540,1227
271,271,5,1,23,1,3,5,551,1208,57,19,96,audio,0.08764367816091954,0.5229810996563574,,,608,1227
272,272,5,1,23,1,3,6,619,1208,84,23,96,listening,0.0999697519661222,0.523840206185567,,,703,1231
273,273,5,1,23,1,3,7,714,1208,67,19,96,device,0.11305202661826981,0.5229810996563574,,,781,1227
274,274,5,1,23,1,3,8,792,1208,15,19,96,is,0.12091651542649728,0.5229810996563574,,,807,1227
275,275,4,1,23,1,4,0,226,1241,581,23,-1,,0.07811554748941318,0.5380154639175257,,,807,1264
276,276,5,1,23,1,4,1,226,1241,95,23,96,provided.,0.041364186327888686,0.5380154639175257,,,321,1264
277,277,5,1,23,1,4,2,331,1241,39,18,96,The,0.0530096793708409,0.5369415807560137,,,370,1259
278,278,5,1,23,1,4,3,380,1241,57,18,96,audio,0.0617816091954023,0.5369415807560137,,,437,1259
279,279,5,1,23,1,4,4,448,1241,84,23,96,listening,0.07410768300060495,0.5380154639175257,,,532,1264
280,280,5,1,23,1,4,5,542,1241,68,18,96,device,0.08711433756805807,0.5369415807560137,,,610,1259
281,281,5,1,23,1,4,6,621,1241,15,18,96,is,0.09505444646098003,0.5369415807560137,,,636,1259
282,282,5,1,23,1,4,7,646,1241,133,23,96,programmed,0.10775862068965517,0.5380154639175257,,,779,1264
283,283,5,1,23,1,4,8,788,1242,19,17,96,to,0.1206140350877193,0.5371563573883161,,,807,1259
284,284,4,1,23,1,5,0,225,1274,584,23,-1,,0.07819116757410768,0.5521907216494846,,,809,1297
285,285,5,1,23,1,5,1,225,1274,75,18,96,receive,0.0397005444646098,0.5511168384879725,,,300,1292
286,286,5,1,23,1,5,2,310,1278,25,14,96,an,0.04877495462794918,0.5519759450171822,,,335,1292
287,287,5,1,23,1,5,3,346,1274,93,23,96,incoming,0.05936176648517846,0.5521907216494846,,,439,1297
288,288,5,1,23,1,5,4,449,1274,85,18,96,ambient,0.07433454325468844,0.5511168384879725,,,534,1292
289,289,5,1,23,1,5,5,543,1274,56,18,96,audio,0.08635813672111313,0.5511168384879725,,,599,1292
290,290,5,1,23,1,5,6,610,1274,60,23,96,signal,0.09679370840895342,0.5521907216494846,,,670,1297
291,291,5,1,23,1,5,7,682,1274,97,18,96,indicative,0.11048094373865698,0.5511168384879725,,,779,1292
292,292,5,1,23,1,5,8,788,1274,21,18,97,of,0.12076527525710828,0.5511168384879725,,,809,1292
293,293,4,1,23,1,6,0,225,1306,582,23,-1,,0.0780399274047187,0.5659364261168385,,,807,1329
294,294,5,1,23,1,6,1,225,1311,24,14,94,an,0.03584392014519056,0.5661512027491409,,,249,1325
295,295,5,1,23,1,6,2,258,1306,82,19,94,external,0.04522081064730792,0.5650773195876289,,,340,1325
296,296,5,1,23,1,6,3,348,1306,84,19,96,ambient,0.05898366606170599,0.5650773195876289,,,432,1325
297,297,5,1,23,1,6,4,440,1306,62,19,96,sound,0.07123411978221415,0.5650773195876289,,,502,1325
298,298,5,1,23,1,6,5,510,1311,24,14,96,and,0.07894736842105263,0.5661512027491409,,,534,1325
299,299,5,1,23,1,6,6,536,1306,38,19,96,to,0.08393829401088929,0.5650773195876289,,,574,1325
300,300,5,1,23,1,6,7,582,1307,51,18,96,store,0.09187840290381125,0.5652920962199313,,,633,1325
301,301,5,1,23,1,6,8,641,1311,11,14,96,a,0.09777676950998185,0.5661512027491409,,,652,1325
302,302,5,1,23,1,6,9,661,1306,81,23,96,plurality,0.10609497882637628,0.5659364261168385,,,742,1329
303,303,5,1,23,1,6,10,748,1306,20,19,92,of,0.11464004839685421,0.5650773195876289,,,768,1325
304,304,5,1,23,1,6,11,774,1306,33,19,92,de-,0.11955535390199637,0.5650773195876289,,,807,1325
305,305,4,1,23,1,7,0,225,1339,583,23,-1,,0.07811554748941318,0.5801116838487973,,,808,1362
306,306,5,1,23,1,7,1,225,1339,49,18,96,sired,0.037734422262552934,0.5790378006872853,,,274,1357
307,307,5,1,23,1,7,2,282,1339,57,18,96,audio,0.04696007259528131,0.5790378006872853,,,339,1357
308,308,5,1,23,1,7,3,346,1339,84,23,96,triggers.,0.05868118572292801,0.5801116838487973,,,430,1362
309,309,5,1,23,1,7,4,438,1339,40,18,96,The,0.0692679975801573,0.5790378006872853,,,478,1357
310,310,5,1,23,1,7,5,485,1339,43,18,96,audio,0.0766031457955233,0.5790378006872853,,,528,1357
311,311,5,1,23,1,7,6,530,1339,104,23,96,listening,0.08802177858439202,0.5801116838487973,,,634,1362
312,312,5,1,23,1,7,7,642,1339,68,18,96,device,0.10223835450695705,0.5790378006872853,,,710,1357
313,313,5,1,23,1,7,8,718,1339,15,18,93,is,0.10972474289171204,0.5790378006872853,,,733,1357
314,314,5,1,23,1,7,9,739,1339,69,18,96,further,0.11698427102238354,0.5790378006872853,,,808,1357
315,315,4,1,23,1,8,0,226,1372,581,23,-1,,0.07811554748941318,0.594286941580756,,,807,1395
316,316,5,1,23,1,8,1,226,1372,132,23,96,programmed,0.044162129461584994,0.594286941580756,,,358,1395
317,317,5,1,23,1,8,2,367,1373,18,18,96,to,0.056866303690260134,0.5936426116838488,,,385,1391
318,318,5,1,23,1,8,3,394,1377,91,18,96,compare,0.06647005444646098,0.595360824742268,,,485,1395
319,319,5,1,23,1,8,4,493,1372,32,19,96,the,0.07698124621899577,0.5934278350515464,,,525,1391
320,320,5,1,23,1,8,5,534,1372,83,19,96,external,0.08703871748336359,0.5934278350515464,,,617,1391
321,321,5,1,23,1,8,6,625,1372,84,19,96,ambient,0.10087719298245613,0.5934278350515464,,,709,1391
322,322,5,1,23,1,8,7,717,1372,63,19,96,sound,0.1132032667876588,0.5934278350515464,,,780,1391
323,323,5,1,23,1,8,8,788,1373,19,18,96,to,0.1206140350877193,0.5936426116838488,,,807,1391
324,324,4,1,23,1,9,0,225,1405,582,23,-1,,0.0780399274047187,0.6084621993127147,,,807,1428
325,325,5,1,23,1,9,1,225,1405,31,18,97,the,0.03637326073805203,0.6073883161512027,,,256,1423
326,326,5,1,23,1,9,2,267,1405,80,23,96,plurality,0.046430732002419844,0.6084621993127147,,,347,1428
327,327,5,1,23,1,9,3,357,1405,20,18,96,of,0.055505142165759226,0.6073883161512027,,,377,1423
328,328,5,1,23,1,9,4,385,1405,76,18,96,desired,0.06397459165154265,0.6073883161512027,,,461,1423
329,329,5,1,23,1,9,5,472,1405,57,18,96,audio,0.07569570477918935,0.6073883161512027,,,529,1423
330,330,5,1,23,1,9,6,538,1405,78,23,96,triggers,0.08726557773744707,0.6084621993127147,,,616,1428
331,331,5,1,23,1,9,7,626,1405,38,18,96,and,0.09754990925589836,0.6073883161512027,,,664,1423
332,332,5,1,23,1,9,8,674,1406,18,17,96,to,0.10329703569267998,0.6076030927835051,,,692,1423
333,333,5,1,23,1,9,9,702,1405,84,18,96,transmit,0.11252268602540835,0.6073883161512027,,,786,1423
334,334,5,1,23,1,9,10,796,1410,11,13,96,a,0.12121899576527526,0.6084621993127147,,,807,1423
335,335,4,1,23,1,10,0,226,1438,581,23,-1,,0.07811554748941318,0.6226374570446735,,,807,1461
336,336,5,1,23,1,10,1,226,1438,111,18,96,notification,0.04257410768300061,0.6215635738831615,,,337,1456
337,337,5,1,23,1,10,2,345,1438,60,23,96,signal,0.05671506352087114,0.6226374570446735,,,405,1461
338,338,5,1,23,1,10,3,412,1438,19,18,96,to,0.06374773139745916,0.6215635738831615,,,431,1456
339,339,5,1,23,1,10,4,439,1438,117,23,96,headphones,0.07524198427102238,0.6226374570446735,,,556,1461
340,340,5,1,23,1,10,5,558,1438,34,18,96,in,0.08696309739866909,0.6215635738831615,,,592,1456
341,341,5,1,23,1,10,6,600,1442,83,19,96,response,0.0970205686630369,0.6234965635738832,,,683,1461
342,342,5,1,23,1,10,7,684,1438,37,18,96,to,0.10624621899576528,0.6215635738831615,,,721,1456
343,343,5,1,23,1,10,8,728,1438,32,18,93,the,0.11252268602540835,0.6215635738831615,,,760,1456
344,344,5,1,23,1,10,9,768,1442,39,14,93,am-,0.1191016333938294,0.6224226804123711,,,807,1456
345,345,4,1,23,1,11,0,226,1470,581,23,-1,,0.07811554748941318,0.6363831615120275,,,807,1493
346,346,5,1,23,1,11,1,226,1470,50,19,93,bient,0.03796128251663642,0.6355240549828178,,,276,1489
347,347,5,1,23,1,11,2,280,1470,63,19,96,sound,0.047111312764670295,0.6355240549828178,,,343,1489
348,348,5,1,23,1,11,3,350,1470,55,23,96,being,0.05709316394434362,0.6363831615120275,,,405,1493
349,349,5,1,23,1,11,4,411,1470,96,23,95,generally,0.06941923774954628,0.6363831615120275,,,507,1493
350,350,5,1,23,1,11,5,513,1470,59,19,96,similar,0.08204779189352691,0.6355240549828178,,,572,1489
351,351,5,1,23,1,11,6,573,1471,30,18,95,to,0.08892921960072596,0.6357388316151202,,,603,1489
352,352,5,1,23,1,11,7,609,1475,11,14,92,a,0.09293708408953417,0.6365979381443299,,,620,1489
353,353,5,1,23,1,11,8,625,1470,39,19,92,first,0.09747428917120388,0.6355240549828178,,,664,1489
354,354,5,1,23,1,11,9,668,1470,76,19,95,desired,0.10677555958862674,0.6355240549828178,,,744,1489
355,355,5,1,23,1,11,10,750,1470,57,19,96,audio,0.1177404718693285,0.6355240549828178,,,807,1489
356,356,4,1,23,1,12,0,225,1503,582,23,-1,,0.0780399274047187,0.6505584192439863,,,807,1526
357,357,5,1,23,1,12,1,225,1503,58,23,96,trigger,0.038415003024803385,0.6505584192439863,,,283,1526
358,358,5,1,23,1,12,2,285,1503,31,18,96,of,0.04544767090139141,0.6494845360824743,,,316,1521
359,359,5,1,23,1,12,3,320,1503,32,18,96,the,0.050816696914700546,0.6494845360824743,,,352,1521
360,360,5,1,23,1,12,4,359,1503,80,23,96,plurality,0.0603448275862069,0.6505584192439863,,,439,1526
361,361,5,1,23,1,12,5,443,1503,20,18,96,of,0.06851179673321234,0.6494845360824743,,,463,1521
362,362,5,1,23,1,12,6,468,1503,76,18,96,desired,0.0765275257108288,0.6494845360824743,,,544,1521
363,363,5,1,23,1,12,7,550,1503,43,18,96,audio,0.08643375680580763,0.6494845360824743,,,593,1521
364,364,5,1,23,1,12,8,595,1503,101,23,96,triggers.,0.09762552934059286,0.6505584192439863,,,696,1526
365,365,5,1,23,1,12,9,702,1503,40,18,93,The,0.10919540229885058,0.6494845360824743,,,742,1521
366,366,5,1,23,1,12,10,749,1503,58,18,93,head-,0.117664851784634,0.6494845360824743,,,807,1521
367,367,4,1,23,1,13,0,226,1536,581,23,-1,,0.07811554748941318,0.664733676975945,,,807,1559
368,368,5,1,23,1,13,1,226,1536,63,23,95,phones,0.03894434361766485,0.664733676975945,,,289,1559
369,369,5,1,23,1,13,2,291,1540,53,14,95,are,0.04801875378100424,0.6645189003436426,,,344,1554
370,370,5,1,23,1,13,3,355,1540,119,19,96,programmed,0.06268905021173624,0.6655927835051546,,,474,1559
371,371,5,1,23,1,13,4,476,1536,40,18,96,to,0.0750151240169389,0.663659793814433,,,516,1554
372,372,5,1,23,1,13,5,526,1536,76,23,96,provide,0.0852994555353902,0.664733676975945,,,602,1559
373,373,5,1,23,1,13,6,612,1540,24,14,96,an,0.09437386569872959,0.6645189003436426,,,636,1554
374,374,5,1,23,1,13,7,647,1536,56,18,96,audio,0.10208711433756806,0.663659793814433,,,703,1554
375,375,5,1,23,1,13,8,713,1536,46,18,96,alert,0.11131276467029642,0.663659793814433,,,759,1554
376,376,5,1,23,1,13,9,767,1536,19,18,84,to,0.11743799153055051,0.663659793814433,,,786,1554
377,377,5,1,23,1,13,10,796,1540,11,14,84,a,0.12121899576527526,0.6645189003436426,,,807,1554
378,378,4,1,23,1,14,0,226,1569,582,23,-1,,0.07819116757410768,0.6789089347079038,,,808,1592
379,379,5,1,23,1,14,1,226,1574,44,13,96,user,0.03750756200846945,0.6789089347079038,,,270,1587
380,380,5,1,23,1,14,2,281,1570,19,17,96,to,0.043935269207501515,0.6780498281786942,,,300,1587
381,381,5,1,23,1,14,3,313,1569,79,18,96,indicate,0.053312159709618875,0.6778350515463918,,,392,1587
382,382,5,1,23,1,14,4,404,1569,31,18,96,the,0.06344525105868118,0.6778350515463918,,,435,1587
383,383,5,1,23,1,14,5,448,1574,96,18,96,presence,0.0750151240169389,0.6799828178694158,,,544,1592
384,384,5,1,23,1,14,6,555,1569,20,18,96,of,0.08545069570477919,0.6778350515463918,,,575,1587
385,385,5,1,23,1,14,7,585,1569,32,18,96,the,0.09089534180278282,0.6778350515463918,,,617,1587
386,386,5,1,23,1,14,8,628,1569,84,18,96,external,0.1013309134906231,0.6778350515463918,,,712,1587
387,387,5,1,23,1,14,9,724,1569,84,18,96,ambient,0.11584996975196613,0.6778350515463918,,,808,1587
388,388,4,1,23,1,15,0,225,1602,69,18,-1,,0.03924682395644283,0.6920103092783505,,,294,1620
389,389,5,1,23,1,15,1,225,1602,69,18,95,sound.,0.03924682395644283,0.6920103092783505,,,294,1620
390,390,2,1,24,0,0,0,942,1279,146,4,-1,,0.15350877192982457,0.5502577319587629,,,1088,1283
391,391,3,1,24,1,0,0,942,1279,146,4,-1,,0.15350877192982457,0.5502577319587629,,,1088,1283
392,392,4,1,24,1,1,0,942,1279,146,4,-1,,0.15350877192982457,0.5502577319587629,,,1088,1283
393,393,5,1,24,1,1,1,942,1279,146,4,95, ,0.15350877192982457,0.5502577319587629,,,1088,1283
394,394,2,1,25,0,0,0,942,1280,2,48,-1,,0.1426194797338173,0.5601374570446735,,,944,1328
395,395,3,1,25,1,0,0,942,1280,2,48,-1,,0.1426194797338173,0.5601374570446735,,,944,1328
396,396,4,1,25,1,1,0,942,1280,2,48,-1,,0.1426194797338173,0.5601374570446735,,,944,1328
397,397,5,1,25,1,1,1,942,1280,2,48,95, ,0.1426194797338173,0.5601374570446735,,,944,1328
398,398,2,1,26,0,0,0,1086,1280,2,48,-1,,0.16439806412583183,0.5601374570446735,,,1088,1328
399,399,3,1,26,1,0,0,1086,1280,2,48,-1,,0.16439806412583183,0.5601374570446735,,,1088,1328
400,400,4,1,26,1,1,0,1086,1280,2,48,-1,,0.16439806412583183,0.5601374570446735,,,1088,1328
401,401,5,1,26,1,1,1,1086,1280,2,48,95, ,0.16439806412583183,0.5601374570446735,,,1088,1328
402,402,2,1,27,0,0,0,942,1325,146,3,-1,,0.15350877192982457,0.5698024054982818,,,1088,1328
403,403,3,1,27,1,0,0,942,1325,146,3,-1,,0.15350877192982457,0.5698024054982818,,,1088,1328
404,404,4,1,27,1,1,0,942,1325,146,3,-1,,0.15350877192982457,0.5698024054982818,,,1088,1328
405,405,5,1,27,1,1,1,942,1325,146,3,95, ,0.15350877192982457,0.5698024054982818,,,1088,1328
406,406,2,1,28,0,0,0,942,1614,146,4,-1,,0.15350877192982457,0.6941580756013745,,,1088,1618
407,407,3,1,28,1,0,0,942,1614,146,4,-1,,0.15350877192982457,0.6941580756013745,,,1088,1618
408,408,4,1,28,1,1,0,942,1614,146,4,-1,,0.15350877192982457,0.6941580756013745,,,1088,1618
409,409,5,1,28,1,1,1,942,1614,146,4,95, ,0.15350877192982457,0.6941580756013745,,,1088,1618
410,410,2,1,29,0,0,0,942,1615,2,74,-1,,0.1426194797338173,0.7096219931271478,,,944,1689
411,411,3,1,29,1,0,0,942,1615,2,74,-1,,0.1426194797338173,0.7096219931271478,,,944,1689
412,412,4,1,29,1,1,0,942,1615,2,74,-1,,0.1426194797338173,0.7096219931271478,,,944,1689
413,413,5,1,29,1,1,1,942,1615,2,74,95, ,0.1426194797338173,0.7096219931271478,,,944,1689
414,414,2,1,30,0,0,0,1086,1615,2,73,-1,,0.16439806412583183,0.7094072164948454,,,1088,1688
415,415,3,1,30,1,0,0,1086,1615,2,73,-1,,0.16439806412583183,0.7094072164948454,,,1088,1688
416,416,4,1,30,1,1,0,1086,1615,2,73,-1,,0.16439806412583183,0.7094072164948454,,,1088,1688
417,417,5,1,30,1,1,1,1086,1615,2,73,95, ,0.16439806412583183,0.7094072164948454,,,1088,1688
418,418,2,1,31,0,0,0,942,1685,146,4,-1,,0.15350877192982457,0.7246563573883161,,,1088,1689
419,419,3,1,31,1,0,0,942,1685,146,4,-1,,0.15350877192982457,0.7246563573883161,,,1088,1689
420,420,4,1,31,1,1,0,942,1685,146,4,-1,,0.15350877192982457,0.7246563573883161,,,1088,1689
421,421,5,1,31,1,1,1,942,1685,146,4,95, ,0.15350877192982457,0.7246563573883161,,,1088,1689
422,422,2,1,32,0,0,0,1242,1729,145,3,-1,,0.19880520266182697,0.7433419243986255,,,1387,1732
423,423,3,1,32,1,0,0,1242,1729,145,3,-1,,0.19880520266182697,0.7433419243986255,,,1387,1732
424,424,4,1,32,1,1,0,1242,1729,145,3,-1,,0.19880520266182697,0.7433419243986255,,,1387,1732
425,425,5,1,32,1,1,1,1242,1729,145,3,95, ,0.19880520266182697,0.7433419243986255,,,1387,1732
426,426,2,1,33,0,0,0,897,1791,557,240,-1,,0.17778281911675742,0.8208762886597938,,,1454,2031
427,427,3,1,33,1,0,0,897,1791,557,240,-1,,0.17778281911675742,0.8208762886597938,,,1454,2031
428,428,4,1,33,1,1,0,897,1791,557,240,-1,,0.17778281911675742,0.8208762886597938,,,1454,2031
429,429,5,1,33,1,1,1,897,1791,557,240,95,   ,0.17778281911675742,0.8208762886597938,,,1454,2031
430,430,5,1,33,1,1,2,1384,1791,70,60,95, ,0.21460980036297642,0.7822164948453608,,,1454,1851
431,431,2,1,34,0,0,0,1241,1774,146,4,-1,,0.1987295825771325,0.7628865979381443,,,1387,1778
432,432,3,1,34,1,0,0,1241,1774,146,4,-1,,0.1987295825771325,0.7628865979381443,,,1387,1778
433,433,4,1,34,1,1,0,1241,1774,146,4,-1,,0.1987295825771325,0.7628865979381443,,,1387,1778
434,434,5,1,34,1,1,1,1241,1774,146,4,95, ,0.1987295825771325,0.7628865979381443,,,1387,1778
435,435,2,1,35,0,0,0,1242,1801,145,4,-1,,0.19880520266182697,0.7744845360824743,,,1387,1805
436,436,3,1,35,1,0,0,1242,1801,145,4,-1,,0.19880520266182697,0.7744845360824743,,,1387,1805
437,437,4,1,35,1,1,0,1242,1801,145,4,-1,,0.19880520266182697,0.7744845360824743,,,1387,1805
438,438,5,1,35,1,1,1,1242,1801,145,4,95, ,0.19880520266182697,0.7744845360824743,,,1387,1805
439,439,2,1,36,0,0,0,942,1813,146,4,-1,,0.15350877192982457,0.779639175257732,,,1088,1817
440,440,3,1,36,1,0,0,942,1813,146,4,-1,,0.15350877192982457,0.779639175257732,,,1088,1817
441,441,4,1,36,1,1,0,942,1813,146,4,-1,,0.15350877192982457,0.779639175257732,,,1088,1817
442,442,5,1,36,1,1,1,942,1813,146,4,95, ,0.15350877192982457,0.779639175257732,,,1088,1817
443,443,2,1,37,0,0,0,1245,1806,168,46,-1,,0.20099818511796733,0.7856529209621993,,,1413,1852
444,444,3,1,37,1,0,0,1245,1806,168,46,-1,,0.20099818511796733,0.7856529209621993,,,1413,1852
445,445,4,1,37,1,1,0,1245,1806,94,14,-1,,0.19540229885057472,0.7787800687285223,,,1339,1820
446,446,5,1,37,1,1,1,1245,1806,34,14,0,Search,0.190865093768905,0.7787800687285223,,,1279,1820
447,447,5,1,37,1,1,2,1283,1806,13,14,78,for,0.19502419842710225,0.7787800687285223,,,1296,1820
448,448,5,1,37,1,1,3,1298,1809,6,11,78,a,0.1967634603750756,0.7794243986254296,,,1304,1820
449,449,5,1,37,1,1,4,1307,1807,23,13,69,First,0.19941016333938294,0.7789948453608248,,,1330,1820
450,450,5,1,37,1,1,5,1332,1807,7,13,69,Fr,0.20198124621899577,0.7789948453608248,,,1339,1820
451,451,4,1,37,1,2,0,1256,1809,157,27,-1,,0.20183000604960677,0.782860824742268,,,1413,1836
452,452,5,1,37,1,2,1,1256,1823,37,13,48,wing,0.1927555958862674,0.7858676975945017,,,1293,1836
453,453,5,1,37,1,2,2,1297,1809,59,27,0,Pessomeed,0.20062008469449485,0.782860824742268,,,1356,1836
454,454,5,1,37,1,2,3,1355,1809,58,27,0,|,0.20931639443436176,0.782860824742268,,,1413,1836
455,455,4,1,37,1,3,0,1286,1839,58,13,-1,,0.19888082274652147,0.7927405498281787,,,1344,1852
456,456,5,1,37,1,3,1,1286,1839,23,13,92,Time,0.19623411978221417,0.7927405498281787,,,1309,1852
457,457,5,1,37,1,3,2,1312,1839,32,13,94,Frame,0.20084694494857835,0.7927405498281787,,,1344,1852
458,458,2,1,38,0,0,0,1241,1730,3,129,-1,,0.18791591046581974,0.7708333333333334,,,1244,1859
459,459,3,1,38,1,0,0,1241,1730,3,129,-1,,0.18791591046581974,0.7708333333333334,,,1244,1859
460,460,4,1,38,1,1,0,1241,1730,3,129,-1,,0.18791591046581974,0.7708333333333334,,,1244,1859
461,461,5,1,38,1,1,1,1241,1730,3,129,95, ,0.18791591046581974,0.7708333333333334,,,1244,1859
462,462,2,1,39,0,0,0,1384,1730,4,129,-1,,0.20961887477313976,0.7708333333333334,,,1388,1859
463,463,3,1,39,1,0,0,1384,1730,4,129,-1,,0.20961887477313976,0.7708333333333334,,,1388,1859
464,464,4,1,39,1,1,0,1384,1730,4,129,-1,,0.20961887477313976,0.7708333333333334,,,1388,1859
465,465,5,1,39,1,1,1,1384,1730,4,129,95, ,0.20961887477313976,0.7708333333333334,,,1388,1859
466,466,2,1,40,0,0,0,942,1814,2,56,-1,,0.1426194797338173,0.7912371134020618,,,944,1870
467,467,3,1,40,1,0,0,942,1814,2,56,-1,,0.1426194797338173,0.7912371134020618,,,944,1870
468,468,4,1,40,1,1,0,942,1814,2,56,-1,,0.1426194797338173,0.7912371134020618,,,944,1870
469,469,5,1,40,1,1,1,942,1814,2,56,95, ,0.1426194797338173,0.7912371134020618,,,944,1870
470,470,2,1,41,0,0,0,1241,1856,146,3,-1,,0.1987295825771325,0.7978951890034365,,,1387,1859
471,471,3,1,41,1,0,0,1241,1856,146,3,-1,,0.1987295825771325,0.7978951890034365,,,1387,1859
472,472,4,1,41,1,1,0,1241,1856,146,3,-1,,0.1987295825771325,0.7978951890034365,,,1387,1859
473,473,5,1,41,1,1,1,1241,1856,146,3,95, ,0.1987295825771325,0.7978951890034365,,,1387,1859
474,474,2,1,42,0,0,0,1085,1615,4,255,-1,,0.16439806412583183,0.7484965635738832,,,1089,1870
475,475,3,1,42,1,0,0,1085,1615,4,255,-1,,0.16439806412583183,0.7484965635738832,,,1089,1870
476,476,4,1,42,1,1,0,1085,1615,4,255,-1,,0.16439806412583183,0.7484965635738832,,,1089,1870
477,477,5,1,42,1,1,1,1085,1615,4,255,95, ,0.16439806412583183,0.7484965635738832,,,1089,1870
478,478,2,1,43,0,0,0,942,1868,146,3,-1,,0.15350877192982457,0.8030498281786942,,,1088,1871
479,479,3,1,43,1,0,0,942,1868,146,3,-1,,0.15350877192982457,0.8030498281786942,,,1088,1871
480,480,4,1,43,1,1,0,942,1868,146,3,-1,,0.15350877192982457,0.8030498281786942,,,1088,1871
481,481,5,1,43,1,1,1,942,1868,146,3,95, ,0.15350877192982457,0.8030498281786942,,,1088,1871
482,482,2,1,44,0,0,0,1452,1303,5,628,-1,,0.21997882637628555,0.6945876288659794,,,1457,1931
483,483,3,1,44,1,0,0,1452,1303,5,628,-1,,0.21997882637628555,0.6945876288659794,,,1457,1931
484,484,4,1,44,1,1,0,1452,1303,5,628,-1,,0.21997882637628555,0.6945876288659794,,,1457,1931
485,485,5,1,44,1,1,1,1452,1303,5,628,95, ,0.21997882637628555,0.6945876288659794,,,1457,1931
486,486,2,1,45,0,0,0,981,1977,65,29,-1,,0.15328191167574107,0.8554553264604811,,,1046,2006
487,487,3,1,45,1,0,0,981,1977,65,29,-1,,0.15328191167574107,0.8554553264604811,,,1046,2006
488,488,4,1,45,1,1,0,981,1977,65,29,-1,,0.15328191167574107,0.8554553264604811,,,1046,2006
489,489,5,1,45,1,1,1,981,1977,65,29,83,Fig-5,0.15328191167574107,0.8554553264604811,,,1046,2006
490,490,2,1,46,0,0,0,716,2270,259,16,-1,,0.1278735632183908,0.9785223367697594,,,975,2286
491,491,3,1,46,1,0,0,716,2270,259,16,-1,,0.1278735632183908,0.9785223367697594,,,975,2286
492,492,4,1,46,1,1,0,716,2270,259,16,-1,,0.1278735632183908,0.9785223367697594,,,975,2286
493,493,5,1,46,1,1,1,716,2270,49,12,96,Printed,0.11199334543254688,0.9776632302405498,,,765,2282
494,494,5,1,46,1,1,2,771,2270,15,16,96,by,0.1177404718693285,0.9785223367697594,,,786,2286
495,495,5,1,46,1,1,3,792,2270,45,14,96,"Jouve,",0.12318511796733213,0.9780927835051546,,,837,2284
496,496,5,1,46,1,1,4,843,2270,41,12,96,75001,0.13059588626739263,0.9776632302405498,,,884,2282
497,497,5,1,46,1,1,5,893,2270,46,12,96,PARIS,0.1385359951603146,0.9776632302405498,,,939,2282
498,498,5,1,46,1,1,6,945,2270,30,16,95,(FR),0.14519056261343014,0.9785223367697594,,,975,2286
