,Unnamed: 0,level,page_num,block_num,par_num,line_num,word_num,left,top,width,height,conf,text,x,y,label,target,right,bottom
0,0,1,1,0,0,0,0,0,0,1653,2328,-1,,0.125,0.5,,,1653,2328
1,1,2,1,1,0,0,0,144,1905,31,328,-1,,0.02412280701754386,0.8887457044673539,,,175,2233
2,2,3,1,1,1,0,0,144,1905,31,328,-1,,0.02412280701754386,0.8887457044673539,,,175,2233
3,3,4,1,1,1,1,0,144,1905,31,328,-1,,0.02412280701754386,0.8887457044673539,,,175,2233
4,4,5,1,1,1,1,1,144,2179,30,54,96,EP,0.024047186932849365,0.947594501718213,,,174,2233
5,5,5,1,1,1,1,2,144,2142,31,21,95,3,0.02412280701754386,0.9246134020618557,,,175,2163
6,6,5,1,1,1,1,3,144,2055,31,71,96,398,0.02412280701754386,0.8979810996563574,,,175,2126
7,7,5,1,1,1,1,4,144,1969,31,70,93,628,0.02412280701754386,0.8608247422680413,,,175,2039
8,8,5,1,1,1,1,5,144,1905,30,50,88,A1,0.024047186932849365,0.8290378006872853,,,174,1955
9,9,2,1,2,0,0,0,429,153,88,28,-1,,0.07153660012099214,0.07173539518900343,,,517,181
10,10,3,1,2,1,0,0,429,153,88,28,-1,,0.07153660012099214,0.07173539518900343,,,517,181
11,11,4,1,2,1,1,0,429,153,88,16,-1,,0.07153660012099214,0.06915807560137457,,,517,169
12,12,5,1,2,1,1,1,429,153,88,16,84,Europaisches,0.07153660012099214,0.06915807560137457,,,517,169
13,13,4,1,2,1,2,0,429,170,71,11,-1,,0.07025105868118572,0.07538659793814433,,,500,181
14,14,5,1,2,1,2,1,429,170,71,11,96,Patentamt,0.07025105868118572,0.07538659793814433,,,500,181
15,15,2,1,3,0,0,0,429,196,89,28,-1,,0.07161222020568662,0.09020618556701031,,,518,224
16,16,3,1,3,1,0,0,429,196,89,28,-1,,0.07161222020568662,0.09020618556701031,,,518,224
17,17,4,1,3,1,1,0,429,196,63,15,-1,,0.06964609800362977,0.08741408934707903,,,492,211
18,18,5,1,3,1,1,1,429,196,63,15,95,European,0.06964609800362977,0.08741408934707903,,,492,211
19,19,4,1,3,1,2,0,429,212,89,12,-1,,0.07161222020568662,0.0936426116838488,,,518,224
20,20,5,1,3,1,2,1,429,213,43,11,96,Patent,0.06813369630973987,0.0938573883161512,,,472,224
21,21,5,1,3,1,2,2,478,212,40,12,90,Office,0.07531760435571688,0.0936426116838488,,,518,224
22,22,2,1,4,0,0,0,429,239,109,28,-1,,0.07312462189957653,0.10867697594501718,,,538,267
23,23,3,1,4,1,0,0,429,239,109,28,-1,,0.07312462189957653,0.10867697594501718,,,538,267
24,24,4,1,4,1,1,0,429,239,109,15,-1,,0.07312462189957653,0.10588487972508591,,,538,254
25,25,5,1,4,1,1,1,429,239,40,12,93,Office,0.06790683605565638,0.1052405498281787,,,469,251
26,26,5,1,4,1,1,2,474,239,64,15,93,europ√©en,0.0765275257108288,0.10588487972508591,,,538,254
27,27,4,1,4,1,2,0,429,255,77,12,-1,,0.0707047791893527,0.11211340206185567,,,506,267
28,28,5,1,4,1,2,1,429,255,22,12,95,des,0.06654567453115548,0.11211340206185567,,,451,267
29,29,5,1,4,1,2,2,457,255,49,12,82,brevets,0.07282214156079855,0.11211340206185567,,,506,267
30,30,2,1,5,0,0,0,281,136,274,150,-1,,0.06321839080459771,0.09063573883161512,,,555,286
31,31,3,1,5,1,0,0,281,136,274,150,-1,,0.06321839080459771,0.09063573883161512,,,555,286
32,32,4,1,5,1,1,0,281,136,274,150,-1,,0.06321839080459771,0.09063573883161512,,,555,286
33,33,5,1,5,1,1,1,281,136,274,150,95, ,0.06321839080459771,0.09063573883161512,,,555,286
34,34,2,1,6,0,0,0,225,324,45,26,-1,,0.037431941923774956,0.14475945017182132,,,270,350
35,35,3,1,6,1,0,0,225,324,45,26,-1,,0.037431941923774956,0.14475945017182132,,,270,350
36,36,4,1,6,1,1,0,225,324,45,26,-1,,0.037431941923774956,0.14475945017182132,,,270,350
37,37,5,1,6,1,1,1,225,324,45,26,96,(12),0.037431941923774956,0.14475945017182132,,,270,350
38,38,2,1,7,0,0,0,225,395,378,53,-1,,0.06261343012704174,0.18105670103092783,,,603,448
39,39,3,1,7,1,0,0,225,395,378,53,-1,,0.06261343012704174,0.18105670103092783,,,603,448
40,40,4,1,7,1,1,0,225,395,262,26,-1,,0.05384150030248034,0.17525773195876287,,,487,421
41,41,5,1,7,1,1,1,225,395,45,26,95,(43),0.037431941923774956,0.17525773195876287,,,270,421
42,42,5,1,7,1,1,2,286,397,48,18,95,Date,0.04688445251058681,0.17439862542955326,,,334,415
43,43,5,1,7,1,1,3,342,397,20,18,96,of,0.05323653962492438,0.17439862542955326,,,362,415
44,44,5,1,7,1,1,4,370,397,117,23,96,publication:,0.0648064125831821,0.17547250859106528,,,487,420
45,45,4,1,7,1,2,0,286,430,317,18,-1,,0.06722625529340592,0.18857388316151202,,,603,448
46,46,5,1,7,1,2,1,286,430,117,18,96,07.11.2018,0.052102238354506954,0.18857388316151202,publication_date,07.11.2018,403,448
47,47,5,1,7,1,2,2,426,430,84,18,95,Bulletin,0.07078039927404718,0.18857388316151202,,,510,448
48,48,5,1,7,1,2,3,519,430,84,18,95,2018/45,0.08484573502722323,0.18857388316151202,,,603,448
49,49,2,1,8,0,0,0,225,493,403,26,-1,,0.06450393224440411,0.21735395189003437,,,628,519
50,50,3,1,8,1,0,0,225,493,403,26,-1,,0.06450393224440411,0.21735395189003437,,,628,519
51,51,4,1,8,1,1,0,225,493,403,26,-1,,0.06450393224440411,0.21735395189003437,,,628,519
52,52,5,1,8,1,1,1,225,493,45,26,95,(21),0.037431941923774956,0.21735395189003437,,,270,519
53,53,5,1,8,1,1,2,285,495,115,23,96,Application,0.051799758015728975,0.21756872852233677,,,400,518
54,54,5,1,8,1,1,3,410,495,83,18,93,number:,0.06828493647912885,0.21649484536082475,,,493,513
55,55,5,1,8,1,1,4,505,495,123,18,86,18180811.4,0.08567755595886267,0.21649484536082475,application_number,18180811.4,628,513
56,56,2,1,9,0,0,0,225,559,325,26,-1,,0.05860556563823351,0.24570446735395188,,,550,585
57,57,3,1,9,1,0,0,225,559,325,26,-1,,0.05860556563823351,0.24570446735395188,,,550,585
58,58,4,1,9,1,1,0,225,559,325,26,-1,,0.05860556563823351,0.24570446735395188,,,550,585
59,59,5,1,9,1,1,1,225,559,45,26,96,(22),0.037431941923774956,0.24570446735395188,,,270,585
60,60,5,1,9,1,1,2,286,561,48,18,96,Date,0.04688445251058681,0.24484536082474226,,,334,579
61,61,5,1,9,1,1,3,342,566,12,13,96,of,0.05263157894736842,0.24591924398625428,,,354,579
62,62,5,1,9,1,1,4,355,561,67,23,96,filing:,0.058756805807622506,0.24591924398625428,,,422,584
63,63,5,1,9,1,1,5,432,561,118,18,96,06.02.2014,0.07425892316999395,0.24484536082474226,filing_date,06.02.2014,550,579
64,64,2,1,10,0,0,0,1002,245,458,38,-1,,0.18617664851784635,0.1134020618556701,,,1460,283
65,65,3,1,10,1,0,0,1002,245,458,38,-1,,0.18617664851784635,0.1134020618556701,,,1460,283
66,66,4,1,10,1,1,0,1002,245,458,38,-1,,0.18617664851784635,0.1134020618556701,,,1460,283
67,67,5,1,10,1,1,1,1002,256,44,27,74,(11),0.15486993345432548,0.11576460481099657,,,1046,283
68,68,5,1,10,1,1,2,1146,245,52,32,96,EP,0.17725347852389595,0.11211340206185567,number,EP,1198,277
69,69,5,1,10,1,1,3,1214,245,20,32,96,3,0.1851179673321234,0.11211340206185567,number,3,1234,277
70,70,5,1,10,1,1,4,1249,245,68,32,96,398,0.1940411373260738,0.11211340206185567,number,398,1317,277
71,71,5,1,10,1,1,5,1332,245,67,32,93,628,0.20651845130066546,0.11211340206185567,number,628,1399,277
72,72,5,1,10,1,1,6,1413,245,47,32,88,A1,0.21725650332728372,0.11211340206185567,number,A1,1460,277
73,73,2,1,11,0,0,0,577,319,537,26,-1,,0.1278735632183908,0.14261168384879724,,,1114,345
74,74,3,1,11,1,0,0,577,319,537,26,-1,,0.1278735632183908,0.14261168384879724,,,1114,345
75,75,4,1,11,1,1,0,577,319,537,26,-1,,0.1278735632183908,0.14261168384879724,,,1114,345
76,76,5,1,11,1,1,1,577,319,156,26,95,EUROPEAN,0.09906231094978826,0.14261168384879724,,,733,345
77,77,5,1,11,1,1,2,735,320,135,24,95,PATENT,0.12137023593466424,0.14261168384879724,,,870,344
78,78,5,1,11,1,1,3,873,319,241,26,96,APPLICATION,0.1502571082879613,0.14261168384879724,,,1114,345
79,79,2,1,12,0,0,0,862,395,248,51,-1,,0.14912280701754385,0.18062714776632302,,,1110,446
80,80,3,1,12,1,0,0,862,395,248,51,-1,,0.14912280701754385,0.18062714776632302,,,1110,446
81,81,4,1,12,1,1,0,862,395,126,26,-1,,0.13989715668481548,0.17525773195876287,,,988,421
82,82,5,1,12,1,1,1,862,395,44,26,67,(51),0.1336963097398669,0.17525773195876287,,,906,421
83,83,5,1,12,1,1,2,923,397,25,18,93,Int,0.1414851784633999,0.17439862542955326,,,948,415
84,84,5,1,12,1,1,3,955,397,33,18,65,Cl:,0.14692982456140352,0.17439862542955326,,,988,415
85,85,4,1,12,1,2,0,921,425,189,21,-1,,0.15358439201451907,0.1870704467353952,,,1110,446
86,86,5,1,12,1,2,1,921,428,64,18,73,AG1M,0.1441318814277072,0.1877147766323024,class_international,A61M,985,446
87,87,5,1,12,1,2,2,994,428,44,18,96,1136,0.15366001209921354,0.1877147766323024,class_international,1/36,1038,446
88,88,5,1,12,1,2,3,1043,425,67,16,89,(2006.01),0.16281004234724744,0.18599656357388317,,,1110,441
89,89,2,1,13,0,0,0,224,611,1243,8,-1,,0.1278735632183908,0.26417525773195877,,,1467,619
90,90,3,1,13,1,0,0,224,611,1243,8,-1,,0.1278735632183908,0.26417525773195877,,,1467,619
91,91,4,1,13,1,1,0,224,611,1243,8,-1,,0.1278735632183908,0.26417525773195877,,,1467,619
92,92,5,1,13,1,1,1,224,611,1243,8,95, ,0.1278735632183908,0.26417525773195877,,,1467,619
93,93,2,1,14,0,0,0,225,631,599,119,-1,,0.07932546884452511,0.296606529209622,,,824,750
94,94,3,1,14,1,0,0,225,631,599,119,-1,,0.07932546884452511,0.296606529209622,,,824,750
95,95,4,1,14,1,1,0,225,631,388,27,-1,,0.0633696309739867,0.2768470790378007,,,613,658
96,96,5,1,14,1,1,1,225,631,45,27,96,(84),0.037431941923774956,0.2768470790378007,,,270,658
97,97,5,1,14,1,1,2,286,633,118,23,96,Designated,0.052177858439201454,0.2768470790378007,,,404,656
98,98,5,1,14,1,1,3,413,633,119,23,96,Contracting,0.07146098003629764,0.2768470790378007,,,532,656
99,99,5,1,14,1,1,4,542,633,71,19,96,States:,0.08734119782214156,0.2759879725085911,,,613,652
100,100,4,1,14,1,2,0,285,666,537,18,-1,,0.08371143375680581,0.28994845360824745,,,822,684
101,101,5,1,14,1,2,1,285,666,31,18,94,AL,0.04544767090139141,0.28994845360824745,,,316,684
102,102,5,1,14,1,2,2,323,666,31,18,94,AT,0.05119479733817302,0.28994845360824745,,,354,684
103,103,5,1,14,1,2,3,363,666,30,18,96,BE,0.05716878402903811,0.28994845360824745,,,393,684
104,104,5,1,14,1,2,4,403,666,32,18,96,BG,0.0633696309739867,0.28994845360824745,,,435,684
105,105,5,1,14,1,2,5,445,666,31,18,96,CH,0.06964609800362977,0.28994845360824745,,,476,684
106,106,5,1,14,1,2,6,486,666,32,18,95,CY,0.07592256503327284,0.28994845360824745,,,518,684
107,107,5,1,14,1,2,7,526,666,30,18,93,CZ,0.08182093163944344,0.28994845360824745,,,556,684
108,108,5,1,14,1,2,8,565,666,30,18,93,DE,0.08771929824561403,0.28994845360824745,,,595,684
109,109,5,1,14,1,2,9,605,666,32,18,95,DK,0.09392014519056262,0.28994845360824745,,,637,684
110,110,5,1,14,1,2,10,646,666,29,18,95,EE,0.0998941318814277,0.28994845360824745,,,675,684
111,111,5,1,14,1,2,11,684,666,29,18,93,ES,0.10564125831820932,0.28994845360824745,,,713,684
112,112,5,1,14,1,2,12,723,666,57,18,90,FIFR,0.11365698729582577,0.28994845360824745,,,780,684
113,113,5,1,14,1,2,13,788,666,34,18,95,GB,0.12174833635813673,0.28994845360824745,,,822,684
114,114,4,1,14,1,3,0,285,699,539,18,-1,,0.0838626739261948,0.30412371134020616,,,824,717
115,115,5,1,14,1,3,1,285,699,297,18,83,GRHRHUIEISITLILTLU,0.06556261343012704,0.30412371134020616,,,582,717
116,116,5,1,14,1,3,2,591,699,28,18,85,LV,0.09150030248033877,0.30412371134020616,,,619,717
117,117,5,1,14,1,3,3,627,699,35,18,85,MC,0.09747428917120388,0.30412371134020616,,,662,717
118,118,5,1,14,1,3,4,670,699,35,18,94,MK,0.10397761645493044,0.30412371134020616,,,705,717
119,119,5,1,14,1,3,5,713,699,32,18,91,MT,0.11025408348457351,0.30412371134020616,,,745,717
120,120,5,1,14,1,3,6,753,699,29,18,49,NL,0.11607683000604961,0.30412371134020616,,,782,717
121,121,5,1,14,1,3,7,791,699,33,18,49,NO,0.1221264367816092,0.30412371134020616,,,824,717
122,122,4,1,14,1,4,0,286,732,336,18,-1,,0.06866303690260134,0.31829896907216493,,,622,750
123,123,5,1,14,1,4,1,286,732,28,18,93,PL,0.045372050816696916,0.31829896907216493,,,314,750
124,124,5,1,14,1,4,2,323,732,29,18,92,PT,0.05104355716878403,0.31829896907216493,,,352,750
125,125,5,1,14,1,4,3,360,732,58,18,92,RORS,0.058832425892317,0.31829896907216493,,,418,750
126,126,5,1,14,1,4,4,420,732,52,18,92,SE,0.06745311554748941,0.31829896907216493,,,472,750
127,127,5,1,14,1,4,5,480,732,20,18,95,SI,0.07410768300060495,0.31829896907216493,,,500,750
128,128,5,1,14,1,4,6,510,732,31,18,93,SK,0.0794767090139141,0.31829896907216493,,,541,750
129,129,5,1,14,1,4,7,550,732,72,18,90,SMTR,0.08862673926194797,0.31829896907216493,,,622,750
130,130,2,1,15,0,0,0,225,795,513,119,-1,,0.07282214156079855,0.36705326460481097,,,738,914
131,131,3,1,15,1,0,0,225,795,513,119,-1,,0.07282214156079855,0.36705326460481097,,,738,914
132,132,4,1,15,1,1,0,225,795,513,27,-1,,0.07282214156079855,0.3472938144329897,,,738,822
133,133,5,1,15,1,1,1,225,795,45,27,96,(30),0.037431941923774956,0.3472938144329897,,,270,822
134,134,5,1,15,1,1,2,286,797,77,23,96,Priority:,0.04907743496672716,0.3472938144329897,,,363,820
135,135,5,1,15,1,1,3,383,797,118,19,96,06.02.2013,0.06684815486993345,0.34643470790378006,priority_date_eu,06.02.2013,501,816
136,136,5,1,15,1,1,4,520,797,30,19,96,US,0.0809134906231095,0.34643470790378006,,,550,816
137,137,5,1,15,1,1,5,559,797,157,19,92,201361761405,0.09641560798548095,0.34643470790378006,,,716,816
138,138,5,1,15,1,1,6,725,797,13,19,92,P,0.11063218390804598,0.34643470790378006,,,738,816
139,139,4,1,15,1,2,0,383,830,355,18,-1,,0.08477011494252873,0.3603951890034364,,,738,848
140,140,5,1,15,1,2,1,383,830,118,18,96,07.02.2013,0.06684815486993345,0.3603951890034364,,,501,848
141,141,5,1,15,1,2,2,520,830,30,18,96,US,0.0809134906231095,0.3603951890034364,,,550,848
142,142,5,1,15,1,2,3,559,830,157,18,93,201361762197,0.09641560798548095,0.3603951890034364,,,716,848
143,143,5,1,15,1,2,4,725,830,13,18,92,P,0.11063218390804598,0.3603951890034364,,,738,848
144,144,4,1,15,1,3,0,385,863,353,18,-1,,0.08492135511191773,0.3745704467353952,,,738,881
145,145,5,1,15,1,3,1,385,863,116,18,90,14.03.2013,0.06699939503932244,0.3745704467353952,,,501,881
146,146,5,1,15,1,3,2,520,863,30,18,91,US,0.0809134906231095,0.3745704467353952,,,550,881
147,147,5,1,15,1,3,3,559,863,158,18,93,201361783774,0.09649122807017543,0.3745704467353952,,,717,881
148,148,5,1,15,1,3,4,725,863,13,18,91,P,0.11063218390804598,0.3745704467353952,,,738,881
149,149,4,1,15,1,4,0,384,895,354,19,-1,,0.08484573502722323,0.38853092783505155,,,738,914
150,150,5,1,15,1,4,1,384,895,118,19,90,13.01.2014,0.06699939503932244,0.38853092783505155,,,502,914
151,151,5,1,15,1,4,2,520,895,30,19,93,US,0.0809134906231095,0.38853092783505155,,,550,914
152,152,5,1,15,1,4,3,559,895,158,19,92,201461926704,0.09649122807017543,0.38853092783505155,,,717,914
153,153,5,1,15,1,4,4,725,895,13,19,89,P,0.11063218390804598,0.38853092783505155,,,738,914
154,154,2,1,16,0,0,0,234,959,587,86,-1,,0.07977918935269207,0.43041237113402064,,,821,1045
155,155,3,1,16,1,0,0,234,959,587,86,-1,,0.07977918935269207,0.43041237113402064,,,821,1045
156,156,4,1,16,1,1,0,234,959,587,27,-1,,0.07977918935269207,0.4177405498281787,,,821,986
157,157,5,1,16,1,1,1,234,959,36,27,96,62),0.038112522686025406,0.4177405498281787,,,270,986
158,158,5,1,16,1,1,2,286,961,107,19,96,Document,0.05134603750756201,0.4168814432989691,,,393,980
159,159,5,1,16,1,1,3,402,961,105,23,95,number(s),0.06873865698729582,0.4177405498281787,,,507,984
160,160,5,1,16,1,1,4,516,961,20,19,95,of,0.07955232909860858,0.4168814432989691,,,536,980
161,161,5,1,16,1,1,5,542,961,32,19,96,the,0.08439201451905626,0.4168814432989691,,,574,980
162,162,5,1,16,1,1,6,582,961,66,19,96,earlier,0.09301270417422867,0.4168814432989691,,,648,980
163,163,5,1,16,1,1,7,656,961,139,23,94,application(s),0.10972474289171204,0.4177405498281787,,,795,984
164,164,5,1,16,1,1,8,805,961,16,19,94,in,0.12295825771324864,0.4168814432989691,,,821,980
165,165,4,1,16,1,2,0,285,994,309,18,-1,,0.06647005444646098,0.43084192439862545,,,594,1012
166,166,5,1,16,1,2,1,285,994,110,18,95,accordance,0.0514216575922565,0.43084192439862545,,,395,1012
167,167,5,1,16,1,2,2,395,994,60,18,96,with,0.06427707199032062,0.43084192439862545,,,455,1012
168,168,5,1,16,1,2,3,464,994,35,18,96,Art.,0.07282214156079855,0.43084192439862545,,,499,1012
169,169,5,1,16,1,2,4,508,994,25,18,96,76,0.07872050816696914,0.43084192439862545,,,533,1012
170,170,5,1,16,1,2,5,542,994,52,18,96,EPC:,0.08590441621294616,0.43084192439862545,,,594,1012
171,171,4,1,16,1,3,0,286,1027,250,18,-1,,0.06215970961887477,0.44501718213058417,,,536,1045
172,172,5,1,16,1,3,1,286,1027,121,18,90,14749201.1,0.05240471869328494,0.44501718213058417,,,407,1045
173,173,5,1,16,1,3,2,417,1027,7,18,74,/,0.06359649122807018,0.44501718213058417,,,424,1045
174,174,5,1,16,1,3,3,432,1027,11,18,92,2,0.066167574107683,0.44501718213058417,,,443,1045
175,175,5,1,16,1,3,4,451,1027,38,18,92,953,0.07108287961282517,0.44501718213058417,,,489,1045
176,176,5,1,16,1,3,5,498,1027,38,18,96,662,0.07819116757410768,0.44501718213058417,,,536,1045
177,177,2,1,17,0,0,0,234,1090,398,58,-1,,0.06548699334543255,0.4806701030927835,,,632,1148
178,178,3,1,17,1,0,0,234,1090,398,58,-1,,0.06548699334543255,0.4806701030927835,,,632,1148
179,179,4,1,17,1,1,0,234,1090,398,26,-1,,0.06548699334543255,0.4737972508591065,,,632,1116
180,180,5,1,17,1,1,1,234,1090,36,26,94,71),0.038112522686025406,0.4737972508591065,,,270,1116
181,181,5,1,17,1,1,2,285,1092,103,23,93,Applicant:,0.05089231699939504,0.4740120274914089,,,388,1115
182,182,5,1,17,1,1,3,397,1092,93,23,93,NxStage,0.06707501512401694,0.4740120274914089,applicant_line_1,NxStage,490,1115
183,183,5,1,17,1,1,4,500,1092,78,18,96,Medical,0.08151845130066546,0.4729381443298969,applicant_line_1,Medical,578,1110
184,184,5,1,17,1,1,5,581,1092,51,18,96,Inc.,0.09172716273442226,0.4729381443298969,applicant_line_1,Inc.,632,1110
185,185,4,1,17,1,2,0,286,1125,287,23,-1,,0.06495765275257108,0.4881872852233677,,,573,1148
186,186,5,1,17,1,2,1,286,1125,114,22,96,"Lawrence,",0.051875378100423475,0.4879725085910653,,,400,1147
187,187,5,1,17,1,2,2,410,1125,34,19,96,MA,0.06457955232909861,0.48732817869415807,,,444,1144
188,188,5,1,17,1,2,3,453,1125,64,19,96,01843,0.07335148215366001,0.48732817869415807,,,517,1144
189,189,5,1,17,1,2,4,526,1125,47,23,96,(US),0.08310647307924984,0.4881872852233677,,,573,1148
190,190,2,1,18,0,0,0,844,614,4,566,-1,,0.1279491833030853,0.3853092783505155,,,848,1180
191,191,3,1,18,1,0,0,844,614,4,566,-1,,0.1279491833030853,0.3853092783505155,,,848,1180
192,192,4,1,18,1,1,0,844,614,4,566,-1,,0.1279491833030853,0.3853092783505155,,,848,1180
193,193,5,1,18,1,1,1,844,614,4,566,95, ,0.1279491833030853,0.3853092783505155,,,848,1180
194,194,2,1,19,0,0,0,862,631,562,157,-1,,0.17286751361161526,0.30476804123711343,,,1424,788
195,195,3,1,19,1,0,0,862,631,562,157,-1,,0.17286751361161526,0.30476804123711343,,,1424,788
196,196,4,1,19,1,1,0,862,631,162,27,-1,,0.1426194797338173,0.2768470790378007,,,1024,658
197,197,5,1,19,1,1,1,862,631,44,27,94,(72),0.1336963097398669,0.2768470790378007,,,906,658
198,198,5,1,19,1,1,2,923,633,101,19,94,Inventors:,0.1472323049001815,0.2759879725085911,,,1024,652
199,199,4,1,19,1,2,0,898,666,264,22,-1,,0.1557773744706594,0.29080756013745707,,,1162,688
200,200,5,1,19,1,2,1,898,671,7,8,63,¬¢,0.13634301270417423,0.28994845360824745,,,905,679
201,201,5,1,19,1,2,2,922,666,111,18,96,"SCHNELL,",0.14783726557773744,0.28994845360824745,inventor_line_1,"SCHNELL,",1033,684
202,202,5,1,19,1,2,3,1035,666,94,22,95,"William,",0.16364186327888688,0.29080756013745707,inventor_line_1,"William,",1129,688
203,203,5,1,19,1,2,4,1132,666,30,22,94,J.,0.1734724742891712,0.29080756013745707,inventor_line_1,J.,1162,688
204,204,4,1,19,1,3,0,923,699,368,23,-1,,0.16742286751361163,0.30519759450171824,,,1291,722
205,205,5,1,19,1,3,1,923,699,129,23,96,"Libertyville,",0.14934966727162735,0.30519759450171824,,,1052,722
206,206,5,1,19,1,3,2,1062,699,19,18,96,IL,0.16205384150030247,0.30412371134020616,,,1081,717
207,207,5,1,19,1,3,3,1090,699,73,18,88,Illinois,0.1703720508166969,0.30412371134020616,,,1163,717
208,208,5,1,19,1,3,4,1172,699,64,18,96,60048,0.1820931639443436,0.30412371134020616,,,1236,717
209,209,5,1,19,1,3,5,1244,699,47,23,96,(US),0.19169691470054445,0.30519759450171824,,,1291,722
210,210,4,1,19,1,4,0,898,732,271,22,-1,,0.15630671506352087,0.31915807560137455,,,1169,754
211,211,5,1,19,1,4,1,898,737,7,8,66,¬´,0.13634301270417423,0.31829896907216493,,,905,745
212,212,5,1,19,1,4,2,923,732,120,18,91,"BRUGGER,",0.14866908650937688,0.31829896907216493,,,1043,750
213,213,5,1,19,1,4,3,1045,732,85,22,93,"James,",0.16447368421052633,0.31915807560137455,,,1130,754
214,214,5,1,19,1,4,4,1132,732,37,22,92,M.,0.17400181488203267,0.31915807560137455,,,1169,754
215,215,4,1,19,1,5,0,923,765,501,23,-1,,0.17748033877797942,0.3335481099656357,,,1424,788
216,216,5,1,19,1,5,1,923,765,151,23,96,"Newburyport,",0.15101330913490624,0.3335481099656357,,,1074,788
217,217,5,1,19,1,5,2,1083,765,35,18,96,MA,0.16643980641258319,0.3324742268041237,,,1118,783
218,218,5,1,19,1,5,3,1127,765,169,18,96,Massachusetts,0.18322746521476105,0.3324742268041237,,,1296,783
219,219,5,1,19,1,5,4,1304,765,64,18,95,01950,0.20205686630369027,0.3324742268041237,,,1368,783
220,220,5,1,19,1,5,5,1377,765,47,23,96,(US),0.2118118572292801,0.3335481099656357,,,1424,788
221,221,2,1,20,0,0,0,862,828,569,156,-1,,0.1733968542044767,0.38917525773195877,,,1431,984
222,222,3,1,20,1,0,0,862,828,569,156,-1,,0.1733968542044767,0.38917525773195877,,,1431,984
223,223,4,1,20,1,1,0,862,828,569,26,-1,,0.1733968542044767,0.36125429553264604,,,1431,854
224,224,5,1,20,1,1,1,862,828,44,26,95,(74),0.1336963097398669,0.36125429553264604,,,906,854
225,225,5,1,20,1,1,2,923,830,163,23,93,Representative:,0.15192075015124018,0.36146907216494845,,,1086,853
226,226,5,1,20,1,1,3,1094,830,87,23,91,"Viering,",0.1720356926799758,0.36146907216494845,representative_line_1_eu,"Viering,",1181,853
227,227,5,1,20,1,1,4,1190,830,125,18,92,Jentschura,0.18942831215970962,0.3603951890034364,representative_line_1_eu,Jentschura,1315,848
228,228,5,1,20,1,1,5,1324,830,15,18,93,&,0.2013762855414398,0.3603951890034364,representative_line_1_eu,&,1339,848
229,229,5,1,20,1,1,6,1349,830,82,18,96,Partner,0.2102238354506957,0.3603951890034364,representative_line_1_eu,Partner,1431,848
230,230,4,1,20,1,2,0,922,863,51,18,-1,,0.14330006049606775,0.3745704467353952,,,973,881
231,231,5,1,20,1,2,1,922,863,51,18,91,mbB,0.14330006049606775,0.3745704467353952,,,973,881
232,232,4,1,20,1,3,0,923,895,302,19,-1,,0.16243194192377494,0.38853092783505155,,,1225,914
233,233,5,1,20,1,3,1,923,895,78,19,92,Patent-,0.1454930429522081,0.38853092783505155,,,1001,914
234,234,5,1,20,1,3,2,1010,895,41,19,93,und,0.1558529945553539,0.38853092783505155,,,1051,914
235,235,5,1,20,1,3,3,1061,895,164,19,70,Rechtsanwalte,0.17286751361161526,0.38853092783505155,,,1225,914
236,236,4,1,20,1,4,0,921,929,174,18,-1,,0.15245009074410162,0.4029209621993127,,,1095,947
237,237,5,1,20,1,4,1,921,929,37,18,89,Am,0.14209013914095583,0.4029209621993127,,,958,947
238,238,5,1,20,1,4,2,968,929,107,18,89,Brauhaus,0.15449183303085298,0.4029209621993127,,,1075,947
239,239,5,1,20,1,4,3,1084,929,11,18,96,8,0.1647761645493043,0.4029209621993127,,,1095,947
240,240,4,1,20,1,5,0,922,961,222,23,-1,,0.15623109497882637,0.4177405498281787,,,1144,984
241,241,5,1,20,1,5,1,922,961,64,19,95,01099,0.1442831215970962,0.4168814432989691,,,986,980
242,242,5,1,20,1,5,2,996,961,92,19,95,Dresden,0.15759225650332728,0.4168814432989691,,,1088,980
243,243,5,1,20,1,5,3,1097,961,47,23,96,(DE),0.169464609800363,0.4177405498281787,,,1144,984
244,244,2,1,21,0,0,0,862,1027,582,117,-1,,0.17437991530550515,0.46628006872852235,,,1444,1144
245,245,3,1,21,1,0,0,862,1027,582,117,-1,,0.17437991530550515,0.46628006872852235,,,1444,1144
246,246,4,1,21,1,1,0,862,1027,99,18,-1,,0.13785541439806412,0.44501718213058417,,,961,1045
247,247,5,1,21,1,1,1,862,1027,99,18,96,Remarks:,0.13785541439806412,0.44501718213058417,,,961,1045
248,248,4,1,21,1,2,0,922,1059,474,23,-1,,0.1752873563218391,0.45983676975945015,,,1396,1082
249,249,5,1,21,1,2,1,922,1059,43,19,96,This,0.1426950998185118,0.45897766323024053,,,965,1078
250,250,5,1,21,1,2,2,974,1059,111,23,96,application,0.15570175438596492,0.45983676975945015,,,1085,1082
251,251,5,1,21,1,2,3,1093,1064,42,14,96,was,0.16848154869933454,0.46005154639175255,,,1135,1078
252,252,5,1,21,1,2,4,1142,1059,43,19,96,filed,0.17596793708408953,0.45897766323024053,,,1185,1078
253,253,5,1,21,1,2,5,1193,1064,25,14,96,on,0.1823200241984271,0.46005154639175255,,,1218,1078
254,254,5,1,21,1,2,6,1226,1059,119,19,96,29.06.2018,0.19441923774954628,0.45897766323024053,,,1345,1078
255,255,5,1,21,1,2,7,1353,1064,24,14,95,as,0.20644283121597096,0.46005154639175255,,,1377,1078
256,256,5,1,21,1,2,8,1385,1064,11,14,96,a,0.2102994555353902,0.46005154639175255,,,1396,1078
257,257,4,1,21,1,3,0,922,1092,522,23,-1,,0.17891712038717483,0.4740120274914089,,,1444,1115
258,258,5,1,21,1,3,1,922,1092,96,18,96,divisional,0.14670296430732002,0.4729381443298969,,,1018,1110
259,259,5,1,21,1,3,2,1027,1092,111,23,96,application,0.16371748336358136,0.4740120274914089,,,1138,1115
260,260,5,1,21,1,3,3,1147,1093,19,17,96,to,0.17490925589836662,0.4731529209621993,,,1166,1110
261,261,5,1,21,1,3,4,1174,1092,31,18,96,the,0.17990018148820328,0.4729381443298969,,,1205,1110
262,262,5,1,21,1,3,5,1214,1092,112,23,96,application,0.19207501512401695,0.4740120274914089,,,1326,1115
263,263,5,1,21,1,3,6,1336,1092,108,18,96,mentioned,0.2102238354506957,0.4729381443298969,,,1444,1110
264,264,4,1,21,1,4,0,923,1125,209,19,-1,,0.15539927404718692,0.48732817869415807,,,1132,1144
265,265,5,1,21,1,4,1,923,1125,59,19,93,under,0.1440562613430127,0.48732817869415807,,,982,1144
266,266,5,1,21,1,4,2,991,1125,45,19,92,INID,0.15328191167574107,0.48732817869415807,,,1036,1144
267,267,5,1,21,1,4,3,1044,1125,50,19,96,code,0.16167574107683,0.48732817869415807,,,1094,1144
268,268,5,1,21,1,4,4,1103,1125,29,19,96,62.,0.16901088929219601,0.48732817869415807,,,1132,1144
269,269,2,1,22,0,0,0,224,1175,1243,8,-1,,0.1278735632183908,0.5064432989690721,,,1467,1183
270,270,3,1,22,1,0,0,224,1175,1243,8,-1,,0.1278735632183908,0.5064432989690721,,,1467,1183
271,271,4,1,22,1,1,0,224,1175,1243,8,-1,,0.1278735632183908,0.5064432989690721,,,1467,1183
272,272,5,1,22,1,1,1,224,1175,1243,8,95, ,0.1278735632183908,0.5064432989690721,,,1467,1183
273,273,2,1,23,0,0,0,225,1272,583,446,-1,,0.07811554748941318,0.6421821305841925,,,808,1718
274,274,3,1,23,1,0,0,225,1272,583,446,-1,,0.07811554748941318,0.6421821305841925,,,808,1718
275,275,4,1,23,1,1,0,234,1272,572,26,-1,,0.07864488808227466,0.5519759450171822,,,806,1298
276,276,5,1,23,1,1,1,234,1272,36,26,89,57),0.038112522686025406,0.5519759450171822,,,270,1298
277,277,5,1,23,1,1,2,0,0,1653,2328,13,‚Äî,0.125,0.5,,,1653,2328
278,278,5,1,23,1,1,3,315,1274,104,23,96,According,0.055505142165759226,0.5521907216494846,,,419,1297
279,279,5,1,23,1,1,4,433,1274,18,18,96,to,0.06684815486993345,0.5511168384879725,,,451,1292
280,280,5,1,23,1,1,5,464,1274,147,21,96,"embodiments,",0.08129159104658197,0.5517611683848798,,,611,1295
281,281,5,1,23,1,1,6,626,1274,75,23,96,priming,0.10034785238959468,0.5521907216494846,,,701,1297
282,282,5,1,23,1,1,7,715,1274,91,23,96,"systems,",0.11501814882032668,0.5521907216494846,,,806,1297
283,283,4,1,23,1,2,0,226,1306,581,22,-1,,0.07811554748941318,0.5657216494845361,,,807,1328
284,284,5,1,23,1,2,1,226,1306,95,22,95,"methods,",0.041364186327888686,0.5657216494845361,,,321,1328
285,285,5,1,23,1,2,2,327,1306,38,19,96,and,0.05232909860859044,0.5650773195876289,,,365,1325
286,286,5,1,23,1,2,3,372,1306,68,19,96,devices,0.06140350877192982,0.5650773195876289,,,440,1325
287,287,5,1,23,1,2,4,442,1311,49,14,96,are,0.0705535390199637,0.5661512027491409,,,491,1325
288,288,5,1,23,1,2,5,497,1306,97,19,96,disclosed,0.08250151240169389,0.5650773195876289,,,594,1325
289,289,5,1,23,1,2,6,600,1306,48,19,97,which,0.09437386569872959,0.5650773195876289,,,648,1325
290,290,5,1,23,1,2,7,651,1306,69,19,96,allow,0.10367513611615245,0.5650773195876289,,,720,1325
291,291,5,1,23,1,2,8,727,1306,80,19,95,medical,0.11600120992135511,0.5650773195876289,,,807,1325
292,292,4,1,23,1,3,0,232,1339,575,23,-1,,0.07856926799758016,0.5801116838487973,,,807,1362
293,293,5,1,23,1,3,1,232,1340,93,17,27,treatment,0.042120387174833636,0.5792525773195877,,,325,1357
294,294,5,1,23,1,3,2,335,1339,79,18,95,devices,0.05663944343617665,0.5790378006872853,,,414,1357
295,295,5,1,23,1,3,3,425,1339,60,18,95,which,0.06881427707199032,0.5790378006872853,,,485,1357
296,296,5,1,23,1,3,4,497,1344,43,18,96,pump,0.07841802782819117,0.5811855670103093,,,540,1362
297,297,5,1,23,1,3,5,543,1339,64,23,96,fluid,0.08696309739866909,0.5801116838487973,,,607,1362
298,298,5,1,23,1,3,6,618,1340,19,17,96,to,0.09490320629159105,0.5792525773195877,,,637,1357
299,299,5,1,23,1,3,7,649,1339,24,18,96,be,0.0999697519661222,0.5790378006872853,,,673,1357
300,300,5,1,23,1,3,8,685,1339,69,23,96,primed,0.1088173018753781,0.5801116838487973,,,754,1362
301,301,5,1,23,1,3,9,765,1339,42,18,96,with,0.11887477313974591,0.5790378006872853,,,807,1357
302,302,4,1,23,1,4,0,226,1372,581,23,-1,,0.07811554748941318,0.594286941580756,,,807,1395
303,303,5,1,23,1,4,1,226,1372,74,19,96,minimal,0.03977616454930429,0.5934278350515464,,,300,1391
304,304,5,1,23,1,4,2,303,1372,88,23,96,operator,0.05248033877797943,0.594286941580756,,,391,1395
305,305,5,1,23,1,4,3,393,1372,134,19,96,intervention,0.06957047791893527,0.5934278350515464,,,527,1391
306,306,5,1,23,1,4,4,533,1372,38,19,96,and,0.08348457350272233,0.5934278350515464,,,571,1391
307,307,5,1,23,1,4,5,578,1377,11,14,96,a,0.0882486388384755,0.5945017182130584,,,589,1391
308,308,5,1,23,1,4,6,597,1372,41,23,96,high,0.09339080459770115,0.594286941580756,,,638,1395
309,309,5,1,23,1,4,7,647,1372,45,19,96,level,0.10125529340592862,0.5934278350515464,,,692,1391
310,310,5,1,23,1,4,8,699,1372,20,19,92,of,0.10722928009679371,0.5934278350515464,,,719,1391
311,311,5,1,23,1,4,9,724,1377,83,14,92,conven-,0.11577434966727163,0.5945017182130584,,,807,1391
312,312,4,1,23,1,5,0,226,1405,581,18,-1,,0.07811554748941318,0.6073883161512027,,,807,1423
313,313,5,1,23,1,5,1,226,1405,60,18,93,ience.,0.03871748336358137,0.6073883161512027,,,286,1423
314,314,5,1,23,1,5,2,294,1405,16,18,96,A,0.045674531155474894,0.6073883161512027,,,310,1423
315,315,5,1,23,1,5,3,319,1405,42,18,96,blood,0.0514216575922565,0.6073883161512027,,,361,1423
316,316,5,1,23,1,5,4,362,1405,82,18,96,circuit,0.06094978826376286,0.6073883161512027,,,444,1423
317,317,5,1,23,1,5,5,451,1405,41,18,96,with,0.07130973986690865,0.6073883161512027,,,492,1423
318,318,5,1,23,1,5,6,501,1410,11,13,95,a,0.0766031457955233,0.6084621993127147,,,512,1423
319,319,5,1,23,1,5,7,520,1405,45,18,96,filter,0.08204779189352691,0.6073883161512027,,,565,1423
320,320,5,1,23,1,5,8,572,1405,50,18,93,fitted,0.09029038112522686,0.6073883161512027,,,622,1423
321,321,5,1,23,1,5,9,630,1405,41,18,96,with,0.0983817301875378,0.6073883161512027,,,671,1423
322,322,5,1,23,1,5,10,680,1410,38,13,96,one,0.10571687840290381,0.6084621993127147,,,718,1423
323,323,5,1,23,1,5,11,726,1410,21,13,96,or,0.11138838475499092,0.6084621993127147,,,747,1423
324,324,5,1,23,1,5,12,755,1410,52,13,96,more,0.11811857229280097,0.6084621993127147,,,807,1423
325,325,4,1,23,1,6,0,225,1438,582,23,-1,,0.0780399274047187,0.6226374570446735,,,807,1461
326,326,5,1,23,1,6,1,225,1438,25,18,96,air,0.035919540229885055,0.6215635738831615,,,250,1456
327,327,5,1,23,1,6,2,259,1438,56,18,96,vents,0.04340592861464005,0.6215635738831615,,,315,1456
328,328,5,1,23,1,6,3,324,1442,25,14,96,on,0.05089231699939504,0.6224226804123711,,,349,1456
329,329,5,1,23,1,6,4,360,1442,11,14,93,a,0.05527828191167574,0.6224226804123711,,,371,1456
330,330,5,1,23,1,6,5,382,1438,103,18,72,non-blood,0.06556261343012704,0.6215635738831615,,,485,1456
331,331,5,1,23,1,6,6,495,1438,130,23,96,compartment,0.08469449485783424,0.6226374570446735,,,625,1461
332,332,5,1,23,1,6,7,628,1438,30,18,96,is,0.09724742891712039,0.6215635738831615,,,658,1456
333,333,5,1,23,1,6,8,668,1438,89,18,96,attached,0.10775862068965517,0.6215635738831615,,,757,1456
334,334,5,1,23,1,6,9,767,1438,19,18,95,to,0.11743799153055051,0.6215635738831615,,,786,1456
335,335,5,1,23,1,6,10,796,1442,11,14,95,a,0.12121899576527526,0.6224226804123711,,,807,1456
336,336,4,1,23,1,7,0,232,1470,576,23,-1,,0.07864488808227466,0.6363831615120275,,,808,1493
337,337,5,1,23,1,7,1,232,1471,93,18,91,reatment,0.042120387174833636,0.6357388316151202,,,325,1489
338,338,5,1,23,1,7,2,342,1471,72,22,96,system,0.05716878402903811,0.6365979381443299,,,414,1493
339,339,5,1,23,1,7,3,433,1470,38,19,96,and,0.06836055656382335,0.6355240549828178,,,471,1489
340,340,5,1,23,1,7,4,489,1470,75,23,95,priming,0.07962794918330308,0.6363831615120275,,,564,1493
341,341,5,1,23,1,7,5,581,1470,43,19,96,fluid,0.0911222020568663,0.6355240549828178,,,624,1489
342,342,5,1,23,1,7,6,643,1470,83,23,95,pumped,0.10352389594676346,0.6363831615120275,,,726,1493
343,343,5,1,23,1,7,7,743,1470,65,23,95,slowly,0.11728675136116153,0.6363831615120275,,,808,1493
344,344,4,1,23,1,8,0,232,1503,575,23,-1,,0.07856926799758016,0.6505584192439863,,,807,1526
345,345,5,1,23,1,8,1,232,1503,71,23,89,hrough,0.04045674531155475,0.6505584192439863,,,303,1526
346,346,5,1,23,1,8,2,315,1503,31,18,96,the,0.0499848759830611,0.6494845360824743,,,346,1521
347,347,5,1,23,1,8,3,358,1503,42,18,96,blood,0.057320024198427105,0.6494845360824743,,,400,1521
348,348,5,1,23,1,8,4,402,1503,84,18,96,circuit,0.06715063520871144,0.6494845360824743,,,486,1521
349,349,5,1,23,1,8,5,496,1503,15,18,93,in,0.07614942528735633,0.6494845360824743,,,511,1521
350,350,5,1,23,1,8,6,522,1508,12,13,93,a,0.07985480943738657,0.6505584192439863,,,534,1521
351,351,5,1,23,1,8,7,546,1503,48,23,94,loop.,0.08620689655172414,0.6505584192439863,,,594,1526
352,352,5,1,23,1,8,8,605,1503,40,18,96,The,0.09452510586811858,0.6494845360824743,,,645,1521
353,353,5,1,23,1,8,9,655,1508,71,13,96,source,0.1044313369630974,0.6505584192439863,,,726,1521
354,354,5,1,23,1,8,10,736,1508,12,13,96,of,0.11222020568663037,0.6505584192439863,,,748,1521
355,355,5,1,23,1,8,11,748,1503,59,18,96,fluid,0.1175892316999395,0.6494845360824743,,,807,1521
356,356,4,1,23,1,9,0,226,1536,580,23,-1,,0.0780399274047187,0.664733676975945,,,806,1559
357,357,5,1,23,1,9,1,226,1540,30,14,96,may,0.03644888082274652,0.6645189003436426,,,256,1554
358,358,5,1,23,1,9,2,258,1536,41,23,86,be,0.042120387174833636,0.664733676975945,,,299,1559
359,359,5,1,23,1,9,3,304,1536,88,18,86,"elevated,",0.05263157894736842,0.663659793814433,,,392,1554
360,360,5,1,23,1,9,4,396,1540,29,17,96,or,0.06208408953418028,0.6651632302405498,,,425,1557
361,361,5,1,23,1,9,5,429,1536,33,18,96,the,0.06737749546279492,0.663659793814433,,,462,1554
362,362,5,1,23,1,9,6,468,1536,88,23,96,pumping,0.07743496672716274,0.664733676975945,,,556,1559
363,363,5,1,23,1,9,7,563,1540,43,19,96,may,0.08839987900786449,0.6655927835051546,,,606,1559
364,364,5,1,23,1,9,8,611,1536,93,23,96,generate,0.09944041137326073,0.664733676975945,,,704,1559
365,365,5,1,23,1,9,9,710,1540,96,19,96,"pressure,",0.11464004839685421,0.6655927835051546,,,806,1559
366,366,4,1,23,1,10,0,225,1569,582,23,-1,,0.0780399274047187,0.6789089347079038,,,807,1592
367,367,5,1,23,1,10,1,225,1569,48,18,96,such,0.03765880217785844,0.6778350515463918,,,273,1587
368,368,5,1,23,1,10,2,283,1569,39,18,96,that,0.04575015124016939,0.6778350515463918,,,322,1587
369,369,5,1,23,1,10,3,331,1569,75,23,96,priming,0.05573200241984271,0.6789089347079038,,,406,1592
370,370,5,1,23,1,10,4,415,1569,42,18,96,fluid,0.06594071385359952,0.6778350515463918,,,457,1587
371,371,5,1,23,1,10,5,468,1569,15,18,96,is,0.07191470054446461,0.6778350515463918,,,483,1587
372,372,5,1,23,1,10,6,491,1569,65,18,96,forced,0.07917422867513611,0.6778350515463918,,,556,1587
373,373,5,1,23,1,10,7,565,1569,79,23,96,through,0.09142468239564429,0.6789089347079038,,,644,1592
374,374,5,1,23,1,10,8,654,1569,31,18,96,the,0.10125529340592862,0.6778350515463918,,,685,1587
375,375,5,1,23,1,10,9,695,1569,112,18,96,membrane,0.11358136721113128,0.6778350515463918,,,807,1587
376,376,4,1,23,1,11,0,225,1602,582,23,-1,,0.0780399274047187,0.6930841924398625,,,807,1625
377,377,5,1,23,1,11,1,225,1602,20,18,96,of,0.035541439806412584,0.6920103092783505,,,245,1620
378,378,5,1,23,1,11,2,251,1602,32,18,96,the,0.04038112522686026,0.6920103092783505,,,283,1620
379,379,5,1,23,1,11,3,291,1602,46,18,96,filter,0.04748941318814277,0.6920103092783505,,,337,1620
380,380,5,1,23,1,11,4,344,1602,38,18,96,and,0.05490018148820327,0.6920103092783505,,,382,1620
381,381,5,1,23,1,11,5,390,1602,33,18,96,out,0.06147912885662432,0.6920103092783505,,,423,1620
382,382,5,1,23,1,11,6,431,1602,32,18,96,the,0.06760435571687841,0.6920103092783505,,,463,1620
383,383,5,1,23,1,11,7,472,1602,25,18,93,air,0.07327586206896551,0.6920103092783505,,,497,1620
384,384,5,1,23,1,11,8,505,1602,77,23,93,vent(s).,0.08219903206291591,0.6930841924398625,,,582,1625
385,385,5,1,23,1,11,9,593,1602,16,18,96,In,0.09089534180278282,0.6920103092783505,,,609,1620
386,386,5,1,23,1,11,10,618,1602,148,21,96,"embodiments,",0.10465819721718088,0.6926546391752577,,,766,1623
387,387,5,1,23,1,11,11,775,1602,32,18,96,the,0.11963097398669087,0.6920103092783505,,,807,1620
388,388,4,1,23,1,12,0,225,1634,582,23,-1,,0.0780399274047187,0.7068298969072165,,,807,1657
389,389,5,1,23,1,12,1,225,1635,55,18,96,vents,0.038188142770719906,0.7061855670103093,,,280,1653
390,390,5,1,23,1,12,2,292,1639,33,14,96,are,0.04665759225650333,0.7070446735395189,,,325,1653
391,391,5,1,23,1,12,3,338,1634,128,23,96,hydrophobic,0.060798548094373864,0.7068298969072165,,,466,1657
392,392,5,1,23,1,12,4,477,1634,59,19,96,which,0.0766031457955233,0.7059707903780069,,,536,1653
393,393,5,1,23,1,12,5,549,1639,70,18,96,prevent,0.08832425892316999,0.7079037800687286,,,619,1657
394,394,5,1,23,1,12,6,621,1634,59,19,96,fluid,0.0983817301875378,0.7059707903780069,,,680,1653
395,395,5,1,23,1,12,7,691,1634,47,19,96,from,0.10806110102843315,0.7059707903780069,,,738,1653
396,396,5,1,23,1,12,8,751,1634,56,23,96,being,0.11781609195402298,0.7068298969072165,,,807,1657
397,397,4,1,23,1,13,0,225,1667,582,23,-1,,0.0780399274047187,0.7210051546391752,,,807,1690
398,398,5,1,23,1,13,1,225,1667,81,23,96,"ejected,",0.04015426497277677,0.7210051546391752,,,306,1690
399,399,5,1,23,1,13,2,314,1672,24,13,96,so,0.049304295220810646,0.7210051546391752,,,338,1685
400,400,5,1,23,1,13,3,345,1667,32,18,96,the,0.05459770114942529,0.7199312714776632,,,377,1685
401,401,5,1,23,1,13,4,385,1667,75,23,96,priming,0.06389897156684815,0.7210051546391752,,,460,1690
402,402,5,1,23,1,13,5,468,1668,73,22,95,system,0.07630066545674531,0.7212199312714777,,,541,1690
403,403,5,1,23,1,13,6,550,1672,36,13,94,can,0.08590441621294616,0.7210051546391752,,,586,1685
404,404,5,1,23,1,13,7,595,1672,31,13,94,run,0.09233212341197822,0.7210051546391752,,,626,1685
405,405,5,1,23,1,13,8,633,1667,76,18,93,without,0.1014821536600121,0.7199312714776632,,,709,1685
406,406,5,1,23,1,13,9,717,1667,90,18,91,interven-,0.11524500907441017,0.7199312714776632,,,807,1685
407,407,4,1,23,1,14,0,225,1700,42,18,-1,,0.03720508166969147,0.7341065292096219,,,267,1718
408,408,5,1,23,1,14,1,225,1700,42,18,96,tion.,0.03720508166969147,0.7341065292096219,,,267,1718
409,409,2,1,24,0,0,0,226,964,3,557,-1,,0.03440713853599516,0.5337199312714777,,,229,1521
410,410,3,1,24,1,0,0,226,964,3,557,-1,,0.03440713853599516,0.5337199312714777,,,229,1521
411,411,4,1,24,1,1,0,226,964,3,557,-1,,0.03440713853599516,0.5337199312714777,,,229,1521
412,412,5,1,24,1,1,1,226,964,3,557,95, ,0.03440713853599516,0.5337199312714777,,,229,1521
413,413,2,1,25,0,0,0,234,1198,872,26,-1,,0.1013309134906231,0.5201890034364262,,,1106,1224
414,414,3,1,25,1,0,0,234,1198,872,26,-1,,0.1013309134906231,0.5201890034364262,,,1106,1224
415,415,4,1,25,1,1,0,234,1198,872,26,-1,,0.1013309134906231,0.5201890034364262,,,1106,1224
416,416,5,1,25,1,1,1,234,1198,36,26,93,54),0.038112522686025406,0.5201890034364262,,,270,1224
417,417,5,1,25,1,1,2,316,1198,75,21,85,FLUID,0.05346339987900786,0.5191151202749141,title_line_1,FLUID,391,1219
418,418,5,1,25,1,1,3,401,1198,107,21,95,CIRCUIT,0.06873865698729582,0.5191151202749141,title_line_1,CIRCUIT,508,1219
419,419,5,1,25,1,1,4,517,1198,110,21,96,PRIMING,0.08650937689050212,0.5191151202749141,title_line_1,PRIMING,627,1219
420,420,5,1,25,1,1,5,638,1198,136,24,96,"METHODS,",0.10677555958862674,0.5197594501718213,title_line_1,"METHODS,",774,1222
421,421,5,1,25,1,1,6,786,1198,120,24,96,"DEVICES,",0.1279491833030853,0.5197594501718213,title_line_1,"DEVICES,",906,1222
422,422,5,1,25,1,1,7,915,1198,57,20,96,AND,0.1426950998185118,0.5189003436426117,title_line_1,AND,972,1218
423,423,5,1,25,1,1,8,982,1198,124,21,96,SYSTEMS,0.15789473684210525,0.5191151202749141,title_line_1,SYSTEMS,1106,1219
424,424,2,1,26,0,0,0,1045,1349,268,16,-1,,0.17831215970961886,0.5829037800687286,,,1313,1365
425,425,3,1,26,1,0,0,1045,1349,268,16,-1,,0.17831215970961886,0.5829037800687286,,,1313,1365
426,426,4,1,26,1,1,0,1045,1349,268,16,-1,,0.17831215970961886,0.5829037800687286,,,1313,1365
427,427,5,1,26,1,1,1,1045,1350,51,11,94,Connect,0.1619026013309135,0.5822594501718213,,,1096,1361
428,428,5,1,26,1,1,2,1100,1350,16,11,89,DL,0.1675741076830006,0.5822594501718213,,,1116,1361
429,429,5,1,26,1,1,3,1119,1350,33,14,96,spike,0.17173321234119782,0.5829037800687286,,,1152,1364
430,430,5,1,26,1,1,4,1155,1351,13,10,94,to,0.17566545674531156,0.5824742268041238,,,1168,1361
431,431,5,1,26,1,1,5,1173,1350,47,14,94,priming,0.1809588626739262,0.5829037800687286,,,1220,1364
432,432,5,1,26,1,1,6,1224,1349,27,12,92,fluid,0.18715970961887476,0.5820446735395189,,,1251,1361
433,433,5,1,26,1,1,7,1256,1350,23,15,95,bag,0.19169691470054445,0.583118556701031,,,1279,1365
434,434,5,1,26,1,1,8,1281,1350,32,14,93,$102,0.19615849969751967,0.5829037800687286,,,1313,1364
435,435,2,1,27,0,0,0,1059,1414,241,33,-1,,0.17838777979431336,0.6144759450171822,,,1300,1447
436,436,3,1,27,1,0,0,1059,1414,241,33,-1,,0.17838777979431336,0.6144759450171822,,,1300,1447
437,437,4,1,27,1,1,0,1059,1414,241,15,-1,,0.17838777979431336,0.6106099656357389,,,1300,1429
438,438,5,1,27,1,1,1,1059,1414,22,12,96,Run,0.161826981246219,0.6099656357388317,,,1081,1426
439,439,5,1,27,1,1,2,1086,1417,27,11,96,pump,0.16628856624319419,0.6110395189003437,,,1113,1428
440,440,5,1,27,1,1,3,1114,1417,26,12,96,and,0.1704476709013914,0.6112542955326461,,,1140,1429
441,441,5,1,27,1,1,4,1141,1414,45,12,71,allow,0.17596793708408953,0.6099656357388317,,,1186,1426
442,442,5,1,27,1,1,5,1190,1417,20,12,96,gas,0.18148820326678766,0.6112542955326461,,,1210,1429
443,443,5,1,27,1,1,6,1214,1416,13,9,96,to,0.18458862673926194,0.6101804123711341,,,1227,1425
444,444,5,1,27,1,1,7,1231,1414,27,12,95,flow,0.1882183908045977,0.6099656357388317,,,1258,1426
445,445,5,1,27,1,1,8,1262,1415,21,11,96,out,0.19245311554748942,0.6101804123711341,,,1283,1426
446,446,5,1,27,1,1,9,1287,1414,13,12,96,of,0.1956291591046582,0.6099656357388317,,,1300,1426
447,447,4,1,27,1,2,0,1065,1433,227,14,-1,,0.1782365396249244,0.6185567010309279,,,1292,1447
448,448,5,1,27,1,2,1,1065,1435,34,10,96,vents,0.16364186327888688,0.6185567010309279,,,1099,1445
449,449,5,1,27,1,2,2,1103,1436,15,9,93,on,0.16795220810647307,0.6187714776632303,,,1118,1445
450,450,5,1,27,1,2,3,1123,1433,30,12,93,filter,0.1721113127646703,0.618127147766323,,,1153,1445
451,451,5,1,27,1,2,4,1158,1433,62,12,78,non-blood,0.17982456140350878,0.618127147766323,,,1220,1445
452,452,5,1,27,1,2,5,1225,1435,32,12,96,ports,0.18768905021173624,0.6189862542955327,,,1257,1447
453,453,5,1,27,1,2,6,1261,1434,31,13,11,$104,0.19305807622504537,0.6187714776632303,,,1292,1447
454,454,2,1,28,0,0,0,1043,1488,271,98,-1,,0.1782365396249244,0.6602233676975945,,,1314,1586
455,455,3,1,28,1,0,0,1043,1488,271,98,-1,,0.1782365396249244,0.6602233676975945,,,1314,1586
456,456,4,1,28,1,1,0,1043,1488,271,15,-1,,0.1782365396249244,0.6423969072164949,,,1314,1503
457,457,5,1,28,1,1,1,1043,1488,58,12,54,Revove,0.16212946158499697,0.6417525773195877,,,1101,1500
458,458,5,1,28,1,1,2,1105,1490,27,10,93,vent,0.169162129461585,0.6421821305841925,,,1132,1500
459,459,5,1,28,1,1,3,1136,1491,28,12,96,caps,0.17392619479733817,0.6430412371134021,,,1164,1503
460,460,5,1,28,1,1,4,1168,1488,23,12,96,and,0.17838777979431336,0.6417525773195877,,,1191,1500
461,461,5,1,28,1,1,5,1195,1490,50,10,90,connect,0.18451300665456746,0.6421821305841925,,,1245,1500
462,462,5,1,28,1,1,6,1249,1488,65,12,71,non-blood|,0.1938142770719903,0.6417525773195877,,,1314,1500
463,463,4,1,28,1,2,0,1102,1507,153,15,-1,,0.1782365396249244,0.6505584192439863,,,1255,1522
464,464,5,1,28,1,2,1,1102,1509,13,10,74,to,0.1676497277676951,0.6503436426116839,,,1115,1519
465,465,5,1,28,1,2,2,1120,1507,63,12,86,non-blood,0.17415305505142165,0.6499140893470791,,,1183,1519
466,466,5,1,28,1,2,3,1188,1509,32,13,95,ports,0.1820931639443436,0.6509879725085911,,,1220,1522
467,467,5,1,28,1,2,4,1223,1508,32,14,81,$106,0.18738656987295826,0.6507731958762887,,,1255,1522
468,468,4,1,28,1,3,0,1098,1571,162,15,-1,,0.17831215970961886,0.6780498281786942,,,1260,1586
469,469,5,1,28,1,3,1,1098,1571,44,15,73,Dialyze,0.1693889897156685,0.6780498281786942,,,1142,1586
470,470,5,1,28,1,3,2,1146,1572,48,14,96,priming,0.17695099818511797,0.6782646048109966,,,1194,1586
471,471,5,1,28,1,3,3,1197,1571,28,12,94,fluid,0.18315184513006655,0.677405498281787,,,1225,1583
472,472,5,1,28,1,3,4,1228,1572,32,14,88,$108,0.1881427707199032,0.6782646048109966,,,1260,1586
473,473,2,1,29,0,0,0,1047,1636,263,34,-1,,0.1782365396249244,0.7100515463917526,,,1310,1670
474,474,3,1,29,1,0,0,1047,1636,263,34,-1,,0.1782365396249244,0.7100515463917526,,,1310,1670
475,475,4,1,29,1,1,0,1047,1636,263,14,-1,,0.1782365396249244,0.7057560137457045,,,1310,1650
476,476,5,1,29,1,1,1,1047,1636,40,14,77,Clamp,0.16137326073805203,0.7057560137457045,,,1087,1650
477,477,5,1,29,1,1,2,1091,1636,28,12,95,lines,0.16712038717483363,0.7053264604810997,,,1119,1648
478,478,5,1,29,1,1,3,1123,1636,23,11,93,and,0.17158197217180884,0.7051116838487973,,,1146,1647
479,479,5,1,29,1,1,4,1150,1638,50,10,92,connect,0.17770719903206292,0.7057560137457045,,,1200,1648
480,480,5,1,29,1,1,5,1204,1636,45,12,94,arterial,0.18549606775559588,0.7053264604810997,,,1249,1648
481,481,5,1,29,1,1,6,1252,1638,41,10,94,access,0.19245311554748942,0.7057560137457045,,,1293,1648
482,482,5,1,29,1,1,7,1297,1638,13,9,91,to,0.19714156079854808,0.7055412371134021,,,1310,1647
483,483,4,1,29,1,2,0,1136,1655,86,15,-1,,0.17831215970961886,0.7141323024054983,,,1222,1670
484,484,5,1,29,1,2,1,1136,1655,44,15,86,"patient,",0.1751361161524501,0.7141323024054983,,,1180,1670
485,485,5,1,29,1,2,2,1190,1655,32,14,86,S110,0.1823956442831216,0.7139175257731959,,,1222,1669
486,486,2,1,30,0,0,0,1049,1710,260,33,-1,,0.17831215970961886,0.7416237113402062,,,1309,1743
487,487,3,1,30,1,0,0,1049,1710,260,33,-1,,0.17831215970961886,0.7416237113402062,,,1309,1743
488,488,4,1,30,1,1,0,1049,1710,260,15,-1,,0.17831215970961886,0.7377577319587629,,,1309,1725
489,489,5,1,30,1,1,1,1049,1710,27,11,95,Pump,0.16069267997580158,0.7368986254295533,,,1076,1721
490,490,5,1,30,1,1,2,1077,1710,47,15,88,blood,0.16643980641258319,0.7377577319587629,,,1124,1725
491,491,5,1,30,1,1,3,1127,1710,16,11,88,till,0.17165759225650332,0.7368986254295533,,,1143,1721
492,492,5,1,30,1,1,4,1147,1712,32,9,93,most,0.17589231699939503,0.7373281786941581,,,1179,1721
493,493,5,1,30,1,1,5,1182,1710,13,11,96,of,0.17974894131881428,0.7368986254295533,,,1195,1721
494,494,5,1,30,1,1,6,1198,1710,49,15,94,priming,0.18489110707803993,0.7377577319587629,,,1247,1725
495,495,5,1,30,1,1,7,1250,1710,27,11,81,fluid,0.1910919540229885,0.7368986254295533,,,1277,1721
496,496,5,1,30,1,1,8,1283,1712,26,9,93,sent,0.19600725952813067,0.7373281786941581,,,1309,1721
497,497,4,1,30,1,2,0,1066,1729,227,14,-1,,0.17838777979431336,0.7457044673539519,,,1293,1743
498,498,5,1,30,1,2,1,1066,1729,21,12,93,back,0.16281004234724744,0.7452749140893471,,,1087,1741
499,499,5,1,30,1,2,2,1088,1729,22,12,96,to,0.16621294615849969,0.7452749140893471,,,1110,1741
500,500,5,1,30,1,2,3,1115,1730,48,13,96,priming,0.1722625529340593,0.7459192439862543,,,1163,1743
501,501,5,1,30,1,2,4,1166,1729,27,12,95,fluid,0.17838777979431336,0.7452749140893471,,,1193,1741
502,502,5,1,30,1,2,5,1198,1730,60,11,95,container,0.18572292800967938,0.7454896907216495,,,1258,1741
503,503,5,1,30,1,2,6,1261,1729,32,14,65,$112.,0.19313369630973987,0.7457044673539519,,,1293,1743
504,504,2,1,31,0,0,0,1056,1784,245,15,-1,,0.1782365396249244,0.7695446735395189,,,1301,1799
505,505,3,1,31,1,0,0,1056,1784,245,15,-1,,0.1782365396249244,0.7695446735395189,,,1301,1799
506,506,4,1,31,1,1,0,1056,1784,245,15,-1,,0.1782365396249244,0.7695446735395189,,,1301,1799
507,507,5,1,31,1,1,1,1056,1784,39,15,94,Clamp,0.16265880217785844,0.7695446735395189,,,1095,1799
508,508,5,1,31,1,1,2,1098,1785,24,11,90,and,0.16787658802177857,0.7691151202749141,,,1122,1796
509,509,5,1,31,1,1,3,1125,1784,50,12,90,transfer,0.17392619479733817,0.7689003436426117,,,1175,1796
510,510,5,1,31,1,1,4,1179,1788,44,8,96,venous,0.18163944343617666,0.7697594501718213,,,1223,1796
511,511,5,1,31,1,1,5,1228,1784,21,12,92,line,0.18731094978826376,0.7689003436426117,,,1249,1796
512,512,5,1,31,1,1,6,1254,1785,47,14,93,priming,0.19320931639443437,0.7697594501718213,,,1301,1799
513,513,2,1,32,0,0,0,1072,1804,214,14,-1,,0.17831215970961886,0.7779209621993127,,,1286,1818
514,514,3,1,32,1,0,0,1072,1804,214,14,-1,,0.17831215970961886,0.7779209621993127,,,1286,1818
515,515,4,1,32,1,1,0,1072,1804,214,14,-1,,0.17831215970961886,0.7779209621993127,,,1286,1818
516,516,5,1,32,1,1,1,1072,1805,69,11,96,connection,0.16734724742891713,0.7777061855670103,,,1141,1816
517,517,5,1,32,1,1,2,1146,1805,13,11,94,to,0.17430429522081065,0.7777061855670103,,,1159,1816
518,518,5,1,32,1,1,3,1163,1805,44,13,95,patient,0.1792196007259528,0.7781357388316151,,,1207,1818
519,519,5,1,32,1,1,4,1211,1807,40,9,95,access,0.18617664851784635,0.7781357388316151,,,1251,1816
520,520,5,1,32,1,1,5,1254,1804,32,14,48,$114.,0.19207501512401695,0.7779209621993127,,,1286,1818
521,521,2,1,33,0,0,0,1050,1859,255,33,-1,,0.1780852994555354,0.805627147766323,,,1305,1892
522,522,3,1,33,1,0,0,1050,1859,255,33,-1,,0.1780852994555354,0.805627147766323,,,1305,1892
523,523,4,1,33,1,1,0,1050,1859,255,14,-1,,0.1780852994555354,0.8015463917525774,,,1305,1873
524,524,5,1,33,1,1,1,1050,1859,33,11,94,Treat,0.16129764065335753,0.8009020618556701,,,1083,1870
525,525,5,1,33,1,1,2,1087,1859,45,14,96,patient,0.1678009679370841,0.8015463917525774,,,1132,1873
526,526,5,1,33,1,1,3,1136,1859,33,14,96,using,0.17430429522081065,0.8015463917525774,,,1169,1873
527,527,5,1,33,1,1,4,1172,1859,51,14,91,dialyzed,0.1811101028433152,0.8015463917525774,,,1223,1873
528,528,5,1,33,1,1,5,1227,1859,48,14,96,priming,0.18920145190562612,0.8015463917525774,,,1275,1873
529,529,5,1,33,1,1,6,1279,1859,26,11,95,fluid,0.19540229885057472,0.8009020618556701,,,1305,1870
530,530,4,1,33,1,2,0,1163,1878,31,14,-1,,0.1782365396249244,0.8097079037800687,,,1194,1892
531,531,5,1,33,1,2,1,1163,1878,31,14,45,S116,0.1782365396249244,0.8097079037800687,,,1194,1892
532,532,2,1,34,0,0,0,1050,1932,257,16,-1,,0.1782365396249244,0.8333333333333334,,,1307,1948
533,533,3,1,34,1,0,0,1050,1932,257,16,-1,,0.1782365396249244,0.8333333333333334,,,1307,1948
534,534,4,1,34,1,1,0,1050,1932,257,16,-1,,0.1782365396249244,0.8333333333333334,,,1307,1948
535,535,5,1,34,1,1,1,1050,1932,62,13,92,Rinseback,0.16349062310949788,0.8326890034364262,,,1112,1945
536,536,5,1,34,1,1,2,1116,1932,27,12,65,blood,0.17082577132486387,0.8324742268041238,,,1143,1944
537,537,5,1,34,1,1,3,1144,1932,42,12,87,after,0.17619479733817303,0.8324742268041238,,,1186,1944
538,538,5,1,34,1,1,4,1189,1933,69,15,85,connecting,0.1850423472474289,0.8335481099656358,,,1258,1948
539,539,5,1,34,1,1,5,1262,1932,45,12,95,arterial,0.19426799758015728,0.8324742268041238,,,1307,1944
540,540,2,1,35,0,0,0,1069,1952,220,15,-1,,0.17831215970961886,0.8417096219931272,,,1289,1967
541,541,3,1,35,1,0,0,1069,1952,220,15,-1,,0.17831215970961886,0.8417096219931272,,,1289,1967
542,542,4,1,35,1,1,0,1069,1952,220,15,-1,,0.17831215970961886,0.8417096219931272,,,1289,1967
543,543,5,1,35,1,1,1,1069,1952,22,12,94,line,0.16333938294010888,0.8410652920962199,,,1091,1964
544,544,5,1,35,1,1,2,1094,1954,13,10,96,to,0.16643980641258319,0.8414948453608248,,,1107,1964
545,545,5,1,35,1,1,3,1112,1955,48,12,95,priming,0.17180883242589232,0.8423539518900344,,,1160,1967
546,546,5,1,35,1,1,4,1163,1952,28,12,87,fluid,0.1780096793708409,0.8410652920962199,,,1191,1964
547,547,5,1,35,1,1,5,1195,1953,60,11,90,container,0.1852692075015124,0.8412800687285223,,,1255,1964
548,548,5,1,35,1,1,6,1258,1953,31,13,78,S118,0.1926043557168784,0.8417096219931272,,,1289,1966
549,549,2,1,36,0,0,0,1042,2007,273,53,-1,,0.1782365396249244,0.8734965635738832,,,1315,2060
550,550,3,1,36,1,0,0,1042,2007,273,53,-1,,0.1782365396249244,0.8734965635738832,,,1315,2060
551,551,4,1,36,1,1,0,1047,2007,262,15,-1,,0.1781609195402299,0.8653350515463918,,,1309,2022
552,552,5,1,36,1,1,1,1047,2007,55,13,63,Circulate,0.16250756200846944,0.864905498281787,,,1102,2020
553,553,5,1,36,1,1,2,1107,2008,47,14,95,priming,0.17097701149425287,0.8655498281786942,,,1154,2022
554,554,5,1,36,1,1,3,1159,2007,27,13,85,fluid,0.17732909860859045,0.864905498281787,,,1186,2020
555,555,5,1,36,1,1,4,1190,2010,13,10,96,to,0.1809588626739262,0.8655498281786942,,,1203,2020
556,556,5,1,36,1,1,5,1207,2011,30,9,96,rinse,0.18481548699334543,0.8657646048109966,,,1237,2020
557,557,5,1,36,1,1,6,1241,2007,36,13,88,blood,0.19041137326073806,0.864905498281787,,,1277,2020
558,558,5,1,36,1,1,7,1280,2007,29,13,95,then,0.1957803992740472,0.864905498281787,,,1309,2020
559,559,4,1,36,1,2,0,1042,2027,273,15,-1,,0.1782365396249244,0.873926116838488,,,1315,2042
560,560,5,1,36,1,2,1,1042,2030,31,12,64,lopen,0.1599364791288566,0.8745704467353952,,,1073,2042
561,561,5,1,36,1,2,2,1078,2027,27,15,52,Joop,0.16507864488808227,0.873926116838488,,,1105,2042
562,562,5,1,36,1,2,3,1108,2029,14,9,95,to,0.16863278886872354,0.8734965635738832,,,1122,2038
563,563,5,1,36,1,2,4,1126,2027,32,12,92,draw,0.17271627344222626,0.8732817869415808,,,1158,2039
564,564,5,1,36,1,2,5,1161,2030,21,12,92,gas,0.17717785843920145,0.8745704467353952,,,1182,2042
565,565,5,1,36,1,2,6,1186,2027,22,13,96,and,0.1810344827586207,0.8734965635738832,,,1208,2040
566,566,5,1,36,1,2,7,1213,2027,29,15,96,push,0.18564730792498488,0.873926116838488,,,1242,2042
567,567,5,1,36,1,2,8,1247,2027,26,12,93,fluid,0.19056261343012704,0.8732817869415808,,,1273,2039
568,568,5,1,36,1,2,9,1278,2029,37,10,15,wastel,0.19608287961282517,0.8737113402061856,,,1315,2039
569,569,4,1,36,1,3,0,1074,2046,210,14,-1,,0.17831215970961886,0.881872852233677,,,1284,2060
570,570,5,1,36,1,3,1,1074,2047,25,11,96,into,0.16432244404113733,0.8816580756013745,,,1099,2058
571,571,5,1,36,1,3,2,1103,2047,47,13,96,priming,0.1703720508166969,0.8820876288659794,,,1150,2060
572,572,5,1,36,1,3,3,1154,2046,28,12,96,fluid,0.17664851784633998,0.8814432989690721,,,1182,2058
573,573,5,1,36,1,3,4,1186,2047,60,11,95,container,0.1839080459770115,0.8816580756013745,,,1246,2058
574,574,5,1,36,1,3,5,1252,2047,32,13,39,"$120,",0.19177253478523895,0.8820876288659794,,,1284,2060
575,575,2,1,37,0,0,0,1045,2104,267,34,-1,,0.1782365396249244,0.9110824742268041,,,1312,2138
576,576,3,1,37,1,0,0,1045,2104,267,34,-1,,0.1782365396249244,0.9110824742268041,,,1312,2138
577,577,4,1,37,1,1,0,1045,2104,267,14,-1,,0.1782365396249244,0.906786941580756,,,1312,2118
578,578,5,1,37,1,1,1,1045,2105,32,13,95,Bring,0.16046581972171808,0.9070017182130584,,,1077,2118
579,579,5,1,37,1,1,2,1082,2105,47,13,94,priming,0.16719600725952813,0.9070017182130584,,,1129,2118
580,580,5,1,37,1,1,3,1133,2104,28,12,95,fluid,0.1734724742891712,0.9063573883161512,,,1161,2116
581,581,5,1,37,1,1,4,1165,2106,12,10,96,to,0.17710223835450695,0.906786941580756,,,1177,2116
582,582,5,1,37,1,1,5,1182,2104,35,12,93,blood,0.18141258318209316,0.9063573883161512,,,1217,2116
583,583,5,1,37,1,1,6,1220,2106,37,10,96,waste,0.18731094978826376,0.906786941580756,,,1257,2116
584,584,5,1,37,1,1,7,1262,2104,50,14,87,disposal,0.19464609800362975,0.906786941580756,,,1312,2118
585,585,4,1,37,1,2,0,1132,2123,94,15,-1,,0.17831215970961886,0.9151632302405498,,,1226,2138
586,586,5,1,37,1,2,1,1132,2123,23,12,96,and,0.17294313369630973,0.9145189003436426,,,1155,2135
587,587,5,1,37,1,2,2,1159,2124,32,11,96,drain,0.17770719903206292,0.914733676975945,,,1191,2135
588,588,5,1,37,1,2,3,1195,2124,31,14,91,$122,0.18307622504537205,0.9153780068728522,,,1226,2138
589,589,2,1,38,0,0,0,1160,2169,38,16,-1,,0.17831215970961886,0.9351374570446735,,,1198,2185
590,590,3,1,38,1,0,0,1160,2169,38,16,-1,,0.17831215970961886,0.9351374570446735,,,1198,2185
591,591,4,1,38,1,1,0,1160,2169,38,16,-1,,0.17831215970961886,0.9351374570446735,,,1198,2185
592,592,5,1,38,1,1,1,1160,2169,24,16,89,Fig.,0.17725347852389595,0.9351374570446735,,,1184,2185
593,593,5,1,38,1,1,2,1189,2169,9,13,71,3,0.18050514216575922,0.9344931271477663,,,1198,2182
594,594,2,1,39,0,0,0,1033,1330,291,816,-1,,0.1782365396249244,0.7465635738831615,,,1324,2146
595,595,3,1,39,1,0,0,1033,1330,291,816,-1,,0.1782365396249244,0.7465635738831615,,,1324,2146
596,596,4,1,39,1,1,0,1033,1330,291,816,-1,,0.1782365396249244,0.7465635738831615,,,1324,2146
597,597,5,1,39,1,1,1,1033,1330,291,816,95, ,0.1782365396249244,0.7465635738831615,,,1324,2146
598,598,2,1,40,0,0,0,716,2270,259,16,-1,,0.1278735632183908,0.9785223367697594,,,975,2286
599,599,3,1,40,1,0,0,716,2270,259,16,-1,,0.1278735632183908,0.9785223367697594,,,975,2286
600,600,4,1,40,1,1,0,716,2270,259,16,-1,,0.1278735632183908,0.9785223367697594,,,975,2286
601,601,5,1,40,1,1,1,716,2270,49,12,96,Printed,0.11199334543254688,0.9776632302405498,,,765,2282
602,602,5,1,40,1,1,2,771,2270,15,16,96,by,0.1177404718693285,0.9785223367697594,,,786,2286
603,603,5,1,40,1,1,3,792,2270,45,14,96,"Jouve,",0.12318511796733213,0.9780927835051546,,,837,2284
604,604,5,1,40,1,1,4,843,2270,41,12,96,75001,0.13059588626739263,0.9776632302405498,,,884,2282
605,605,5,1,40,1,1,5,893,2270,46,12,96,PARIS,0.1385359951603146,0.9776632302405498,,,939,2282
606,606,5,1,40,1,1,6,945,2270,30,16,95,(FR),0.14519056261343014,0.9785223367697594,,,975,2286
