,Unnamed: 0,level,page_num,block_num,par_num,line_num,word_num,left,top,width,height,conf,text,x,y,label,target,right,bottom
0,0,1,1,0,0,0,0,0,0,1653,2328,-1,,0.125,0.5,,,1653,2328
1,1,2,1,1,0,0,0,144,1905,31,328,-1,,0.02412280701754386,0.8887457044673539,,,175,2233
2,2,3,1,1,1,0,0,144,1905,31,328,-1,,0.02412280701754386,0.8887457044673539,,,175,2233
3,3,4,1,1,1,1,0,144,1905,31,328,-1,,0.02412280701754386,0.8887457044673539,,,175,2233
4,4,5,1,1,1,1,1,144,2179,30,54,95,EP,0.024047186932849365,0.947594501718213,,,174,2233
5,5,5,1,1,1,1,2,144,2142,31,21,94,3,0.02412280701754386,0.9246134020618557,,,175,2163
6,6,5,1,1,1,1,3,144,2061,31,65,94,401,0.02412280701754386,0.8992697594501718,,,175,2126
7,7,5,1,1,1,1,4,144,1969,31,70,93,839,0.02412280701754386,0.8608247422680413,,,175,2039
8,8,5,1,1,1,1,5,144,1905,30,50,89,A1,0.024047186932849365,0.8290378006872853,,,174,1955
9,9,2,1,2,0,0,0,429,153,88,28,-1,,0.07153660012099214,0.07173539518900343,,,517,181
10,10,3,1,2,1,0,0,429,153,88,28,-1,,0.07153660012099214,0.07173539518900343,,,517,181
11,11,4,1,2,1,1,0,429,153,88,16,-1,,0.07153660012099214,0.06915807560137457,,,517,169
12,12,5,1,2,1,1,1,429,153,88,16,84,Europaisches,0.07153660012099214,0.06915807560137457,,,517,169
13,13,4,1,2,1,2,0,429,170,71,11,-1,,0.07025105868118572,0.07538659793814433,,,500,181
14,14,5,1,2,1,2,1,429,170,71,11,96,Patentamt,0.07025105868118572,0.07538659793814433,,,500,181
15,15,2,1,3,0,0,0,429,196,89,28,-1,,0.07161222020568662,0.09020618556701031,,,518,224
16,16,3,1,3,1,0,0,429,196,89,28,-1,,0.07161222020568662,0.09020618556701031,,,518,224
17,17,4,1,3,1,1,0,429,196,63,15,-1,,0.06964609800362977,0.08741408934707903,,,492,211
18,18,5,1,3,1,1,1,429,196,63,15,95,European,0.06964609800362977,0.08741408934707903,,,492,211
19,19,4,1,3,1,2,0,429,212,89,12,-1,,0.07161222020568662,0.0936426116838488,,,518,224
20,20,5,1,3,1,2,1,429,213,43,11,96,Patent,0.06813369630973987,0.0938573883161512,,,472,224
21,21,5,1,3,1,2,2,478,212,40,12,90,Office,0.07531760435571688,0.0936426116838488,,,518,224
22,22,2,1,4,0,0,0,429,239,109,28,-1,,0.07312462189957653,0.10867697594501718,,,538,267
23,23,3,1,4,1,0,0,429,239,109,28,-1,,0.07312462189957653,0.10867697594501718,,,538,267
24,24,4,1,4,1,1,0,429,239,109,15,-1,,0.07312462189957653,0.10588487972508591,,,538,254
25,25,5,1,4,1,1,1,429,239,40,12,93,Office,0.06790683605565638,0.1052405498281787,,,469,251
26,26,5,1,4,1,1,2,474,239,64,15,93,europ√©en,0.0765275257108288,0.10588487972508591,,,538,254
27,27,4,1,4,1,2,0,429,255,77,12,-1,,0.0707047791893527,0.11211340206185567,,,506,267
28,28,5,1,4,1,2,1,429,255,22,12,95,des,0.06654567453115548,0.11211340206185567,,,451,267
29,29,5,1,4,1,2,2,457,255,49,12,82,brevets,0.07282214156079855,0.11211340206185567,,,506,267
30,30,2,1,5,0,0,0,281,136,274,150,-1,,0.06321839080459771,0.09063573883161512,,,555,286
31,31,3,1,5,1,0,0,281,136,274,150,-1,,0.06321839080459771,0.09063573883161512,,,555,286
32,32,4,1,5,1,1,0,281,136,274,150,-1,,0.06321839080459771,0.09063573883161512,,,555,286
33,33,5,1,5,1,1,1,281,136,274,150,95, ,0.06321839080459771,0.09063573883161512,,,555,286
34,34,2,1,6,0,0,0,225,324,45,26,-1,,0.037431941923774956,0.14475945017182132,,,270,350
35,35,3,1,6,1,0,0,225,324,45,26,-1,,0.037431941923774956,0.14475945017182132,,,270,350
36,36,4,1,6,1,1,0,225,324,45,26,-1,,0.037431941923774956,0.14475945017182132,,,270,350
37,37,5,1,6,1,1,1,225,324,45,26,96,(12),0.037431941923774956,0.14475945017182132,,,270,350
38,38,2,1,7,0,0,0,225,395,415,53,-1,,0.06541137326073805,0.18105670103092783,,,640,448
39,39,3,1,7,1,0,0,225,395,415,53,-1,,0.06541137326073805,0.18105670103092783,,,640,448
40,40,4,1,7,1,1,0,225,395,282,26,-1,,0.05535390199637023,0.17525773195876287,,,507,421
41,41,5,1,7,1,1,1,225,395,45,26,92,(43),0.037431941923774956,0.17525773195876287,,,270,421
42,42,5,1,7,1,1,2,285,397,222,23,90,Verdffentlichungstag:,0.05989110707803993,0.17547250859106528,,,507,420
43,43,4,1,7,1,2,0,287,430,353,18,-1,,0.07009981851179674,0.18857388316151202,,,640,448
44,44,5,1,7,1,2,1,287,430,116,18,92,14.11.2018,0.052177858439201454,0.18857388316151202,publication_date,14.11.2018,403,448
45,45,5,1,7,1,2,2,426,430,121,18,92,Patentblatt,0.0735783424077435,0.18857388316151202,,,547,448
46,46,5,1,7,1,2,3,555,430,85,18,96,2018/46,0.09036600120992136,0.18857388316151202,,,640,448
47,47,2,1,8,0,0,0,225,493,379,26,-1,,0.06268905021173624,0.21735395189003437,,,604,519
48,48,3,1,8,1,0,0,225,493,379,26,-1,,0.06268905021173624,0.21735395189003437,,,604,519
49,49,4,1,8,1,1,0,225,493,379,26,-1,,0.06268905021173624,0.21735395189003437,,,604,519
50,50,5,1,8,1,1,1,225,493,45,26,91,(21),0.037431941923774956,0.21735395189003437,,,270,519
51,51,5,1,8,1,1,2,285,495,186,18,91,Anmeldenummer:,0.05716878402903811,0.21649484536082475,,,471,513
52,52,5,1,8,1,1,3,481,495,123,18,92,18170993.2,0.08204779189352691,0.21649484536082475,application_number,18170993.2,604,513
53,53,2,1,9,0,0,0,225,559,319,26,-1,,0.05815184513006655,0.24570446735395188,,,544,585
54,54,3,1,9,1,0,0,225,559,319,26,-1,,0.05815184513006655,0.24570446735395188,,,544,585
55,55,4,1,9,1,1,0,225,559,319,26,-1,,0.05815184513006655,0.24570446735395188,,,544,585
56,56,5,1,9,1,1,1,225,559,45,26,93,(22),0.037431941923774956,0.24570446735395188,,,270,585
57,57,5,1,9,1,1,2,285,561,131,23,92,Anmeldetag:,0.0530096793708409,0.24591924398625428,,,416,584
58,58,5,1,9,1,1,3,426,561,118,18,96,07.05.2018,0.07335148215366001,0.24484536082474226,filing_date,07.05.2018,544,579
59,59,2,1,10,0,0,0,1002,245,458,38,-1,,0.18617664851784635,0.1134020618556701,,,1460,283
60,60,3,1,10,1,0,0,1002,245,458,38,-1,,0.18617664851784635,0.1134020618556701,,,1460,283
61,61,4,1,10,1,1,0,1002,245,458,38,-1,,0.18617664851784635,0.1134020618556701,,,1460,283
62,62,5,1,10,1,1,1,1002,256,44,27,74,(11),0.15486993345432548,0.11576460481099657,,,1046,283
63,63,5,1,10,1,1,2,1146,245,52,32,96,EP,0.17725347852389595,0.11211340206185567,number,EP,1198,277
64,64,5,1,10,1,1,3,1214,245,20,32,96,3,0.1851179673321234,0.11211340206185567,number,3,1234,277
65,65,5,1,10,1,1,4,1248,245,64,32,96,401,0.19358741681790684,0.11211340206185567,number,401,1312,277
66,66,5,1,10,1,1,5,1332,245,67,32,88,839,0.20651845130066546,0.11211340206185567,number,839,1399,277
67,67,5,1,10,1,1,6,1413,245,47,32,87,A1,0.21725650332728372,0.11211340206185567,number,A1,1460,277
68,68,2,1,11,0,0,0,559,314,573,31,-1,,0.1278735632183908,0.14153780068728522,,,1132,345
69,69,3,1,11,1,0,0,559,314,573,31,-1,,0.1278735632183908,0.14153780068728522,,,1132,345
70,70,4,1,11,1,1,0,559,314,573,31,-1,,0.1278735632183908,0.14153780068728522,,,1132,345
71,71,5,1,11,1,1,1,559,314,230,31,92,EUROPAISCHE,0.10193587416817906,0.14153780068728522,,,789,345
72,72,5,1,11,1,1,2,802,319,330,26,91,PATENTANMELDUNG,0.14624924379915305,0.14261168384879724,,,1132,345
73,73,2,1,12,0,0,0,862,395,247,51,-1,,0.14904718693284935,0.18062714776632302,,,1109,446
74,74,3,1,12,1,0,0,862,395,247,51,-1,,0.14904718693284935,0.18062714776632302,,,1109,446
75,75,4,1,12,1,1,0,862,395,126,26,-1,,0.13989715668481548,0.17525773195876287,,,988,421
76,76,5,1,12,1,1,1,862,395,44,26,67,(51),0.1336963097398669,0.17525773195876287,,,906,421
77,77,5,1,12,1,1,2,923,397,25,18,93,Int,0.1414851784633999,0.17439862542955326,,,948,415
78,78,5,1,12,1,1,3,955,397,33,18,65,Cl:,0.14692982456140352,0.17439862542955326,,,988,415
79,79,4,1,12,1,2,0,923,425,186,21,-1,,0.15366001209921354,0.1870704467353952,,,1109,446
80,80,5,1,12,1,2,1,923,428,61,18,66,GO6K,0.1442075015124017,0.1877147766323024,class_international,G06K,984,446
81,81,5,1,12,1,2,2,992,428,45,18,61,9/00,0.15343315184513007,0.1877147766323024,class_international,9/00,1037,446
82,82,5,1,12,1,2,3,1042,425,67,16,57,(2026.07),0.16265880217785844,0.18599656357388317,,,1109,441
83,83,2,1,13,0,0,0,224,613,1243,4,-1,,0.1278735632183908,0.26417525773195877,,,1467,617
84,84,3,1,13,1,0,0,224,613,1243,4,-1,,0.1278735632183908,0.26417525773195877,,,1467,617
85,85,4,1,13,1,1,0,224,613,1243,4,-1,,0.1278735632183908,0.26417525773195877,,,1467,617
86,86,5,1,13,1,1,1,224,613,1243,4,95, ,0.1278735632183908,0.26417525773195877,,,1467,617
87,87,2,1,14,0,0,0,225,631,599,250,-1,,0.07932546884452511,0.3247422680412371,,,824,881
88,88,3,1,14,1,0,0,225,631,599,250,-1,,0.07932546884452511,0.3247422680412371,,,824,881
89,89,4,1,14,1,1,0,225,631,342,27,-1,,0.05989110707803993,0.2768470790378007,,,567,658
90,90,5,1,14,1,1,1,225,631,45,27,93,(84),0.037431941923774956,0.2768470790378007,,,270,658
91,91,5,1,14,1,1,2,286,633,100,19,93,Benannte,0.050816696914700546,0.2759879725085911,,,386,652
92,92,5,1,14,1,1,3,393,633,174,23,92,Vertragsstaaten:,0.07259528130671507,0.2768470790378007,,,567,656
93,93,4,1,14,1,2,0,285,666,537,18,-1,,0.08371143375680581,0.28994845360824745,,,822,684
94,94,5,1,14,1,2,1,285,666,31,18,94,AL,0.04544767090139141,0.28994845360824745,,,316,684
95,95,5,1,14,1,2,2,323,666,31,18,94,AT,0.05119479733817302,0.28994845360824745,,,354,684
96,96,5,1,14,1,2,3,363,666,30,18,95,BE,0.05716878402903811,0.28994845360824745,,,393,684
97,97,5,1,14,1,2,4,403,666,32,18,95,BG,0.0633696309739867,0.28994845360824745,,,435,684
98,98,5,1,14,1,2,5,445,666,31,18,95,CH,0.06964609800362977,0.28994845360824745,,,476,684
99,99,5,1,14,1,2,6,486,666,32,18,96,CY,0.07592256503327284,0.28994845360824745,,,518,684
100,100,5,1,14,1,2,7,526,666,30,18,96,CZ,0.08182093163944344,0.28994845360824745,,,556,684
101,101,5,1,14,1,2,8,565,666,30,18,96,DE,0.08771929824561403,0.28994845360824745,,,595,684
102,102,5,1,14,1,2,9,605,666,32,18,93,DK,0.09392014519056262,0.28994845360824745,,,637,684
103,103,5,1,14,1,2,10,646,666,29,18,93,EE,0.0998941318814277,0.28994845360824745,,,675,684
104,104,5,1,14,1,2,11,684,666,29,18,93,ES,0.10564125831820932,0.28994845360824745,,,713,684
105,105,5,1,14,1,2,12,723,666,99,18,86,FIFRGB,0.11683303085299455,0.28994845360824745,,,822,684
106,106,4,1,14,1,3,0,285,699,539,18,-1,,0.0838626739261948,0.30412371134020616,,,824,717
107,107,5,1,14,1,3,1,285,699,35,18,94,GR,0.04575015124016939,0.30412371134020616,,,320,717
108,108,5,1,14,1,3,2,328,699,32,18,94,HR,0.05202661826981246,0.30412371134020616,,,360,717
109,109,5,1,14,1,3,3,368,699,14,18,41,HU,0.05671506352087114,0.30412371134020616,,,382,717
110,110,5,1,14,1,3,4,385,699,43,18,41,IE,0.06147912885662432,0.30412371134020616,,,428,717
111,111,5,1,14,1,3,5,436,699,20,18,47,IS,0.06745311554748941,0.30412371134020616,,,456,717
112,112,5,1,14,1,3,6,464,699,20,18,47,IT,0.07168784029038112,0.30412371134020616,,,484,717
113,113,5,1,14,1,3,7,492,699,54,18,83,LILT,0.07849364791288566,0.30412371134020616,,,546,717
114,114,5,1,14,1,3,8,554,699,28,18,75,LU,0.08590441621294616,0.30412371134020616,,,582,717
115,115,5,1,14,1,3,9,591,699,28,18,75,LV,0.09150030248033877,0.30412371134020616,,,619,717
116,116,5,1,14,1,3,10,627,699,35,18,95,MC,0.09747428917120388,0.30412371134020616,,,662,717
117,117,5,1,14,1,3,11,670,699,35,18,94,MK,0.10397761645493044,0.30412371134020616,,,705,717
118,118,5,1,14,1,3,12,713,699,32,18,93,MT,0.11025408348457351,0.30412371134020616,,,745,717
119,119,5,1,14,1,3,13,753,699,29,18,20,NL,0.11607683000604961,0.30412371134020616,,,782,717
120,120,5,1,14,1,3,14,791,699,33,18,20,NO,0.1221264367816092,0.30412371134020616,,,824,717
121,121,4,1,14,1,4,0,286,732,336,18,-1,,0.06866303690260134,0.31829896907216493,,,622,750
122,122,5,1,14,1,4,1,286,732,28,18,95,PL,0.045372050816696916,0.31829896907216493,,,314,750
123,123,5,1,14,1,4,2,323,732,29,18,92,PT,0.05104355716878403,0.31829896907216493,,,352,750
124,124,5,1,14,1,4,3,360,732,58,18,92,RORS,0.058832425892317,0.31829896907216493,,,418,750
125,125,5,1,14,1,4,4,420,732,52,18,96,SE,0.06745311554748941,0.31829896907216493,,,472,750
126,126,5,1,14,1,4,5,480,732,20,18,91,SI,0.07410768300060495,0.31829896907216493,,,500,750
127,127,5,1,14,1,4,6,510,732,31,18,91,SK,0.0794767090139141,0.31829896907216493,,,541,750
128,128,5,1,14,1,4,7,550,732,72,18,91,SMTR,0.08862673926194797,0.31829896907216493,,,622,750
129,129,4,1,14,1,5,0,286,765,330,23,-1,,0.06820931639443437,0.3335481099656357,,,616,788
130,130,5,1,14,1,5,1,286,765,100,18,92,Benannte,0.050816696914700546,0.3324742268041237,,,386,783
131,131,5,1,14,1,5,2,395,765,221,23,91,Erstreckungsstaaten:,0.0764519056261343,0.3335481099656357,,,616,788
132,132,4,1,14,1,6,0,286,797,74,19,-1,,0.04885057471264368,0.34643470790378006,,,360,816
133,133,5,1,14,1,6,1,286,797,33,19,96,BA,0.04575015124016939,0.34643470790378006,,,319,816
134,134,5,1,14,1,6,2,327,797,33,19,96,ME,0.05195099818511797,0.34643470790378006,,,360,816
135,135,4,1,14,1,7,0,286,830,322,23,-1,,0.06760435571687841,0.36146907216494845,,,608,853
136,136,5,1,14,1,7,1,286,830,100,18,92,Benannte,0.050816696914700546,0.3603951890034364,,,386,848
137,137,5,1,14,1,7,2,393,830,215,23,92,Validierungsstaaten:,0.07569570477918935,0.36146907216494845,,,608,853
138,138,4,1,14,1,8,0,286,863,157,18,-1,,0.055127041742286755,0.3745704467353952,,,443,881
139,139,5,1,14,1,8,1,286,863,31,18,95,KH,0.0455989110707804,0.3745704467353952,,,317,881
140,140,5,1,14,1,8,2,327,863,35,18,96,MA,0.052102238354506954,0.3745704467353952,,,362,881
141,141,5,1,14,1,8,3,371,863,34,18,95,MD,0.05868118572292801,0.3745704467353952,,,405,881
142,142,5,1,14,1,8,4,413,863,30,18,95,TN,0.0647307924984876,0.3745704467353952,,,443,881
143,143,2,1,15,0,0,0,225,927,492,26,-1,,0.07123411978221415,0.40378006872852235,,,717,953
144,144,3,1,15,1,0,0,225,927,492,26,-1,,0.07123411978221415,0.40378006872852235,,,717,953
145,145,4,1,15,1,1,0,225,927,492,26,-1,,0.07123411978221415,0.40378006872852235,,,717,953
146,146,5,1,15,1,1,1,225,927,45,26,91,(30),0.037431941923774956,0.40378006872852235,,,270,953
147,147,5,1,15,1,1,2,286,929,86,18,67,Prioritat:,0.04975801572897762,0.4029209621993127,,,372,947
148,148,5,1,15,1,1,3,383,929,118,18,93,08.05.2017,0.06684815486993345,0.4029209621993127,priority_date_eu,08.05.2017,501,947
149,149,5,1,15,1,1,4,520,929,30,18,93,DE,0.0809134906231095,0.4029209621993127,,,550,947
150,150,5,1,15,1,1,5,559,929,158,18,96,102017207754,0.09649122807017543,0.4029209621993127,,,717,947
151,151,2,1,16,0,0,0,225,992,331,156,-1,,0.059059286146400485,0.45962199312714774,,,556,1148
152,152,3,1,16,1,0,0,225,992,331,156,-1,,0.059059286146400485,0.45962199312714774,,,556,1148
153,153,4,1,16,1,1,0,225,992,166,26,-1,,0.04658197217180883,0.43170103092783507,,,391,1018
154,154,5,1,16,1,1,1,225,992,45,26,93,(71),0.037431941923774956,0.43170103092783507,,,270,1018
155,155,5,1,16,1,1,2,285,994,106,18,92,Anmelder:,0.051119177253478525,0.43084192439862545,,,391,1012
156,156,4,1,16,1,2,0,262,1027,294,18,-1,,0.06185722928009679,0.44501718213058417,,,556,1045
157,157,5,1,16,1,2,1,262,1032,7,8,73,*,0.04015426497277677,0.44501718213058417,,,269,1040
158,158,5,1,16,1,2,2,286,1027,192,18,90,Bundesdruckerei,0.05777374470659407,0.44501718213058417,applicant_line_1,Bundesdruckerei,478,1045
159,159,5,1,16,1,2,3,487,1027,69,18,95,GmbH,0.07887174833635814,0.44501718213058417,applicant_line_1,GmbH,556,1045
160,160,4,1,16,1,3,0,286,1059,193,23,-1,,0.05784936479128856,0.45983676975945015,,,479,1082
161,161,5,1,16,1,3,1,286,1059,64,19,96,10969,0.04809437386569873,0.45897766323024053,,,350,1078
162,162,5,1,16,1,3,2,359,1059,64,19,96,Berlin,0.05913490623109498,0.45897766323024053,,,423,1078
163,163,5,1,16,1,3,3,433,1059,46,23,96,(DE),0.06896551724137931,0.45983676975945015,,,479,1082
164,164,4,1,16,1,4,0,262,1092,192,18,-1,,0.05414398064125832,0.4729381443298969,,,454,1110
165,165,5,1,16,1,4,1,262,1097,7,8,76,*,0.04015426497277677,0.4729381443298969,,,269,1105
166,166,5,1,16,1,4,2,286,1092,90,18,92,neXenio,0.050060496067755596,0.4729381443298969,,,376,1110
167,167,5,1,16,1,4,3,385,1092,69,18,94,GmbH,0.06344525105868118,0.4729381443298969,,,454,1110
168,168,4,1,16,1,5,0,286,1125,193,23,-1,,0.05784936479128856,0.4881872852233677,,,479,1148
169,169,5,1,16,1,5,1,286,1125,64,19,96,10117,0.04809437386569873,0.48732817869415807,,,350,1144
170,170,5,1,16,1,5,2,359,1125,64,19,96,Berlin,0.05913490623109498,0.48732817869415807,,,423,1144
171,171,5,1,16,1,5,3,433,1125,46,23,96,(DE),0.06896551724137931,0.4881872852233677,,,479,1148
172,172,2,1,17,0,0,0,844,614,4,599,-1,,0.1279491833030853,0.39239690721649484,,,848,1213
173,173,3,1,17,1,0,0,844,614,4,599,-1,,0.1279491833030853,0.39239690721649484,,,848,1213
174,174,4,1,17,1,1,0,844,614,4,599,-1,,0.1279491833030853,0.39239690721649484,,,848,1213
175,175,5,1,17,1,1,1,844,614,4,599,95, ,0.1279491833030853,0.39239690721649484,,,848,1213
176,176,2,1,18,0,0,0,862,631,336,419,-1,,0.1557773744706594,0.36103951890034364,,,1198,1050
177,177,3,1,18,1,0,0,862,631,147,27,-1,,0.1414851784633999,0.2768470790378007,,,1009,658
178,178,4,1,18,1,1,0,862,631,147,27,-1,,0.1414851784633999,0.2768470790378007,,,1009,658
179,179,5,1,18,1,1,1,862,631,44,27,90,(72),0.1336963097398669,0.2768470790378007,,,906,658
180,180,5,1,18,1,1,2,923,633,86,19,89,Erfinder:,0.14609800362976408,0.2759879725085911,,,1009,652
181,181,3,1,18,2,0,0,898,666,289,56,-1,,0.15766787658802178,0.2981099656357388,,,1187,722
182,182,4,1,18,2,1,0,898,666,289,22,-1,,0.15766787658802178,0.29080756013745707,,,1187,688
183,183,5,1,18,2,1,1,898,671,7,8,22,¬¢,0.13634301270417423,0.28994845360824745,,,905,679
184,184,5,1,18,2,1,2,922,666,144,22,89,"SCHNJAKIN,",0.15033272837265577,0.29080756013745707,inventor_line_1,"SCHNJAKIN,",1066,688
185,185,5,1,18,2,1,3,1075,666,30,18,96,Dr.,0.1648517846339988,0.28994845360824745,inventor_line_1,Dr.,1105,684
186,186,5,1,18,2,1,4,1115,666,72,18,96,Maxim,0.17407743496672717,0.28994845360824745,inventor_line_1,Maxim,1187,684
187,187,4,1,18,2,2,0,923,699,193,23,-1,,0.154189352692075,0.30519759450171824,,,1116,722
188,188,5,1,18,2,2,1,923,699,63,18,96,10245,0.1443587416817907,0.30412371134020616,,,986,717
189,189,5,1,18,2,2,2,996,699,64,18,96,Berlin,0.15547489413188142,0.30412371134020616,,,1060,717
190,190,5,1,18,2,2,3,1070,699,46,23,96,(DE),0.16530550514216577,0.30519759450171824,,,1116,722
191,191,3,1,18,3,0,0,898,732,300,56,-1,,0.15849969751966123,0.32646048109965636,,,1198,788
192,192,4,1,18,3,1,0,898,732,300,22,-1,,0.15849969751966123,0.31915807560137455,,,1198,754
193,193,5,1,18,3,1,1,898,737,7,8,49,¬´,0.13634301270417423,0.31829896907216493,,,905,745
194,194,5,1,18,3,1,2,923,732,130,18,92,"PAESCHKE,",0.14942528735632185,0.31829896907216493,,,1053,750
195,195,5,1,18,3,1,3,1056,732,43,22,94,Dr.,0.1629612825166364,0.31915807560137455,,,1099,754
196,196,5,1,18,3,1,4,1109,732,89,18,96,Manfred,0.17445553539019965,0.31829896907216493,,,1198,750
197,197,4,1,18,3,2,0,923,765,224,23,-1,,0.15653357531760437,0.3335481099656357,,,1147,788
198,198,5,1,18,3,2,1,923,765,63,18,93,16348,0.1443587416817907,0.3324742268041237,,,986,783
199,199,5,1,18,3,2,2,994,765,98,18,90,Wandlitz,0.15774349667271628,0.3324742268041237,,,1092,783
200,200,5,1,18,3,2,3,1100,765,47,23,96,(DE),0.16991833030852996,0.3335481099656357,,,1147,788
201,201,3,1,18,4,0,0,898,797,288,56,-1,,0.15759225650332728,0.3543814432989691,,,1186,853
202,202,4,1,18,4,1,0,898,797,196,22,-1,,0.15063520871143377,0.3470790378006873,,,1094,819
203,203,5,1,18,4,1,1,898,803,7,7,49,¬´,0.13634301270417423,0.34643470790378006,,,905,810
204,204,5,1,18,4,1,2,923,797,110,19,92,"DRESSEL,",0.14791288566243194,0.34643470790378006,,,1033,816
205,205,5,1,18,4,1,3,1035,797,59,22,96,Olaf,0.16099516031457956,0.3470790378006873,,,1094,819
206,206,4,1,18,4,2,0,923,830,263,23,-1,,0.15948275862068967,0.36146907216494845,,,1186,853
207,207,5,1,18,4,2,1,923,830,61,18,91,14641,0.1442075015124017,0.3603951890034364,,,984,848
208,208,5,1,18,4,2,2,994,830,138,18,91,Wustermark,0.16076830006049606,0.3603951890034364,,,1132,848
209,209,5,1,18,4,2,3,1140,830,46,23,96,(DE),0.17589231699939503,0.36146907216494845,,,1186,853
210,210,3,1,18,5,0,0,898,863,218,55,-1,,0.15229885057471265,0.38251718213058417,,,1116,918
211,211,4,1,18,5,1,0,898,863,208,22,-1,,0.1515426497277677,0.3754295532646048,,,1106,885
212,212,5,1,18,5,1,1,898,868,7,8,29,¬´,0.13634301270417423,0.3745704467353952,,,905,876
213,213,5,1,18,5,1,2,923,863,89,18,87,"HENNIG,",0.14632486388384755,0.3745704467353952,,,1012,881
214,214,5,1,18,5,1,3,1015,863,91,22,96,Patrick,0.16039019963702358,0.3754295532646048,,,1106,885
215,215,4,1,18,5,2,0,924,895,192,23,-1,,0.1542649727767695,0.3893900343642612,,,1116,918
216,216,5,1,18,5,2,1,924,895,62,19,96,10437,0.1444343617664852,0.38853092783505155,,,986,914
217,217,5,1,18,5,2,2,996,895,64,19,96,Berlin,0.15547489413188142,0.38853092783505155,,,1060,914
218,218,5,1,18,5,2,3,1070,895,46,23,96,(DE),0.16530550514216577,0.3893900343642612,,,1116,918
219,219,3,1,18,6,0,0,898,929,218,55,-1,,0.15229885057471265,0.4108676975945017,,,1116,984
220,220,4,1,18,6,1,0,898,929,203,23,-1,,0.1511645493042952,0.40399484536082475,,,1101,952
221,221,5,1,18,6,1,1,898,934,7,8,42,¬´,0.13634301270417423,0.4029209621993127,,,905,942
222,222,5,1,18,6,1,2,923,929,100,18,96,"BERGER,",0.147156684815487,0.4029209621993127,,,1023,947
223,223,5,1,18,6,1,3,1025,929,76,23,96,Philip,0.16076830006049606,0.40399484536082475,,,1101,952
224,224,4,1,18,6,2,0,923,961,193,23,-1,,0.154189352692075,0.4177405498281787,,,1116,984
225,225,5,1,18,6,2,1,923,961,63,19,96,10627,0.1443587416817907,0.4168814432989691,,,986,980
226,226,5,1,18,6,2,2,996,961,64,19,96,Berlin,0.15547489413188142,0.4168814432989691,,,1060,980
227,227,5,1,18,6,2,3,1070,961,46,23,96,(DE),0.16530550514216577,0.4177405498281787,,,1116,984
228,228,3,1,18,7,0,0,898,994,218,56,-1,,0.15229885057471265,0.43900343642611683,,,1116,1050
229,229,4,1,18,7,1,0,898,994,175,22,-1,,0.14904718693284935,0.43170103092783507,,,1073,1016
230,230,5,1,18,7,1,1,898,999,7,8,56,¬´,0.13634301270417423,0.43084192439862545,,,905,1007
231,231,5,1,18,7,1,2,923,994,74,22,96,"LICHT,",0.14519056261343014,0.43170103092783507,,,997,1016
232,232,5,1,18,7,1,3,1006,994,67,18,96,Lucas,0.1572141560798548,0.43084192439862545,,,1073,1012
233,233,4,1,18,7,2,0,923,1027,193,23,-1,,0.154189352692075,0.44609106529209624,,,1116,1050
234,234,5,1,18,7,2,1,923,1027,63,18,96,12043,0.1443587416817907,0.44501718213058417,,,986,1045
235,235,5,1,18,7,2,2,996,1027,64,18,96,Berlin,0.15547489413188142,0.44501718213058417,,,1060,1045
236,236,5,1,18,7,2,3,1070,1027,46,23,96,(DE),0.16530550514216577,0.44609106529209624,,,1116,1050
237,237,2,1,19,0,0,0,862,1090,559,91,-1,,0.17264065335753176,0.4877577319587629,,,1421,1181
238,238,3,1,19,1,0,0,862,1090,559,91,-1,,0.17264065335753176,0.4877577319587629,,,1421,1181
239,239,4,1,19,1,1,0,862,1090,559,26,-1,,0.17264065335753176,0.4737972508591065,,,1421,1116
240,240,5,1,19,1,1,1,862,1090,44,26,93,(74),0.1336963097398669,0.4737972508591065,,,906,1116
241,241,5,1,19,1,1,2,921,1092,97,18,92,Vertreter:,0.14662734422262552,0.4729381443298969,,,1018,1110
242,242,5,1,19,1,1,3,1029,1092,95,18,93,Richardt,0.16281004234724744,0.4729381443298969,representative_line_1_eu,Richardt,1124,1110
243,243,5,1,19,1,1,4,1132,1092,158,18,86,Patentanwalte,0.18315184513006655,0.4729381443298969,representative_line_1_eu,Patentanw‚àö¬ßlte,1290,1110
244,244,5,1,19,1,1,5,1300,1092,61,18,92,PartG,0.20122504537205083,0.4729381443298969,representative_line_1_eu,PartG,1361,1110
245,245,5,1,19,1,1,6,1371,1092,50,18,91,mbB,0.21113127646702964,0.4729381443298969,representative_line_1_eu,mbB,1421,1110
246,246,4,1,19,1,2,0,921,1125,182,19,-1,,0.1530550514216576,0.48732817869415807,,,1103,1144
247,247,5,1,19,1,2,1,921,1125,162,19,31,WilhelmstraRe,0.1515426497277677,0.48732817869415807,,,1083,1144
248,248,5,1,19,1,2,2,1092,1126,11,18,96,7,0.16598608590441621,0.48754295532646047,,,1103,1144
249,249,4,1,19,1,3,0,922,1158,253,23,-1,,0.15857531760435573,0.5023625429553265,,,1175,1181
250,250,5,1,19,1,3,1,922,1158,64,18,96,65185,0.1442831215970962,0.5012886597938144,,,986,1176
251,251,5,1,19,1,3,2,994,1158,124,18,96,Wiesbaden,0.15970961887477314,0.5012886597938144,,,1118,1176
252,252,5,1,19,1,3,3,1128,1158,47,23,96,(DE),0.17415305505142165,0.5023625429553265,,,1175,1181
253,253,2,1,20,0,0,0,224,1209,1243,6,-1,,0.1278735632183908,0.520618556701031,,,1467,1215
254,254,3,1,20,1,0,0,224,1209,1243,6,-1,,0.1278735632183908,0.520618556701031,,,1467,1215
255,255,4,1,20,1,1,0,224,1209,1243,6,-1,,0.1278735632183908,0.520618556701031,,,1467,1215
256,256,5,1,20,1,1,1,224,1209,1243,6,95, ,0.1278735632183908,0.520618556701031,,,1467,1215
257,257,2,1,21,0,0,0,225,1230,45,27,-1,,0.037431941923774956,0.5341494845360825,,,270,1257
258,258,3,1,21,1,0,0,225,1230,45,27,-1,,0.037431941923774956,0.5341494845360825,,,270,1257
259,259,4,1,21,1,1,0,225,1230,45,27,-1,,0.037431941923774956,0.5341494845360825,,,270,1257
260,260,5,1,21,1,1,1,225,1230,45,27,96,(54),0.037431941923774956,0.5341494845360825,,,270,1257
261,261,2,1,22,0,0,0,225,1304,582,321,-1,,0.0780399274047187,0.6290807560137457,,,807,1625
262,262,3,1,22,1,0,0,225,1304,582,321,-1,,0.0780399274047187,0.6290807560137457,,,807,1625
263,263,4,1,22,1,1,0,225,1304,582,27,-1,,0.0780399274047187,0.5659364261168385,,,807,1331
264,264,5,1,22,1,1,1,225,1304,45,27,93,(57),0.037431941923774956,0.5659364261168385,,,270,1331
265,265,5,1,22,1,1,2,316,1306,33,19,34,Die,0.05028735632183908,0.5650773195876289,,,349,1325
266,266,5,1,22,1,1,3,360,1306,86,19,92,Erfindung,0.06094978826376286,0.5650773195876289,,,446,1325
267,267,5,1,22,1,1,4,448,1306,87,23,91,betrifft,0.07433454325468844,0.5659364261168385,,,535,1329
268,268,5,1,22,1,1,5,543,1306,44,19,95,eine,0.08545069570477919,0.5650773195876289,,,587,1325
269,269,5,1,22,1,1,6,597,1306,109,22,96,"Verfahren,",0.0985329703569268,0.5657216494845361,,,706,1328
270,270,5,1,22,1,1,7,717,1306,30,19,92,ein,0.11070780399274047,0.5650773195876289,,,747,1325
271,271,5,1,22,1,1,8,757,1306,50,19,92,elek-,0.11826981246218995,0.5650773195876289,,,807,1325
272,272,4,1,22,1,2,0,225,1339,581,23,-1,,0.0779643073200242,0.5801116838487973,,,806,1362
273,273,5,1,22,1,2,1,225,1339,107,18,90,tronisches,0.042120387174833636,0.5790378006872853,,,332,1357
274,274,5,1,22,1,2,2,341,1339,77,23,96,System,0.0573956442831216,0.5801116838487973,,,418,1362
275,275,5,1,22,1,2,3,427,1339,37,18,96,und,0.06737749546279492,0.5790378006872853,,,464,1357
276,276,5,1,22,1,2,4,473,1339,29,18,93,ein,0.07372958257713248,0.5790378006872853,,,502,1357
277,277,5,1,22,1,2,5,512,1339,242,23,92,Servercomputersystem,0.09573502722323049,0.5801116838487973,,,754,1362
278,278,5,1,22,1,2,6,764,1344,42,13,96,zum,0.11872353297035693,0.5801116838487973,,,806,1357
279,279,4,1,22,1,3,0,225,1372,582,23,-1,,0.0780399274047187,0.594286941580756,,,807,1395
280,280,5,1,22,1,3,1,225,1372,153,19,91,automatischen,0.0455989110707804,0.5934278350515464,,,378,1391
281,281,5,1,22,1,3,2,394,1372,131,19,87,Identifizieren,0.06949485783424078,0.5934278350515464,,,525,1391
282,282,5,1,22,1,3,3,541,1372,115,23,91,potentieller,0.09051724137931035,0.594286941580756,,,656,1395
283,283,5,1,22,1,3,4,670,1372,68,19,92,Nutzer,0.10647307924984876,0.5934278350515464,,,738,1391
284,284,5,1,22,1,3,5,752,1372,55,19,96,eines,0.11789171203871748,0.5934278350515464,,,807,1391
285,285,4,1,22,1,4,0,226,1405,581,23,-1,,0.07811554748941318,0.6084621993127147,,,807,1428
286,286,5,1,22,1,4,1,226,1405,171,23,92,pyrotechnischen,0.047111312764670295,0.6084621993127147,,,397,1428
287,287,5,1,22,1,4,2,406,1405,128,23,92,Gegenstands,0.07108287961282517,0.6084621993127147,,,534,1428
288,288,5,1,22,1,4,3,536,1405,35,18,96,in,0.08371143375680581,0.6073883161512027,,,571,1423
289,289,5,1,22,1,4,4,581,1405,52,18,93,einer,0.09180278281911676,0.6073883161512027,,,633,1423
290,290,5,1,22,1,4,5,640,1405,167,23,91,Veranstaltungs-,0.10942226255293407,0.6084621993127147,,,807,1428
291,291,4,1,22,1,5,0,225,1438,582,23,-1,,0.0780399274047187,0.6226374570446735,,,807,1461
292,292,5,1,22,1,5,1,225,1438,57,18,89,statte,0.03833938294010889,0.6215635738831615,,,282,1456
293,293,5,1,22,1,5,2,289,1438,59,23,96,(100).,0.048169993950393224,0.6226374570446735,,,348,1461
294,294,5,1,22,1,5,3,356,1438,100,18,96,Besucher,0.06140350877192982,0.6215635738831615,,,456,1456
295,295,5,1,22,1,5,4,461,1438,77,18,96,werden,0.07554446460980037,0.6215635738831615,,,538,1456
296,296,5,1,22,1,5,5,546,1438,48,18,93,beim,0.08620689655172414,0.6215635738831615,,,594,1456
297,297,5,1,22,1,5,6,602,1438,88,18,92,Betreten,0.09770114942528736,0.6215635738831615,,,690,1456
298,298,5,1,22,1,5,7,697,1438,34,18,93,der,0.10798548094373865,0.6215635738831615,,,731,1456
299,299,5,1,22,1,5,8,736,1438,71,18,92,Veran-,0.11668179068360557,0.6215635738831615,,,807,1456
300,300,4,1,22,1,6,0,225,1466,582,27,-1,,0.0780399274047187,0.6355240549828178,,,807,1493
301,301,5,1,22,1,6,1,225,1470,152,23,89,staltungsstatte,0.0455232909860859,0.6363831615120275,,,377,1493
302,302,5,1,22,1,6,2,397,1470,54,23,93,(100),0.06412583182093164,0.6363831615120275,,,451,1493
303,303,5,1,22,1,6,3,472,1470,66,19,92,mittels,0.07637628554143981,0.6355240549828178,,,538,1489
304,304,5,1,22,1,6,4,559,1466,248,27,92,Uberwachungskameras,0.10329703569267998,0.6355240549828178,,,807,1493
305,305,4,1,22,1,7,0,225,1503,581,23,-1,,0.0779643073200242,0.6505584192439863,,,806,1526
306,306,5,1,22,1,7,1,225,1503,52,23,96,"(120,",0.03796128251663642,0.6505584192439863,,,277,1526
307,307,5,1,22,1,7,2,290,1503,43,22,96,"220,",0.047111312764670295,0.6503436426116839,,,333,1525
308,308,5,1,22,1,7,3,346,1503,47,23,93,224),0.0558832425892317,0.6505584192439863,,,393,1526
309,309,5,1,22,1,7,4,405,1503,76,18,91,erfasst.,0.06699939503932244,0.6494845360824743,,,481,1521
310,310,5,1,22,1,7,5,495,1503,45,18,93,Eine,0.07826678765880218,0.6494845360824743,,,540,1521
311,311,5,1,22,1,7,6,552,1503,190,18,91,Anwesenheitsliste,0.09785238959467635,0.6494845360824743,,,742,1521
312,312,5,1,22,1,7,7,755,1503,51,23,96,"(132,",0.11804295220810647,0.6505584192439863,,,806,1526
313,313,4,1,22,1,8,0,225,1536,582,23,-1,,0.0780399274047187,0.664733676975945,,,807,1559
314,314,5,1,22,1,8,1,225,1536,46,23,95,292),0.03750756200846945,0.664733676975945,,,271,1559
315,315,5,1,22,1,8,2,278,1536,44,18,93,aller,0.045372050816696916,0.663659793814433,,,322,1554
316,316,5,1,22,1,8,3,328,1536,95,18,92,erfassten,0.05679068360556564,0.663659793814433,,,423,1554
317,317,5,1,22,1,8,4,431,1536,91,18,96,Besucher,0.0720659407138536,0.663659793814433,,,522,1554
318,318,5,1,22,1,8,5,524,1536,28,18,96,in,0.08136721113127647,0.663659793814433,,,552,1554
319,319,5,1,22,1,8,6,559,1536,45,18,93,dem,0.08794615849969752,0.663659793814433,,,604,1554
320,320,5,1,22,1,8,7,610,1536,197,18,92,Aufenthaltsbereich,0.10715366001209921,0.663659793814433,,,807,1554
321,321,4,1,22,1,9,0,225,1569,582,23,-1,,0.0780399274047187,0.6789089347079038,,,807,1592
322,322,5,1,22,1,9,1,225,1569,54,23,96,(104),0.038112522686025406,0.6789089347079038,,,279,1592
323,323,5,1,22,1,9,2,285,1569,42,18,93,wird,0.04627949183303085,0.6778350515463918,,,327,1587
324,324,5,1,22,1,9,3,334,1569,108,18,92,wiederholt,0.05868118572292801,0.6778350515463918,,,442,1587
325,325,5,1,22,1,9,4,448,1569,119,18,92,aktualisiert.,0.07675438596491228,0.6778350515463918,,,567,1587
326,326,5,1,22,1,9,5,575,1569,40,18,93,Das,0.08998790078644887,0.6778350515463918,,,615,1587
327,327,5,1,22,1,9,6,622,1569,79,18,84,Ziinden,0.10004537205081669,0.6778350515463918,,,701,1587
328,328,5,1,22,1,9,7,709,1569,54,18,96,eines,0.11131276467029642,0.6778350515463918,,,763,1587
329,329,5,1,22,1,9,8,770,1569,37,18,96,des,0.11925287356321838,0.6778350515463918,,,807,1587
330,330,4,1,22,1,10,0,226,1602,581,23,-1,,0.07811554748941318,0.6930841924398625,,,807,1625
331,331,5,1,22,1,10,1,226,1602,171,23,91,pyrotechnischen,0.047111312764670295,0.6930841924398625,,,397,1625
332,332,5,1,22,1,10,2,403,1602,127,23,92,Gegenstands,0.0705535390199637,0.6930841924398625,,,530,1625
333,333,5,1,22,1,10,3,533,1602,113,18,96,innerhalb,0.08915607985480943,0.6920103092783505,,,646,1620
334,334,5,1,22,1,10,4,651,1602,38,18,96,des,0.1013309134906231,0.6920103092783505,,,689,1620
335,335,5,1,22,1,10,5,694,1602,64,18,92,ersten,0.10980036297640654,0.6920103092783505,,,758,1620
336,336,5,1,22,1,10,6,764,1602,43,18,89,Auf-,0.11879915305505143,0.6920103092783505,,,807,1620
337,337,2,1,23,0,0,0,316,1226,1017,25,-1,,0.12469751966122201,0.5320017182130584,,,1333,1251
338,338,3,1,23,1,0,0,316,1226,1017,25,-1,,0.12469751966122201,0.5320017182130584,,,1333,1251
339,339,4,1,23,1,1,0,316,1226,1017,25,-1,,0.12469751966122201,0.5320017182130584,,,1333,1251
340,340,5,1,23,1,1,1,316,1231,204,20,92,IDENTIFIZIEREN,0.06321839080459771,0.5330756013745704,title_line_1,IDENTIFIZIEREN,520,1251
341,341,5,1,23,1,1,2,532,1230,200,21,90,POTENTIELLER,0.0955837870538415,0.532860824742268,title_line_1,POTENTIELLER,732,1251
342,342,5,1,23,1,1,3,741,1231,105,20,90,NUTZER,0.12000907441016334,0.5330756013745704,title_line_1,NUTZER,846,1251
343,343,5,1,23,1,1,4,857,1230,264,21,90,PYROTECHNISCHER,0.14957652752571082,0.532860824742268,title_line_1,PYROTECHNISCHER,1121,1251
344,344,5,1,23,1,1,5,1130,1226,203,25,90,GEGENSTANDE,0.18625226860254082,0.5320017182130584,,,1333,1251
345,345,2,1,24,0,0,0,883,1306,583,314,-1,,0.17763157894736842,0.6284364261168385,,,1466,1620
346,346,3,1,24,1,0,0,883,1306,583,314,-1,,0.17763157894736842,0.6284364261168385,,,1466,1620
347,347,4,1,24,1,1,0,884,1306,582,23,-1,,0.17770719903206292,0.5659364261168385,,,1466,1329
348,348,5,1,24,1,1,1,884,1306,172,19,92,enthaltsbereichs,0.14670296430732002,0.5650773195876289,,,1056,1325
349,349,5,1,24,1,1,2,1075,1306,54,23,92,(104),0.16666666666666666,0.5659364261168385,,,1129,1329
350,350,5,1,24,1,1,3,1148,1306,97,23,85,geziindet,0.1809588626739262,0.5659364261168385,,,1245,1329
351,351,5,1,24,1,1,4,1263,1306,42,19,93,wird,0.19419237749546278,0.5650773195876289,,,1305,1325
352,352,5,1,24,1,1,5,1325,1306,67,19,91,mittels,0.20545977011494254,0.5650773195876289,,,1392,1325
353,353,5,1,24,1,1,6,1410,1306,56,19,96,eines,0.21748336358136722,0.5650773195876289,,,1466,1325
354,354,4,1,24,1,2,0,885,1339,581,23,-1,,0.17778281911675742,0.5801116838487973,,,1466,1362
355,355,5,1,24,1,2,1,885,1339,117,18,91,IR-Sensors,0.1426950998185118,0.5790378006872853,,,1002,1357
356,356,5,1,24,1,2,2,1008,1339,52,23,96,"(126,",0.15638233514821537,0.5801116838487973,,,1060,1362
357,357,5,1,24,1,2,3,1067,1339,44,22,96,"230,",0.1647005444646098,0.5798969072164949,,,1111,1361
358,358,5,1,24,1,2,4,1118,1339,46,23,92,234),0.17256503327283726,0.5801116838487973,,,1164,1362
359,359,5,1,24,1,2,5,1170,1339,77,18,92,erfasst.,0.18277374470659408,0.5790378006872853,,,1247,1357
360,360,5,1,24,1,2,6,1254,1339,120,18,91,Aufnahmen,0.1987295825771325,0.5790378006872853,,,1374,1357
361,361,5,1,24,1,2,7,1381,1339,37,18,93,des,0.21166061705989112,0.5790378006872853,,,1418,1357
362,362,5,1,24,1,2,8,1423,1339,43,18,92,Auf-,0.21846642468239563,0.5790378006872853,,,1466,1357
363,363,4,1,24,1,3,0,885,1372,581,23,-1,,0.17778281911675742,0.594286941580756,,,1466,1395
364,364,5,1,24,1,3,1,885,1372,171,19,91,enthaltsbereichs,0.14677858439201452,0.5934278350515464,,,1056,1391
365,365,5,1,24,1,3,2,1066,1372,54,23,96,(104),0.16530550514216577,0.594286941580756,,,1120,1395
366,366,5,1,24,1,3,3,1130,1372,76,19,91,werden,0.17664851784633998,0.5934278350515464,,,1206,1391
367,367,5,1,24,1,3,4,1217,1372,106,23,91,analysiert.,0.19207501512401695,0.594286941580756,,,1323,1395
368,368,5,1,24,1,3,5,1334,1372,38,19,96,Alle,0.2046279491833031,0.5934278350515464,,,1372,1391
369,369,5,1,24,1,3,6,1382,1372,34,19,93,auf,0.21158499697519662,0.5934278350515464,,,1416,1391
370,370,5,1,24,1,3,7,1423,1372,43,19,93,Auf-,0.21846642468239563,0.5934278350515464,,,1466,1391
371,371,4,1,24,1,4,0,885,1405,581,23,-1,,0.17778281911675742,0.6084621993127147,,,1466,1428
372,372,5,1,24,1,4,1,885,1405,70,18,92,nahmen,0.13914095583787053,0.6073883161512027,,,955,1423
373,373,5,1,24,1,4,2,958,1405,59,18,93,nicht,0.14934966727162735,0.6073883161512027,,,1017,1423
374,374,5,1,24,1,4,3,1019,1405,175,18,90,identifizierbarer,0.16734724742891713,0.6073883161512027,,,1194,1423
375,375,5,1,24,1,4,4,1202,1405,103,22,96,"Besucher,",0.18957955232909862,0.6082474226804123,,,1305,1427
376,376,5,1,24,1,4,5,1313,1405,73,18,93,welche,0.20409860859044163,0.6073883161512027,,,1386,1423
377,377,5,1,24,1,4,6,1393,1405,73,23,0,gemak,0.2161978221415608,0.6084621993127147,,,1466,1428
378,378,4,1,24,1,5,0,884,1438,581,22,-1,,0.17763157894736842,0.6224226804123711,,,1465,1460
379,379,5,1,24,1,5,1,884,1438,34,18,92,der,0.13626739261947973,0.6215635738831615,,,918,1456
380,380,5,1,24,1,5,2,922,1438,191,18,91,Anwesenheitsliste,0.15388687235329704,0.6215635738831615,,,1113,1456
381,381,5,1,24,1,5,3,1119,1438,52,22,96,"(132,",0.17316999395039323,0.6224226804123711,,,1171,1460
382,382,5,1,24,1,5,4,1177,1438,47,22,93,292),0.18156382335148216,0.6224226804123711,,,1224,1460
383,383,5,1,24,1,5,5,1230,1442,94,14,92,anwesend,0.19313369630973987,0.6224226804123711,,,1324,1456
384,384,5,1,24,1,5,6,1325,1438,47,18,93,sein,0.20394736842105263,0.6215635738831615,,,1372,1456
385,385,5,1,24,1,5,7,1375,1438,90,21,91,"sollten,",0.2147610405323654,0.6222079037800687,,,1465,1459
386,386,4,1,24,1,6,0,883,1470,583,23,-1,,0.17763157894736842,0.6363831615120275,,,1466,1493
387,387,5,1,24,1,6,1,883,1470,65,19,94,werden,0.1384603750756201,0.6355240549828178,,,948,1489
388,388,5,1,24,1,6,2,950,1470,119,19,96,bestimmt.,0.15267695099818512,0.6355240549828178,,,1069,1489
389,389,5,1,24,1,6,3,1080,1470,58,19,93,Diese,0.1677253478523896,0.6355240549828178,,,1138,1489
390,390,5,1,24,1,6,4,1147,1470,88,19,89,umfassen,0.18012704174228675,0.6355240549828178,,,1235,1489
391,391,5,1,24,1,6,5,1237,1470,49,19,93,die,0.19078947368421054,0.6355240549828178,,,1286,1489
392,392,5,1,24,1,6,6,1295,1470,119,23,92,potentiellen,0.20485480943738657,0.6363831615120275,,,1414,1493
393,393,5,1,24,1,6,7,1424,1470,42,19,93,Nut-,0.21854204476709013,0.6355240549828178,,,1466,1489
394,394,4,1,24,1,7,0,884,1503,582,23,-1,,0.17770719903206292,0.6505584192439863,,,1466,1526
395,395,5,1,24,1,7,1,884,1508,32,13,93,zer,0.13611615245009073,0.6505584192439863,,,916,1521
396,396,5,1,24,1,7,2,924,1503,37,18,93,des,0.1425438596491228,0.6494845360824743,,,961,1521
397,397,5,1,24,1,7,3,970,1503,171,23,92,pyrotechnischen,0.15963399879007864,0.6505584192439863,,,1141,1526
398,398,5,1,24,1,7,4,1151,1503,140,23,91,Gegenstands.,0.18466424682395643,0.6505584192439863,,,1291,1526
399,399,5,1,24,1,7,5,1293,1503,59,18,92,Wird,0.2000151240169389,0.6494845360824743,,,1352,1521
400,400,5,1,24,1,7,6,1361,1503,30,18,93,ein,0.20810647307924984,0.6494845360824743,,,1391,1521
401,401,5,1,24,1,7,7,1401,1504,65,22,92,poten-,0.21680278281911675,0.6507731958762887,,,1466,1526
402,402,4,1,24,1,8,0,884,1536,582,23,-1,,0.17770719903206292,0.664733676975945,,,1466,1559
403,403,5,1,24,1,8,1,884,1536,57,18,92,tieller,0.13800665456745312,0.663659793814433,,,941,1554
404,404,5,1,24,1,8,2,952,1536,68,18,91,Nutzer,0.14912280701754385,0.663659793814433,,,1020,1554
405,405,5,1,24,1,8,3,1031,1536,48,18,93,beim,0.15955837870538414,0.663659793814433,,,1079,1554
406,406,5,1,24,1,8,4,1090,1536,105,18,92,Verlassen,0.17279189352692076,0.663659793814433,,,1195,1554
407,407,5,1,24,1,8,5,1206,1536,34,18,93,der,0.18496672716273443,0.663659793814433,,,1240,1554
408,408,5,1,24,1,8,6,1250,1536,216,23,92,Veranstaltungsstatte,0.20538415003024804,0.664733676975945,,,1466,1559
409,409,4,1,24,1,9,0,885,1569,581,23,-1,,0.17778281911675742,0.6789089347079038,,,1466,1592
410,410,5,1,24,1,9,1,885,1569,52,23,93,(100),0.13777979431336962,0.6789089347079038,,,937,1592
411,411,5,1,24,1,9,2,946,1569,84,21,92,"erkannt,",0.14942528735632185,0.678479381443299,,,1030,1590
412,412,5,1,24,1,9,3,1038,1569,42,18,96,wird,0.1601633393829401,0.6778350515463918,,,1080,1587
413,413,5,1,24,1,9,4,1089,1569,29,18,93,ein,0.16689352692075016,0.6778350515463918,,,1118,1587
414,414,5,1,24,1,9,5,1128,1569,187,23,91,Erkennungssignal,0.18473986690865093,0.6789089347079038,,,1315,1592
415,415,5,1,24,1,9,6,1324,1569,51,23,95,"(142,",0.20409860859044163,0.6789089347079038,,,1375,1592
416,416,5,1,24,1,9,7,1385,1569,45,23,93,304),0.21287053841500303,0.6789089347079038,,,1430,1592
417,417,5,1,24,1,9,8,1438,1574,28,13,92,er-,0.21960072595281308,0.6789089347079038,,,1466,1587
418,418,4,1,24,1,10,0,884,1602,53,18,-1,,0.13770417422867515,0.6920103092783505,,,937,1620
419,419,5,1,24,1,10,1,884,1602,53,18,93,stellt.,0.13770417422867515,0.6920103092783505,,,937,1620
420,420,2,1,25,0,0,0,510,1676,670,511,-1,,0.1277979431336963,0.8296821305841925,,,1180,2187
421,421,3,1,25,1,0,0,510,1676,670,511,-1,,0.1277979431336963,0.8296821305841925,,,1180,2187
422,422,4,1,25,1,1,0,510,1676,670,511,-1,,0.1277979431336963,0.8296821305841925,,,1180,2187
423,423,5,1,25,1,1,1,510,1676,670,511,95, ,0.1277979431336963,0.8296821305841925,,,1180,2187
424,424,2,1,26,0,0,0,716,2270,259,16,-1,,0.1278735632183908,0.9785223367697594,,,975,2286
425,425,3,1,26,1,0,0,716,2270,259,16,-1,,0.1278735632183908,0.9785223367697594,,,975,2286
426,426,4,1,26,1,1,0,716,2270,259,16,-1,,0.1278735632183908,0.9785223367697594,,,975,2286
427,427,5,1,26,1,1,1,716,2270,49,12,96,Printed,0.11199334543254688,0.9776632302405498,,,765,2282
428,428,5,1,26,1,1,2,771,2270,15,16,96,by,0.1177404718693285,0.9785223367697594,,,786,2286
429,429,5,1,26,1,1,3,792,2270,45,14,96,"Jouve,",0.12318511796733213,0.9780927835051546,,,837,2284
430,430,5,1,26,1,1,4,843,2270,41,12,96,75001,0.13059588626739263,0.9776632302405498,,,884,2282
431,431,5,1,26,1,1,5,893,2270,46,12,96,PARIS,0.1385359951603146,0.9776632302405498,,,939,2282
432,432,5,1,26,1,1,6,945,2270,30,16,95,(FR),0.14519056261343014,0.9785223367697594,,,975,2286
