,Unnamed: 0,level,page_num,block_num,par_num,line_num,word_num,left,top,width,height,conf,text,x,y,label,target,right,bottom
0,0,1,1,0,0,0,0,0,0,1653,2328,-1,,0.125,0.5,,,1653,2328
1,1,2,1,1,0,0,0,144,1905,31,328,-1,,0.02412280701754386,0.8887457044673539,,,175,2233
2,2,3,1,1,1,0,0,144,1905,31,328,-1,,0.02412280701754386,0.8887457044673539,,,175,2233
3,3,4,1,1,1,1,0,144,1905,31,328,-1,,0.02412280701754386,0.8887457044673539,,,175,2233
4,4,5,1,1,1,1,1,144,2179,30,54,95,EP,0.024047186932849365,0.947594501718213,,,174,2233
5,5,5,1,1,1,1,2,144,2142,31,21,95,3,0.02412280701754386,0.9246134020618557,,,175,2163
6,6,5,1,1,1,1,3,144,2055,31,71,95,375,0.02412280701754386,0.8979810996563574,,,175,2126
7,7,5,1,1,1,1,4,144,1968,31,71,89,366,0.02412280701754386,0.8606099656357389,,,175,2039
8,8,5,1,1,1,1,5,144,1905,30,50,89,A1,0.024047186932849365,0.8290378006872853,,,174,1955
9,9,2,1,2,0,0,0,429,153,88,28,-1,,0.07153660012099214,0.07173539518900343,,,517,181
10,10,3,1,2,1,0,0,429,153,88,28,-1,,0.07153660012099214,0.07173539518900343,,,517,181
11,11,4,1,2,1,1,0,429,153,88,16,-1,,0.07153660012099214,0.06915807560137457,,,517,169
12,12,5,1,2,1,1,1,429,153,88,16,84,Europaisches,0.07153660012099214,0.06915807560137457,,,517,169
13,13,4,1,2,1,2,0,429,170,71,11,-1,,0.07025105868118572,0.07538659793814433,,,500,181
14,14,5,1,2,1,2,1,429,170,71,11,96,Patentamt,0.07025105868118572,0.07538659793814433,,,500,181
15,15,2,1,3,0,0,0,429,196,89,28,-1,,0.07161222020568662,0.09020618556701031,,,518,224
16,16,3,1,3,1,0,0,429,196,89,28,-1,,0.07161222020568662,0.09020618556701031,,,518,224
17,17,4,1,3,1,1,0,429,196,63,15,-1,,0.06964609800362977,0.08741408934707903,,,492,211
18,18,5,1,3,1,1,1,429,196,63,15,95,European,0.06964609800362977,0.08741408934707903,,,492,211
19,19,4,1,3,1,2,0,429,212,89,12,-1,,0.07161222020568662,0.0936426116838488,,,518,224
20,20,5,1,3,1,2,1,429,213,43,11,96,Patent,0.06813369630973987,0.0938573883161512,,,472,224
21,21,5,1,3,1,2,2,478,212,40,12,90,Office,0.07531760435571688,0.0936426116838488,,,518,224
22,22,2,1,4,0,0,0,429,239,109,28,-1,,0.07312462189957653,0.10867697594501718,,,538,267
23,23,3,1,4,1,0,0,429,239,109,28,-1,,0.07312462189957653,0.10867697594501718,,,538,267
24,24,4,1,4,1,1,0,429,239,109,15,-1,,0.07312462189957653,0.10588487972508591,,,538,254
25,25,5,1,4,1,1,1,429,239,40,12,93,Office,0.06790683605565638,0.1052405498281787,,,469,251
26,26,5,1,4,1,1,2,474,239,64,15,93,europ√©en,0.0765275257108288,0.10588487972508591,,,538,254
27,27,4,1,4,1,2,0,429,255,77,12,-1,,0.0707047791893527,0.11211340206185567,,,506,267
28,28,5,1,4,1,2,1,429,255,22,12,95,des,0.06654567453115548,0.11211340206185567,,,451,267
29,29,5,1,4,1,2,2,457,255,49,12,82,brevets,0.07282214156079855,0.11211340206185567,,,506,267
30,30,2,1,5,0,0,0,281,136,274,150,-1,,0.06321839080459771,0.09063573883161512,,,555,286
31,31,3,1,5,1,0,0,281,136,274,150,-1,,0.06321839080459771,0.09063573883161512,,,555,286
32,32,4,1,5,1,1,0,281,136,274,150,-1,,0.06321839080459771,0.09063573883161512,,,555,286
33,33,5,1,5,1,1,1,281,136,274,150,95, ,0.06321839080459771,0.09063573883161512,,,555,286
34,34,2,1,6,0,0,0,225,324,45,26,-1,,0.037431941923774956,0.14475945017182132,,,270,350
35,35,3,1,6,1,0,0,225,324,45,26,-1,,0.037431941923774956,0.14475945017182132,,,270,350
36,36,4,1,6,1,1,0,225,324,45,26,-1,,0.037431941923774956,0.14475945017182132,,,270,350
37,37,5,1,6,1,1,1,225,324,45,26,96,(12),0.037431941923774956,0.14475945017182132,,,270,350
38,38,2,1,7,0,0,0,225,395,415,53,-1,,0.06541137326073805,0.18105670103092783,,,640,448
39,39,3,1,7,1,0,0,225,395,415,53,-1,,0.06541137326073805,0.18105670103092783,,,640,448
40,40,4,1,7,1,1,0,225,395,282,26,-1,,0.05535390199637023,0.17525773195876287,,,507,421
41,41,5,1,7,1,1,1,225,395,45,26,92,(43),0.037431941923774956,0.17525773195876287,,,270,421
42,42,5,1,7,1,1,2,285,397,222,23,90,Verdffentlichungstag:,0.05989110707803993,0.17547250859106528,,,507,420
43,43,4,1,7,1,2,0,287,430,353,18,-1,,0.07009981851179674,0.18857388316151202,,,640,448
44,44,5,1,7,1,2,1,287,430,116,18,92,19.09.2018,0.052177858439201454,0.18857388316151202,publication_date,19.09.2018,403,448
45,45,5,1,7,1,2,2,426,430,121,18,92,Patentblatt,0.0735783424077435,0.18857388316151202,,,547,448
46,46,5,1,7,1,2,3,555,430,85,18,95,2018/38,0.09036600120992136,0.18857388316151202,,,640,448
47,47,2,1,8,0,0,0,225,493,379,26,-1,,0.06268905021173624,0.21735395189003437,,,604,519
48,48,3,1,8,1,0,0,225,493,379,26,-1,,0.06268905021173624,0.21735395189003437,,,604,519
49,49,4,1,8,1,1,0,225,493,379,26,-1,,0.06268905021173624,0.21735395189003437,,,604,519
50,50,5,1,8,1,1,1,225,493,45,26,92,(21),0.037431941923774956,0.21735395189003437,,,270,519
51,51,5,1,8,1,1,2,285,495,186,18,92,Anmeldenummer:,0.05716878402903811,0.21649484536082475,,,471,513
52,52,5,1,8,1,1,3,481,495,123,18,92,18161691.3,0.08204779189352691,0.21649484536082475,application_number,18161691.3,604,513
53,53,2,1,9,0,0,0,225,559,319,26,-1,,0.05815184513006655,0.24570446735395188,,,544,585
54,54,3,1,9,1,0,0,225,559,319,26,-1,,0.05815184513006655,0.24570446735395188,,,544,585
55,55,4,1,9,1,1,0,225,559,319,26,-1,,0.05815184513006655,0.24570446735395188,,,544,585
56,56,5,1,9,1,1,1,225,559,45,26,93,(22),0.037431941923774956,0.24570446735395188,,,270,585
57,57,5,1,9,1,1,2,285,561,131,23,92,Anmeldetag:,0.0530096793708409,0.24591924398625428,,,416,584
58,58,5,1,9,1,1,3,427,561,117,18,96,14.03.2018,0.07342710223835451,0.24484536082474226,filing_date,14.03.2018,544,579
59,59,2,1,10,0,0,0,1002,245,458,38,-1,,0.18617664851784635,0.1134020618556701,,,1460,283
60,60,3,1,10,1,0,0,1002,245,458,38,-1,,0.18617664851784635,0.1134020618556701,,,1460,283
61,61,4,1,10,1,1,0,1002,245,458,38,-1,,0.18617664851784635,0.1134020618556701,,,1460,283
62,62,5,1,10,1,1,1,1002,256,44,27,74,(11),0.15486993345432548,0.11576460481099657,,,1046,283
63,63,5,1,10,1,1,2,1146,245,52,32,94,EP,0.17725347852389595,0.11211340206185567,number,EP,1198,277
64,64,5,1,10,1,1,3,1214,245,20,32,94,3,0.1851179673321234,0.11211340206185567,number,3,1234,277
65,65,5,1,10,1,1,4,1249,245,68,32,95,375,0.1940411373260738,0.11211340206185567,number,375,1317,277
66,66,5,1,10,1,1,5,1332,245,68,32,92,366,0.20659407138535996,0.11211340206185567,number,366,1400,277
67,67,5,1,10,1,1,6,1413,245,47,32,85,A1,0.21725650332728372,0.11211340206185567,number,A1,1460,277
68,68,2,1,11,0,0,0,559,314,573,31,-1,,0.1278735632183908,0.14153780068728522,,,1132,345
69,69,3,1,11,1,0,0,559,314,573,31,-1,,0.1278735632183908,0.14153780068728522,,,1132,345
70,70,4,1,11,1,1,0,559,314,573,31,-1,,0.1278735632183908,0.14153780068728522,,,1132,345
71,71,5,1,11,1,1,1,559,314,230,31,92,EUROPAISCHE,0.10193587416817906,0.14153780068728522,,,789,345
72,72,5,1,11,1,1,2,802,319,330,26,91,PATENTANMELDUNG,0.14624924379915305,0.14261168384879724,,,1132,345
73,73,2,1,12,0,0,0,862,395,126,26,-1,,0.13989715668481548,0.17525773195876287,,,988,421
74,74,3,1,12,1,0,0,862,395,126,26,-1,,0.13989715668481548,0.17525773195876287,,,988,421
75,75,4,1,12,1,1,0,862,395,126,26,-1,,0.13989715668481548,0.17525773195876287,,,988,421
76,76,5,1,12,1,1,1,862,395,44,26,67,(51),0.1336963097398669,0.17525773195876287,,,906,421
77,77,5,1,12,1,1,2,923,397,25,18,93,Int,0.1414851784633999,0.17439862542955326,,,948,415
78,78,5,1,12,1,1,3,955,397,33,18,65,Cl:,0.14692982456140352,0.17439862542955326,,,988,415
79,79,2,1,13,0,0,0,921,425,458,21,-1,,0.17392619479733817,0.1870704467353952,,,1379,446
80,80,3,1,13,1,0,0,921,425,458,21,-1,,0.17392619479733817,0.1870704467353952,,,1379,446
81,81,4,1,13,1,1,0,921,425,458,21,-1,,0.17392619479733817,0.1870704467353952,,,1379,446
82,82,5,1,13,1,1,1,921,428,61,18,74,A61B,0.14390502117362372,0.1877147766323024,class_international,A61B,982,446
83,83,5,1,13,1,1,2,990,428,59,18,58,5/053,0.154189352692075,0.1877147766323024,class_international,5/053,1049,446
84,84,5,1,13,1,1,3,1054,425,67,16,62,(2006.04),0.16447368421052633,0.18599656357388317,,,1121,441
85,85,5,1,13,1,1,4,1192,428,61,18,89,A61B,0.18489110707803993,0.1877147766323024,,,1253,446
86,86,5,1,13,1,1,5,1261,428,46,18,93,5/00,0.19419237749546278,0.1877147766323024,,,1307,446
87,87,5,1,13,1,1,6,1312,425,67,16,91,(2006.01),0.20349364791288566,0.18599656357388317,,,1379,441
88,88,2,1,14,0,0,0,224,614,1243,2,-1,,0.1278735632183908,0.26417525773195877,,,1467,616
89,89,3,1,14,1,0,0,224,614,1243,2,-1,,0.1278735632183908,0.26417525773195877,,,1467,616
90,90,4,1,14,1,1,0,224,614,1243,2,-1,,0.1278735632183908,0.26417525773195877,,,1467,616
91,91,5,1,14,1,1,1,224,614,1243,2,95, ,0.1278735632183908,0.26417525773195877,,,1467,616
92,92,2,1,15,0,0,0,225,631,599,250,-1,,0.07932546884452511,0.3247422680412371,,,824,881
93,93,3,1,15,1,0,0,225,631,599,250,-1,,0.07932546884452511,0.3247422680412371,,,824,881
94,94,4,1,15,1,1,0,225,631,342,27,-1,,0.05989110707803993,0.2768470790378007,,,567,658
95,95,5,1,15,1,1,1,225,631,45,27,93,(84),0.037431941923774956,0.2768470790378007,,,270,658
96,96,5,1,15,1,1,2,286,633,100,19,93,Benannte,0.050816696914700546,0.2759879725085911,,,386,652
97,97,5,1,15,1,1,3,393,633,174,23,92,Vertragsstaaten:,0.07259528130671507,0.2768470790378007,,,567,656
98,98,4,1,15,1,2,0,285,666,537,18,-1,,0.08371143375680581,0.28994845360824745,,,822,684
99,99,5,1,15,1,2,1,285,666,31,18,94,AL,0.04544767090139141,0.28994845360824745,,,316,684
100,100,5,1,15,1,2,2,323,666,31,18,94,AT,0.05119479733817302,0.28994845360824745,,,354,684
101,101,5,1,15,1,2,3,363,666,30,18,95,BE,0.05716878402903811,0.28994845360824745,,,393,684
102,102,5,1,15,1,2,4,403,666,32,18,95,BG,0.0633696309739867,0.28994845360824745,,,435,684
103,103,5,1,15,1,2,5,445,666,31,18,95,CH,0.06964609800362977,0.28994845360824745,,,476,684
104,104,5,1,15,1,2,6,486,666,32,18,96,CY,0.07592256503327284,0.28994845360824745,,,518,684
105,105,5,1,15,1,2,7,526,666,30,18,96,CZ,0.08182093163944344,0.28994845360824745,,,556,684
106,106,5,1,15,1,2,8,565,666,30,18,96,DE,0.08771929824561403,0.28994845360824745,,,595,684
107,107,5,1,15,1,2,9,605,666,32,18,93,DK,0.09392014519056262,0.28994845360824745,,,637,684
108,108,5,1,15,1,2,10,646,666,29,18,93,EE,0.0998941318814277,0.28994845360824745,,,675,684
109,109,5,1,15,1,2,11,684,666,29,18,93,ES,0.10564125831820932,0.28994845360824745,,,713,684
110,110,5,1,15,1,2,12,723,666,99,18,86,FIFRGB,0.11683303085299455,0.28994845360824745,,,822,684
111,111,4,1,15,1,3,0,285,699,539,18,-1,,0.0838626739261948,0.30412371134020616,,,824,717
112,112,5,1,15,1,3,1,285,699,35,18,94,GR,0.04575015124016939,0.30412371134020616,,,320,717
113,113,5,1,15,1,3,2,328,699,32,18,94,HR,0.05202661826981246,0.30412371134020616,,,360,717
114,114,5,1,15,1,3,3,368,699,14,18,41,HU,0.05671506352087114,0.30412371134020616,,,382,717
115,115,5,1,15,1,3,4,385,699,43,18,41,IE,0.06147912885662432,0.30412371134020616,,,428,717
116,116,5,1,15,1,3,5,436,699,20,18,47,IS,0.06745311554748941,0.30412371134020616,,,456,717
117,117,5,1,15,1,3,6,464,699,20,18,47,IT,0.07168784029038112,0.30412371134020616,,,484,717
118,118,5,1,15,1,3,7,492,699,54,18,83,LILT,0.07849364791288566,0.30412371134020616,,,546,717
119,119,5,1,15,1,3,8,554,699,28,18,75,LU,0.08590441621294616,0.30412371134020616,,,582,717
120,120,5,1,15,1,3,9,591,699,28,18,75,LV,0.09150030248033877,0.30412371134020616,,,619,717
121,121,5,1,15,1,3,10,627,699,35,18,95,MC,0.09747428917120388,0.30412371134020616,,,662,717
122,122,5,1,15,1,3,11,670,699,35,18,94,MK,0.10397761645493044,0.30412371134020616,,,705,717
123,123,5,1,15,1,3,12,713,699,32,18,93,MT,0.11025408348457351,0.30412371134020616,,,745,717
124,124,5,1,15,1,3,13,753,699,29,18,20,NL,0.11607683000604961,0.30412371134020616,,,782,717
125,125,5,1,15,1,3,14,791,699,33,18,20,NO,0.1221264367816092,0.30412371134020616,,,824,717
126,126,4,1,15,1,4,0,286,732,336,18,-1,,0.06866303690260134,0.31829896907216493,,,622,750
127,127,5,1,15,1,4,1,286,732,28,18,95,PL,0.045372050816696916,0.31829896907216493,,,314,750
128,128,5,1,15,1,4,2,323,732,29,18,92,PT,0.05104355716878403,0.31829896907216493,,,352,750
129,129,5,1,15,1,4,3,360,732,58,18,92,RORS,0.058832425892317,0.31829896907216493,,,418,750
130,130,5,1,15,1,4,4,420,732,52,18,96,SE,0.06745311554748941,0.31829896907216493,,,472,750
131,131,5,1,15,1,4,5,480,732,20,18,91,SI,0.07410768300060495,0.31829896907216493,,,500,750
132,132,5,1,15,1,4,6,510,732,31,18,91,SK,0.0794767090139141,0.31829896907216493,,,541,750
133,133,5,1,15,1,4,7,550,732,72,18,91,SMTR,0.08862673926194797,0.31829896907216493,,,622,750
134,134,4,1,15,1,5,0,286,765,330,23,-1,,0.06820931639443437,0.3335481099656357,,,616,788
135,135,5,1,15,1,5,1,286,765,100,18,92,Benannte,0.050816696914700546,0.3324742268041237,,,386,783
136,136,5,1,15,1,5,2,395,765,221,23,91,Erstreckungsstaaten:,0.0764519056261343,0.3335481099656357,,,616,788
137,137,4,1,15,1,6,0,286,797,74,19,-1,,0.04885057471264368,0.34643470790378006,,,360,816
138,138,5,1,15,1,6,1,286,797,33,19,96,BA,0.04575015124016939,0.34643470790378006,,,319,816
139,139,5,1,15,1,6,2,327,797,33,19,96,ME,0.05195099818511797,0.34643470790378006,,,360,816
140,140,4,1,15,1,7,0,286,830,322,23,-1,,0.06760435571687841,0.36146907216494845,,,608,853
141,141,5,1,15,1,7,1,286,830,100,18,92,Benannte,0.050816696914700546,0.3603951890034364,,,386,848
142,142,5,1,15,1,7,2,393,830,215,23,92,Validierungsstaaten:,0.07569570477918935,0.36146907216494845,,,608,853
143,143,4,1,15,1,8,0,286,863,157,18,-1,,0.055127041742286755,0.3745704467353952,,,443,881
144,144,5,1,15,1,8,1,286,863,31,18,95,KH,0.0455989110707804,0.3745704467353952,,,317,881
145,145,5,1,15,1,8,2,327,863,35,18,96,MA,0.052102238354506954,0.3745704467353952,,,362,881
146,146,5,1,15,1,8,3,371,863,34,18,95,MD,0.05868118572292801,0.3745704467353952,,,405,881
147,147,5,1,15,1,8,4,413,863,30,18,95,TN,0.0647307924984876,0.3745704467353952,,,443,881
148,148,2,1,16,0,0,0,225,927,581,91,-1,,0.0779643073200242,0.4177405498281787,,,806,1018
149,149,3,1,16,1,0,0,225,927,581,91,-1,,0.0779643073200242,0.4177405498281787,,,806,1018
150,150,4,1,16,1,1,0,225,927,491,26,-1,,0.07115849969751967,0.40378006872852235,,,716,953
151,151,5,1,16,1,1,1,225,927,45,26,93,(30),0.037431941923774956,0.40378006872852235,,,270,953
152,152,5,1,16,1,1,2,286,929,86,18,72,Prioritat:,0.04975801572897762,0.4029209621993127,,,372,947
153,153,5,1,16,1,1,3,384,929,117,18,92,14.03.2017,0.06692377495462795,0.4029209621993127,priority_date_eu,14.03.2017,501,947
154,154,5,1,16,1,1,4,520,929,30,18,92,DE,0.0809134906231095,0.4029209621993127,,,550,947
155,155,5,1,16,1,1,5,559,929,157,18,95,102017105447,0.09641560798548095,0.4029209621993127,,,716,947
156,156,4,1,16,1,2,0,225,992,581,26,-1,,0.0779643073200242,0.43170103092783507,,,806,1018
157,157,5,1,16,1,2,1,225,992,45,26,93,(71),0.037431941923774956,0.43170103092783507,,,270,1018
158,158,5,1,16,1,2,2,285,994,106,18,92,Anmelder:,0.051119177253478525,0.43084192439862545,,,391,1012
159,159,5,1,16,1,2,3,401,994,96,18,92,Senetics,0.06790683605565638,0.43084192439862545,applicant_line_1,Senetics,497,1012
160,160,5,1,16,1,2,4,506,994,120,18,96,Healthcare,0.08560193587416817,0.43084192439862545,applicant_line_1,Healthcare,626,1012
161,161,5,1,16,1,2,5,634,994,70,23,96,Group,0.10117967332123412,0.4319158075601375,applicant_line_1,Group,704,1017
162,162,5,1,16,1,2,6,712,994,70,18,93,GmbH,0.11297640653357532,0.43084192439862545,applicant_line_1,GmbH,782,1012
163,163,5,1,16,1,2,7,791,994,15,18,93,&,0.12076527525710828,0.43084192439862545,applicant_line_1,&,806,1012
164,164,2,1,17,0,0,0,285,1027,228,55,-1,,0.0603448275862069,0.4529639175257732,,,513,1082
165,165,3,1,17,1,0,0,285,1027,228,55,-1,,0.0603448275862069,0.4529639175257732,,,513,1082
166,166,4,1,17,1,1,0,286,1027,77,18,-1,,0.04907743496672716,0.44501718213058417,,,363,1045
167,167,5,1,17,1,1,1,286,1027,35,18,94,Co.,0.04590139140955838,0.44501718213058417,applicant_line_1,Co.,321,1045
168,168,5,1,17,1,1,2,331,1027,32,18,96,KG,0.05248033877797943,0.44501718213058417,applicant_line_1,KG,363,1045
169,169,4,1,17,1,2,0,285,1059,228,23,-1,,0.0603448275862069,0.45983676975945015,,,513,1082
170,170,5,1,17,1,2,1,285,1059,65,19,96,91522,0.04801875378100424,0.45897766323024053,,,350,1078
171,171,5,1,17,1,2,2,358,1059,98,19,96,Ansbach,0.061554748941318814,0.45897766323024053,,,456,1078
172,172,5,1,17,1,2,3,466,1059,47,23,96,(DE),0.07403206291591047,0.45983676975945015,,,513,1082
173,173,2,1,18,0,0,0,845,614,2,500,-1,,0.1279491833030853,0.3711340206185567,,,847,1114
174,174,3,1,18,1,0,0,845,614,2,500,-1,,0.1279491833030853,0.3711340206185567,,,847,1114
175,175,4,1,18,1,1,0,845,614,2,500,-1,,0.1279491833030853,0.3711340206185567,,,847,1114
176,176,5,1,18,1,1,1,845,614,2,500,95, ,0.1279491833030853,0.3711340206185567,,,847,1114
177,177,2,1,19,0,0,0,862,631,288,157,-1,,0.15214761040532365,0.30476804123711343,,,1150,788
178,178,3,1,19,1,0,0,862,631,288,157,-1,,0.15214761040532365,0.30476804123711343,,,1150,788
179,179,4,1,19,1,1,0,862,631,147,27,-1,,0.1414851784633999,0.2768470790378007,,,1009,658
180,180,5,1,19,1,1,1,862,631,44,27,90,(72),0.1336963097398669,0.2768470790378007,,,906,658
181,181,5,1,19,1,1,2,923,633,86,19,89,Erfinder:,0.14609800362976408,0.2759879725085911,,,1009,652
182,182,4,1,19,1,2,0,898,666,223,23,-1,,0.15267695099818512,0.29102233676975947,,,1121,689
183,183,5,1,19,1,2,1,898,671,7,8,55,¬¢,0.13634301270417423,0.28994845360824745,,,905,679
184,184,5,1,19,1,2,2,921,666,114,23,93,"Wolfgang,",0.14791288566243194,0.29102233676975947,inventor_line_1,"Wolfgang,",1035,689
185,185,5,1,19,1,2,3,1044,666,77,23,91,Sening,0.16371748336358136,0.29102233676975947,inventor_line_1,Sening,1121,689
186,186,4,1,19,1,3,0,922,699,227,23,-1,,0.15660919540229884,0.30519759450171824,,,1149,722
187,187,5,1,19,1,3,1,922,699,64,18,96,91522,0.1442831215970962,0.30412371134020616,,,986,717
188,188,5,1,19,1,3,2,994,699,99,18,96,Ansbach,0.15781911675741075,0.30412371134020616,,,1093,717
189,189,5,1,19,1,3,3,1103,699,46,23,96,(DE),0.17029643073200243,0.30519759450171824,,,1149,722
190,190,4,1,19,1,4,0,898,732,186,22,-1,,0.1498790078644888,0.31915807560137455,,,1084,754
191,191,5,1,19,1,4,1,898,737,7,8,39,¬¢,0.13634301270417423,0.31829896907216493,,,905,745
192,192,5,1,19,1,4,2,921,732,69,22,92,"Wiehl,",0.14450998185117966,0.31915807560137455,,,990,754
193,193,5,1,19,1,4,3,999,732,85,18,96,Michael,0.15751663641863278,0.31829896907216493,,,1084,750
194,194,4,1,19,1,5,0,922,765,228,23,-1,,0.15668481548699334,0.3335481099656357,,,1150,788
195,195,5,1,19,1,5,1,922,765,64,18,96,91522,0.1442831215970962,0.3324742268041237,,,986,783
196,196,5,1,19,1,5,2,996,765,98,23,95,Erlangen,0.15804597701149425,0.3335481099656357,,,1094,788
197,197,5,1,19,1,5,3,1104,765,46,23,96,(DE),0.1704476709013914,0.3335481099656357,,,1150,788
198,198,2,1,20,0,0,0,862,828,413,124,-1,,0.1616001209921355,0.38230240549828176,,,1275,952
199,199,3,1,20,1,0,0,862,828,413,124,-1,,0.1616001209921355,0.38230240549828176,,,1275,952
200,200,4,1,20,1,1,0,862,828,381,26,-1,,0.15918027828191167,0.36125429553264604,,,1243,854
201,201,5,1,20,1,1,1,862,828,44,26,93,(74),0.1336963097398669,0.36125429553264604,,,906,854
202,202,5,1,20,1,1,2,921,830,97,18,92,Vertreter:,0.14662734422262552,0.3603951890034364,,,1018,848
203,203,5,1,20,1,1,3,1027,830,114,22,93,"Wittmann,",0.16394434361766486,0.36125429553264604,representative_line_1_eu,"Wittmann,",1141,852
204,204,5,1,20,1,1,4,1151,830,92,18,58,Giinther,0.1810344827586207,0.3603951890034364,representative_line_1_eu,G‚àö¬∫nther,1243,848
205,205,4,1,20,1,2,0,923,863,352,18,-1,,0.16621294615849969,0.3745704467353952,,,1275,881
206,206,5,1,20,1,2,1,923,863,237,18,91,Patentanwaltskanzlei,0.15751663641863278,0.3745704467353952,,,1160,881
207,207,5,1,20,1,2,2,1168,863,107,18,96,Wittmann,0.18473986690865093,0.3745704467353952,,,1275,881
208,208,4,1,20,1,3,0,923,895,233,19,-1,,0.1572141560798548,0.38853092783505155,,,1156,914
209,209,5,1,20,1,3,1,923,895,202,19,37,Frans-Hals-StraRe,0.15486993345432548,0.38853092783505155,,,1125,914
210,210,5,1,20,1,3,2,1135,895,21,19,83,31,0.17324561403508773,0.38853092783505155,,,1156,914
211,211,4,1,20,1,4,0,922,929,231,23,-1,,0.15691167574107684,0.40399484536082475,,,1153,952
212,212,5,1,20,1,4,1,922,929,64,18,91,81479,0.1442831215970962,0.4029209621993127,,,986,947
213,213,5,1,20,1,4,2,996,929,101,18,91,Miinchen,0.15827283726557773,0.4029209621993127,,,1097,947
214,214,5,1,20,1,4,3,1107,929,46,23,96,(DE),0.17090139140955837,0.40399484536082475,,,1153,952
215,215,2,1,21,0,0,0,224,1112,1243,2,-1,,0.1278735632183908,0.47809278350515466,,,1467,1114
216,216,3,1,21,1,0,0,224,1112,1243,2,-1,,0.1278735632183908,0.47809278350515466,,,1467,1114
217,217,4,1,21,1,1,0,224,1112,1243,2,-1,,0.1278735632183908,0.47809278350515466,,,1467,1114
218,218,5,1,21,1,1,1,224,1112,1243,2,95, ,0.1278735632183908,0.47809278350515466,,,1467,1114
219,219,2,1,22,0,0,0,225,1131,1235,134,-1,,0.12741984271022383,0.5146048109965635,,,1460,1265
220,220,3,1,22,1,0,0,225,1131,1235,134,-1,,0.12741984271022383,0.5146048109965635,,,1460,1265
221,221,4,1,22,1,1,0,225,1131,1235,27,-1,,0.12741984271022383,0.49162371134020616,,,1460,1158
222,222,5,1,22,1,1,1,225,1131,45,27,85,(54),0.037431941923774956,0.49162371134020616,,,270,1158
223,223,5,1,22,1,1,2,315,1131,195,21,85,VORRICHTUNG,0.06238656987295826,0.49033505154639173,title_line_1,VORRICHTUNG,510,1152
224,224,5,1,22,1,1,3,521,1132,54,20,91,UND,0.08287961282516637,0.49054982817869414,title_line_1,UND,575,1152
225,225,5,1,22,1,1,4,582,1132,164,20,91,VERFAHREN,0.10042347247428918,0.49054982817869414,title_line_1,VERFAHREN,746,1152
226,226,5,1,22,1,1,5,755,1132,54,20,93,ZUM,0.11826981246218995,0.49054982817869414,title_line_1,ZUM,809,1152
227,227,5,1,22,1,1,6,820,1132,147,20,91,ERMITTELN,0.13513309134906232,0.49054982817869414,title_line_1,ERMITTELN,967,1152
228,228,5,1,22,1,1,7,978,1131,52,21,93,DES,0.15184513006654568,0.49033505154639173,title_line_1,DES,1030,1152
229,229,5,1,22,1,1,8,1038,1131,318,21,92,HYDRATIONSZUSTANDES,0.1810344827586207,0.49033505154639173,title_line_1,HYDRATIONSZUSTANDES,1356,1152
230,230,5,1,22,1,1,9,1358,1131,102,21,96,EINES,0.2130973986690865,0.49033505154639173,,,1460,1152
231,231,4,1,22,1,2,0,316,1160,744,26,-1,,0.10405323653962492,0.5038659793814433,,,1060,1186
232,232,5,1,22,1,2,1,316,1160,112,26,92,KORPERS,0.056261343012704176,0.5038659793814433,,,428,1186
233,233,5,1,22,1,2,2,429,1165,103,21,93,EINES,0.07267090139140955,0.5049398625429553,,,532,1186
234,234,5,1,22,1,2,3,542,1165,129,21,92,MENSCHEN,0.09172716273442226,0.5049398625429553,,,671,1186
235,235,5,1,22,1,2,4,675,1165,81,21,96,ODER,0.10821234119782214,0.5049398625429553,,,756,1186
236,236,5,1,22,1,2,5,759,1165,104,21,93,EINES,0.12265577737447066,0.5049398625429553,title_line_1,EINES,863,1186
237,237,5,1,22,1,2,6,872,1160,188,26,91,SAUGETIERES,0.14609800362976408,0.5038659793814433,,,1060,1186
238,238,4,1,22,1,3,0,225,1239,582,26,-1,,0.0780399274047187,0.5378006872852233,,,807,1265
239,239,5,1,22,1,3,1,225,1239,45,26,89,(57),0.037431941923774956,0.5378006872852233,,,270,1265
240,240,5,1,22,1,3,2,316,1241,33,18,55,Die,0.05028735632183908,0.5369415807560137,,,349,1259
241,241,5,1,22,1,3,3,369,1241,99,23,91,Erfindung,0.0632940108892922,0.5380154639175257,,,468,1264
242,242,5,1,22,1,3,4,487,1241,94,18,92,offenbart,0.08076225045372051,0.5369415807560137,,,581,1259
243,243,5,1,22,1,3,5,600,1241,43,18,92,eine,0.0939957652752571,0.5369415807560137,,,643,1259
244,244,5,1,22,1,3,6,662,1241,145,23,92,Hydrationszu-,0.11108590441621295,0.5380154639175257,,,807,1264
245,245,2,1,23,0,0,0,224,1274,584,351,-1,,0.0780399274047187,0.6226374570446735,,,808,1625
246,246,3,1,23,1,0,0,225,1274,582,88,-1,,0.0780399274047187,0.5661512027491409,,,807,1362
247,247,4,1,23,1,1,0,225,1274,581,23,-1,,0.0779643073200242,0.5521907216494846,,,806,1297
248,248,5,1,23,1,1,1,225,1274,309,23,91,"standserfassungsvorrichtung,",0.0573956442831216,0.5521907216494846,,,534,1297
249,249,5,1,23,1,1,2,545,1274,31,18,96,die,0.08477011494252873,0.5511168384879725,,,576,1292
250,250,5,1,23,1,1,3,586,1274,50,18,93,dazu,0.09240774349667272,0.5511168384879725,,,636,1292
251,251,5,1,23,1,1,4,647,1274,114,23,92,ausgebildet,0.10647307924984876,0.5521907216494846,,,761,1297
252,252,5,1,23,1,1,5,762,1274,44,21,96,"ist,",0.11857229280096794,0.5517611683848798,,,806,1295
253,253,4,1,23,1,2,0,225,1306,582,23,-1,,0.0780399274047187,0.5659364261168385,,,807,1329
254,254,5,1,23,1,2,1,225,1306,38,19,93,den,0.03690260133091349,0.5650773195876289,,,263,1325
255,255,5,1,23,1,2,2,273,1306,195,23,91,Hydrationszustand,0.05603448275862069,0.5659364261168385,,,468,1329
256,256,5,1,23,1,2,3,478,1306,55,19,93,eines,0.0764519056261343,0.5650773195876289,,,533,1325
257,257,5,1,23,1,2,4,543,1306,81,23,82,K√©rpers,0.0882486388384755,0.5659364261168385,,,624,1329
258,258,5,1,23,1,2,5,633,1306,56,19,96,eines,0.0999697519661222,0.5650773195876289,,,689,1325
259,259,5,1,23,1,2,6,700,1306,107,19,96,Menschen,0.11395946763460375,0.5650773195876289,,,807,1325
260,260,4,1,23,1,3,0,225,1339,513,23,-1,,0.07282214156079855,0.5801116838487973,,,738,1362
261,261,5,1,23,1,3,1,225,1339,47,18,96,oder,0.03758318209316394,0.5790378006872853,,,272,1357
262,262,5,1,23,1,3,2,279,1339,56,18,93,eines,0.046430732002419844,0.5790378006872853,,,335,1357
263,263,5,1,23,1,3,3,343,1339,126,23,90,Saugetieres,0.06140350877192982,0.5801116838487973,,,469,1362
264,264,5,1,23,1,3,4,477,1344,23,13,91,zu,0.07388082274652148,0.5801116838487973,,,500,1357
265,265,5,1,23,1,3,5,509,1339,95,21,90,"erfassen,",0.08416515426497277,0.5796821305841925,,,604,1360
266,266,5,1,23,1,3,6,614,1339,124,18,91,aufweisend:,0.10223835450695705,0.5790378006872853,,,738,1357
267,267,3,1,23,2,0,0,224,1372,584,253,-1,,0.0780399274047187,0.6436855670103093,,,808,1625
268,268,4,1,23,2,1,0,225,1372,581,23,-1,,0.0779643073200242,0.594286941580756,,,806,1395
269,269,5,1,23,2,1,1,225,1383,6,2,93,-,0.034482758620689655,0.5945017182130584,,,231,1385
270,270,5,1,23,2,1,2,240,1372,43,19,96,eine,0.039549304295220813,0.5934278350515464,,,283,1391
271,271,5,1,23,2,1,3,290,1373,52,18,93,erste,0.04779189352692075,0.5936426116838488,,,342,1391
272,272,5,1,23,2,1,4,351,1372,187,23,91,"Sensoranordnung,",0.06722625529340592,0.594286941580756,,,538,1395
273,273,5,1,23,2,1,5,541,1372,42,22,96,die,0.08499697519661222,0.5940721649484536,,,583,1394
274,274,5,1,23,2,1,6,591,1372,50,19,93,dazu,0.09316394434361766,0.5934278350515464,,,641,1391
275,275,5,1,23,2,1,7,650,1372,113,23,92,ausgebildet,0.10685117967332124,0.594286941580756,,,763,1395
276,276,5,1,23,2,1,8,765,1372,41,22,96,"ist,",0.11879915305505143,0.5940721649484536,,,806,1394
277,277,4,1,23,2,2,0,225,1405,583,23,-1,,0.07811554748941318,0.6084621993127147,,,808,1428
278,278,5,1,23,2,2,1,225,1405,205,23,92,elektromagnetische,0.04953115547489413,0.6084621993127147,,,430,1428
279,279,5,1,23,2,2,2,437,1405,72,18,92,Wellen,0.07153660012099214,0.6073883161512027,,,509,1423
280,280,5,1,23,2,2,3,519,1405,45,18,8,iiber,0.08189655172413793,0.6073883161512027,,,564,1423
281,281,5,1,23,2,2,4,571,1405,31,18,96,die,0.08870235934664247,0.6073883161512027,,,602,1423
282,282,5,1,23,2,2,5,610,1405,49,18,96,Haut,0.09596188747731398,0.6073883161512027,,,659,1423
283,283,5,1,23,2,2,6,667,1405,15,18,96,in,0.10201149425287356,0.6073883161512027,,,682,1423
284,284,5,1,23,2,2,7,691,1405,37,18,93,den,0.10730490018148821,0.6073883161512027,,,728,1423
285,285,5,1,23,2,2,8,738,1405,70,23,60,K6rper,0.11690865093768905,0.6084621993127147,,,808,1428
286,286,4,1,23,2,3,0,225,1438,583,23,-1,,0.07811554748941318,0.6226374570446735,,,808,1461
287,287,5,1,23,2,3,1,225,1442,23,14,88,zu,0.03576830006049607,0.6224226804123711,,,248,1456
288,288,5,1,23,2,3,2,262,1438,109,21,88,"emittieren,",0.047867513611615245,0.6222079037800687,,,371,1459
289,289,5,1,23,2,3,3,387,1438,37,18,96,und,0.06132788868723533,0.6215635738831615,,,424,1456
290,290,5,1,23,2,3,4,438,1438,50,18,93,dazu,0.07002419842710224,0.6215635738831615,,,488,1456
291,291,5,1,23,2,3,5,503,1438,121,23,92,ausgebildet,0.0852238354506957,0.6226374570446735,,,624,1461
292,292,5,1,23,2,3,6,638,1438,26,21,96,"ist,",0.0984573502722323,0.6222079037800687,,,664,1459
293,293,5,1,23,2,3,7,679,1442,43,14,92,vom,0.1059437386569873,0.6224226804123711,,,722,1456
294,294,5,1,23,2,3,8,738,1438,70,23,85,K6rper,0.11690865093768905,0.6226374570446735,,,808,1461
295,295,4,1,23,2,4,0,225,1470,581,23,-1,,0.0779643073200242,0.6363831615120275,,,806,1493
296,296,5,1,23,2,4,1,225,1470,136,19,92,transmittierte,0.04431336963097399,0.6355240549828178,,,361,1489
297,297,5,1,23,2,4,2,370,1470,205,23,89,elektromagnetische,0.07146098003629764,0.6363831615120275,,,575,1493
298,298,5,1,23,2,4,3,582,1470,72,19,92,Wellen,0.09346642468239565,0.6355240549828178,,,654,1489
299,299,5,1,23,2,4,4,664,1470,92,19,91,und/oder,0.1073805202661827,0.6355240549828178,,,756,1489
300,300,5,1,23,2,4,5,764,1475,42,14,96,vom,0.11872353297035693,0.6365979381443299,,,806,1489
301,301,4,1,23,2,5,0,225,1503,582,23,-1,,0.0780399274047187,0.6505584192439863,,,807,1526
302,302,5,1,23,2,5,1,225,1503,62,23,26,Korper,0.03871748336358137,0.6505584192439863,,,287,1526
303,303,5,1,23,2,5,2,289,1503,119,18,92,reflektiere,0.05270719903206292,0.6494845360824743,,,408,1521
304,304,5,1,23,2,5,3,418,1503,205,23,91,elektromagnetische,0.07872050816696914,0.6505584192439863,,,623,1526
305,305,5,1,23,2,5,4,632,1503,72,18,92,Wellen,0.10102843315184513,0.6494845360824743,,,704,1521
306,306,5,1,23,2,5,5,714,1508,23,13,92,zu,0.10972474289171204,0.6505584192439863,,,737,1521
307,307,5,1,23,2,5,6,748,1503,59,18,92,erfas-,0.1175892316999395,0.6494845360824743,,,807,1521
308,308,4,1,23,2,6,0,225,1536,583,23,-1,,0.07811554748941318,0.664733676975945,,,808,1559
309,309,5,1,23,2,6,1,225,1540,42,17,93,"sen,",0.03720508166969147,0.6651632302405498,,,267,1557
310,310,5,1,23,2,6,2,274,1536,56,18,92,wobei,0.045674531155474894,0.663659793814433,,,330,1554
311,311,5,1,23,2,6,3,333,1536,39,18,96,die,0.053312159709618875,0.663659793814433,,,372,1554
312,312,5,1,23,2,6,4,378,1536,52,18,91,erste,0.06110102843315184,0.663659793814433,,,430,1554
313,313,5,1,23,2,6,5,436,1536,188,23,91,Sensoranordnung,0.08015728977616456,0.664733676975945,,,624,1559
314,314,5,1,23,2,6,6,630,1536,50,18,93,dazu,0.09906231094978826,0.663659793814433,,,680,1554
315,315,5,1,23,2,6,7,687,1536,121,23,92,ausgebildet,0.11305202661826981,0.664733676975945,,,808,1559
316,316,4,1,23,2,7,0,226,1569,581,23,-1,,0.07811554748941318,0.6789089347079038,,,807,1592
317,317,5,1,23,2,7,1,226,1569,26,22,95,"ist,",0.03614640048396854,0.6786941580756014,,,252,1591
318,318,5,1,23,2,7,2,261,1569,33,18,96,auf,0.04196914700544464,0.6778350515463918,,,294,1587
319,319,5,1,23,2,7,3,299,1569,34,18,96,der,0.04779189352692075,0.6778350515463918,,,333,1587
320,320,5,1,23,2,7,4,341,1569,48,18,96,Haut,0.05520266182698125,0.6778350515463918,,,389,1587
321,321,5,1,23,2,7,5,395,1569,37,18,93,des,0.06253781004234725,0.6778350515463918,,,432,1587
322,322,5,1,23,2,7,6,440,1569,81,23,47,Korpers,0.07267090139140955,0.6789089347079038,,,521,1592
323,323,5,1,23,2,7,7,528,1569,120,23,91,angeordnet,0.08892921960072596,0.6789089347079038,,,648,1592
324,324,5,1,23,2,7,8,654,1574,23,13,95,zu,0.10065033272837265,0.6789089347079038,,,677,1587
325,325,5,1,23,2,7,9,684,1569,77,18,96,werden,0.10927102238354507,0.6778350515463918,,,761,1587
326,326,5,1,23,2,7,10,770,1569,37,18,96,und,0.11925287356321838,0.6778350515463918,,,807,1587
327,327,4,1,23,2,8,0,224,1602,583,23,-1,,0.0779643073200242,0.6930841924398625,,,807,1625
328,328,5,1,23,2,8,1,224,1602,56,18,92,wobei,0.038112522686025406,0.6920103092783505,,,280,1620
329,329,5,1,23,2,8,2,283,1602,41,18,96,die,0.04590139140955838,0.6920103092783505,,,324,1620
330,330,5,1,23,2,8,3,332,1602,52,18,92,erste,0.05414398064125832,0.6920103092783505,,,384,1620
331,331,5,1,23,2,8,4,392,1602,188,23,91,Sensoranordnung,0.073502722323049,0.6930841924398625,,,580,1625
332,332,5,1,23,2,8,5,588,1602,101,18,92,zumindest,0.09656684815486993,0.6920103092783505,,,689,1620
333,333,5,1,23,2,8,6,690,1602,57,18,97,eine,0.10866606170598911,0.6920103092783505,,,747,1620
334,334,5,1,23,2,8,7,756,1602,51,18,96,erste,0.11819419237749547,0.6920103092783505,,,807,1620
335,335,2,1,24,0,0,0,505,1678,38,17,-1,,0.07924984875983061,0.7244415807560137,,,543,1695
336,336,3,1,24,1,0,0,505,1678,38,17,-1,,0.07924984875983061,0.7244415807560137,,,543,1695
337,337,4,1,24,1,1,0,505,1678,38,17,-1,,0.07924984875983061,0.7244415807560137,,,543,1695
338,338,5,1,24,1,1,1,505,1678,38,17,66,Fig.1,0.07924984875983061,0.7244415807560137,,,543,1695
339,339,2,1,25,0,0,0,680,1724,141,16,-1,,0.11350574712643678,0.7439862542955327,,,821,1740
340,340,3,1,25,1,0,0,680,1724,141,16,-1,,0.11350574712643678,0.7439862542955327,,,821,1740
341,341,4,1,25,1,1,0,680,1724,141,16,-1,,0.11350574712643678,0.7439862542955327,,,821,1740
342,342,5,1,25,1,1,1,680,1724,27,13,96,122,0.10488505747126436,0.7433419243986255,,,707,1737
343,343,5,1,25,1,1,2,795,1727,26,13,96,120,0.12220205686630368,0.7446305841924399,,,821,1740
344,344,2,1,26,0,0,0,608,1737,587,129,-1,,0.13634301270417423,0.773840206185567,,,1195,1866
345,345,3,1,26,1,0,0,608,1737,587,129,-1,,0.13634301270417423,0.773840206185567,,,1195,1866
346,346,4,1,26,1,1,0,608,1737,587,19,-1,,0.13634301270417423,0.7502147766323024,,,1195,1756
347,347,5,1,26,1,1,1,608,1737,587,19,95, ,0.13634301270417423,0.7502147766323024,,,1195,1756
348,348,4,1,26,1,2,0,825,1756,370,14,-1,,0.15275257108287962,0.7573024054982818,,,1195,1770
349,349,5,1,26,1,2,1,825,1756,370,14,95, ,0.15275257108287962,0.7573024054982818,,,1195,1770
350,350,4,1,26,1,3,0,942,1770,253,25,-1,,0.1616001209921355,0.7656786941580757,,,1195,1795
351,351,5,1,26,1,3,1,942,1770,253,25,95,  ,0.1616001209921355,0.7656786941580757,,,1195,1795
352,352,4,1,26,1,4,0,951,1795,141,9,-1,,0.15449183303085298,0.7729810996563574,,,1092,1804
353,353,5,1,26,1,4,1,951,1795,141,9,95, ,0.15449183303085298,0.7729810996563574,,,1092,1804
354,354,4,1,26,1,5,0,951,1804,141,17,-1,,0.15449183303085298,0.7785652920962199,,,1092,1821
355,355,5,1,26,1,5,1,951,1804,141,17,95,  ,0.15449183303085298,0.7785652920962199,,,1092,1821
356,356,4,1,26,1,6,0,951,1821,141,11,-1,,0.15449183303085298,0.7845790378006873,,,1092,1832
357,357,5,1,26,1,6,1,951,1821,141,11,95,  ,0.15449183303085298,0.7845790378006873,,,1092,1832
358,358,4,1,26,1,7,0,951,1832,140,12,-1,,0.1544162129461585,0.7895189003436426,,,1091,1844
359,359,5,1,26,1,7,1,951,1832,140,12,95,  ,0.1544162129461585,0.7895189003436426,,,1091,1844
360,360,4,1,26,1,8,0,929,1844,162,11,-1,,0.15275257108287962,0.7944587628865979,,,1091,1855
361,361,5,1,26,1,8,1,929,1844,162,11,95, ,0.15275257108287962,0.7944587628865979,,,1091,1855
362,362,4,1,26,1,9,0,807,1855,305,11,-1,,0.14511494252873564,0.7991838487972509,,,1112,1866
363,363,5,1,26,1,9,1,807,1855,305,11,95, ,0.14511494252873564,0.7991838487972509,,,1112,1866
364,364,2,1,27,0,0,0,608,1756,137,76,-1,,0.10231397459165155,0.770618556701031,,,745,1832
365,365,3,1,27,1,0,0,608,1756,137,76,-1,,0.10231397459165155,0.770618556701031,,,745,1832
366,366,4,1,27,1,1,0,608,1756,137,23,-1,,0.10231397459165155,0.7592353951890034,,,745,1779
367,367,5,1,27,1,1,1,608,1756,137,23,95, ,0.10231397459165155,0.7592353951890034,,,745,1779
368,368,4,1,27,1,2,0,608,1779,130,16,-1,,0.10178463399879008,0.7676116838487973,,,738,1795
369,369,5,1,27,1,2,1,608,1779,130,16,95,   ,0.10178463399879008,0.7676116838487973,,,738,1795
370,370,4,1,27,1,3,0,713,1795,25,26,-1,,0.10972474289171204,0.7766323024054983,,,738,1821
371,371,5,1,27,1,3,1,713,1795,25,26,95,   ,0.10972474289171204,0.7766323024054983,,,738,1821
372,372,4,1,27,1,4,0,713,1821,25,11,-1,,0.10972474289171204,0.7845790378006873,,,738,1832
373,373,5,1,27,1,4,1,713,1821,25,11,95,  ,0.10972474289171204,0.7845790378006873,,,738,1832
374,374,2,1,28,0,0,0,489,1795,273,71,-1,,0.09460072595281306,0.7862972508591065,,,762,1866
375,375,3,1,28,1,0,0,489,1795,273,71,-1,,0.09460072595281306,0.7862972508591065,,,762,1866
376,376,4,1,28,1,1,0,607,1795,12,26,-1,,0.09271022383545069,0.7766323024054983,,,619,1821
377,377,5,1,28,1,1,1,607,1795,12,26,95,  ,0.09271022383545069,0.7766323024054983,,,619,1821
378,378,4,1,28,1,2,0,490,1821,248,20,-1,,0.09286146400483969,0.7865120274914089,,,738,1841
379,379,5,1,28,1,2,1,490,1821,248,20,95,  ,0.09286146400483969,0.7865120274914089,,,738,1841
380,380,4,1,28,1,3,0,489,1841,265,14,-1,,0.0939957652752571,0.7938144329896907,,,754,1855
381,381,5,1,28,1,3,1,489,1841,265,14,95,  ,0.0939957652752571,0.7938144329896907,,,754,1855
382,382,4,1,28,1,4,0,489,1855,273,11,-1,,0.09460072595281306,0.7991838487972509,,,762,1866
383,383,5,1,28,1,4,1,489,1855,273,11,95, ,0.09460072595281306,0.7991838487972509,,,762,1866
384,384,2,1,29,0,0,0,825,1770,41,9,-1,,0.1278735632183908,0.7622422680412371,,,866,1779
385,385,3,1,29,1,0,0,825,1770,41,9,-1,,0.1278735632183908,0.7622422680412371,,,866,1779
386,386,4,1,29,1,1,0,825,1770,41,9,-1,,0.1278735632183908,0.7622422680412371,,,866,1779
387,387,5,1,29,1,1,1,825,1770,41,9,95, ,0.1278735632183908,0.7622422680412371,,,866,1779
388,388,2,1,30,0,0,0,832,1844,46,11,-1,,0.12931034482758622,0.7944587628865979,,,878,1855
389,389,3,1,30,1,0,0,832,1844,46,11,-1,,0.12931034482758622,0.7944587628865979,,,878,1855
390,390,4,1,30,1,1,0,832,1844,46,11,-1,,0.12931034482758622,0.7944587628865979,,,878,1855
391,391,5,1,30,1,1,1,832,1844,46,11,95, ,0.12931034482758622,0.7944587628865979,,,878,1855
392,392,2,1,31,0,0,0,883,1241,585,351,-1,,0.17778281911675742,0.6084621993127147,,,1468,1592
393,393,3,1,31,1,0,0,885,1241,582,56,-1,,0.17785843920145192,0.5451030927835051,,,1467,1297
394,394,4,1,31,1,1,0,885,1241,582,23,-1,,0.17785843920145192,0.5380154639175257,,,1467,1264
395,395,5,1,31,1,1,1,885,1241,117,23,24,Messgr6fe,0.1426950998185118,0.5380154639175257,,,1002,1264
396,396,5,1,31,1,1,2,1009,1241,81,23,90,"ausgibt,",0.1587265577737447,0.5380154639175257,,,1090,1264
397,397,5,1,31,1,1,3,1099,1241,30,18,96,die,0.16848154869933454,0.5369415807560137,,,1129,1259
398,398,5,1,31,1,1,4,1137,1241,32,18,96,auf,0.17437991530550515,0.5369415807560137,,,1169,1259
399,399,5,1,31,1,1,5,1175,1241,35,18,92,der,0.18035390199637025,0.5369415807560137,,,1210,1259
400,400,5,1,31,1,1,6,1216,1241,149,18,85,transmittierten,0.19517543859649122,0.5369415807560137,,,1365,1259
401,401,5,1,31,1,1,7,1374,1241,93,18,93,und/oder,0.2148366606170599,0.5369415807560137,,,1467,1259
402,402,4,1,31,1,2,0,885,1274,509,23,-1,,0.1723381730187538,0.5521907216494846,,,1394,1297
403,403,5,1,31,1,2,1,885,1274,121,18,84,reflektierten,0.14299758015728978,0.5511168384879725,,,1006,1292
404,404,5,1,31,1,2,2,1016,1274,217,23,87,elektromagnetischen,0.17006957047791893,0.5521907216494846,,,1233,1297
405,405,5,1,31,1,2,3,1242,1274,71,18,92,Wellen,0.19320931639443437,0.5511168384879725,,,1313,1292
406,406,5,1,31,1,2,4,1323,1274,71,21,92,beruht;,0.20545977011494254,0.5517611683848798,,,1394,1295
407,407,3,1,31,2,0,0,884,1306,582,122,-1,,0.17770719903206292,0.5871993127147767,,,1466,1428
408,408,4,1,31,2,1,0,884,1306,581,23,-1,,0.17763157894736842,0.5659364261168385,,,1465,1329
409,409,5,1,31,2,1,1,884,1317,7,2,93,-,0.13422565033272837,0.5661512027491409,,,891,1319
410,410,5,1,31,2,1,2,897,1306,43,19,91,eine,0.13891409558378706,0.5650773195876289,,,940,1325
411,411,5,1,31,2,1,3,945,1306,67,19,90,zweite,0.14798850574712644,0.5650773195876289,,,1012,1325
412,412,5,1,31,2,1,4,1018,1306,187,23,92,"Sensoranordnung,",0.16810344827586207,0.5659364261168385,,,1205,1329
413,413,5,1,31,2,1,5,1209,1306,40,22,97,die,0.18587416817906835,0.5657216494845361,,,1249,1328
414,414,5,1,31,2,1,6,1255,1306,49,19,93,dazu,0.19351179673321234,0.5650773195876289,,,1304,1325
415,415,5,1,31,2,1,7,1311,1306,114,23,90,ausgebildet,0.20689655172413793,0.5659364261168385,,,1425,1329
416,416,5,1,31,2,1,8,1426,1306,39,22,96,"ist,",0.21861766485178463,0.5657216494845361,,,1465,1328
417,417,4,1,31,2,2,0,884,1339,582,23,-1,,0.17770719903206292,0.5801116838487973,,,1466,1362
418,418,5,1,31,2,2,1,884,1339,101,18,91,zumindest,0.1413339382940109,0.5790378006872853,,,985,1357
419,419,5,1,31,2,2,2,986,1339,55,18,92,eine,0.15328191167574107,0.5790378006872853,,,1041,1357
420,420,5,1,31,2,2,3,1048,1339,66,18,92,zweite,0.16349062310949788,0.5790378006872853,,,1114,1357
421,421,5,1,31,2,2,4,1122,1339,139,23,92,physikalische,0.18020266182698125,0.5801116838487973,,,1261,1362
422,422,5,1,31,2,2,5,1268,1339,66,18,42,Grd√©Be,0.1967634603750756,0.5790378006872853,,,1334,1357
423,423,5,1,31,2,2,6,1341,1339,36,18,93,des,0.205535390199637,0.5790378006872853,,,1377,1357
424,424,5,1,31,2,2,7,1385,1339,81,23,43,Korpers,0.21559286146400483,0.5801116838487973,,,1466,1362
425,425,4,1,31,2,3,0,884,1372,582,23,-1,,0.17770719903206292,0.594286941580756,,,1466,1395
426,426,5,1,31,2,3,1,884,1377,23,14,80,zu,0.1354355716878403,0.5945017182130584,,,907,1391
427,427,5,1,31,2,3,2,915,1377,68,14,89,messen,0.14352692075015125,0.5945017182130584,,,983,1391
428,428,5,1,31,2,3,3,985,1372,55,19,95,und,0.1531306715063521,0.5934278350515464,,,1040,1391
429,429,5,1,31,2,3,4,1048,1372,43,19,93,eine,0.1617513611615245,0.5934278350515464,,,1091,1391
430,430,5,1,31,2,3,5,1097,1372,66,19,92,zweite,0.17090139140955837,0.5934278350515464,,,1163,1391
431,431,5,1,31,2,3,6,1171,1372,116,23,0,Messgr√©Re,0.18587416817906835,0.594286941580756,,,1287,1395
432,432,5,1,31,2,3,7,1294,1372,128,23,91,"auszugeben,",0.20538415003024804,0.594286941580756,,,1422,1395
433,433,5,1,31,2,3,8,1425,1372,41,22,96,die,0.21861766485178463,0.5940721649484536,,,1466,1394
434,434,4,1,31,2,4,0,884,1405,523,23,-1,,0.17324561403508773,0.6084621993127147,,,1407,1428
435,435,5,1,31,2,4,1,884,1405,33,18,96,auf,0.13619177253478523,0.6073883161512027,,,917,1423
436,436,5,1,31,2,4,2,924,1405,34,18,93,der,0.14231699939503933,0.6073883161512027,,,958,1423
437,437,5,1,31,2,4,3,965,1405,79,18,91,zweiten,0.15192075015124018,0.6073883161512027,,,1044,1423
438,438,5,1,31,2,4,4,1054,1405,152,23,92,physikalischen,0.17090139140955837,0.6084621993127147,,,1206,1428
439,439,5,1,31,2,4,5,1215,1405,65,18,12,Gr√©Re,0.18867211131276468,0.6073883161512027,,,1280,1423
440,440,5,1,31,2,4,6,1290,1405,71,22,92,beruht;,0.20046884452510585,0.6082474226804123,,,1361,1427
441,441,5,1,31,2,4,7,1371,1405,36,18,96,und,0.21007259528130673,0.6073883161512027,,,1407,1423
442,442,3,1,31,3,0,0,883,1438,585,154,-1,,0.17778281911675742,0.6507731958762887,,,1468,1592
443,443,4,1,31,3,1,0,884,1438,584,23,-1,,0.17785843920145192,0.6226374570446735,,,1468,1461
444,444,5,1,31,3,1,1,884,1448,7,3,93,-,0.13422565033272837,0.6226374570446735,,,891,1451
445,445,5,1,31,3,1,2,897,1438,44,18,93,eine,0.13898971566848156,0.6215635738831615,,,941,1456
446,446,5,1,31,3,1,3,947,1438,221,23,92,"Auswerteeinrichtung,",0.1599364791288566,0.6226374570446735,,,1168,1461
447,447,5,1,31,3,1,4,1176,1438,30,18,96,die,0.18012704174228675,0.6215635738831615,,,1206,1456
448,448,5,1,31,3,1,5,1214,1438,49,18,93,dazu,0.18731094978826376,0.6215635738831615,,,1263,1456
449,449,5,1,31,3,1,6,1271,1438,114,23,91,ausgebildet,0.20084694494857835,0.6226374570446735,,,1385,1461
450,450,5,1,31,3,1,7,1386,1438,40,21,96,"ist,",0.21264367816091953,0.6222079037800687,,,1426,1459
451,451,5,1,31,3,1,8,1435,1438,33,18,96,auf,0.21952510586811858,0.6215635738831615,,,1468,1456
452,452,4,1,31,3,2,0,885,1470,581,23,-1,,0.17778281911675742,0.6363831615120275,,,1466,1493
453,453,5,1,31,3,2,1,885,1470,109,23,92,Grundlage,0.14209013914095583,0.6363831615120275,,,994,1493
454,454,5,1,31,3,2,2,999,1470,26,19,96,der,0.1530550514216576,0.6355240549828178,,,1025,1489
455,455,5,1,31,3,2,3,1027,1471,76,18,93,ersten,0.16107078039927405,0.6357388316151202,,,1103,1489
456,456,5,1,31,3,2,4,1111,1470,116,23,32,Messgr√©fe,0.17679975801572897,0.6363831615120275,,,1227,1493
457,457,5,1,31,3,2,5,1235,1470,36,19,96,und,0.18950393224440412,0.6355240549828178,,,1271,1489
458,458,5,1,31,3,2,6,1278,1470,34,19,93,der,0.1958560193587417,0.6355240549828178,,,1312,1489
459,459,5,1,31,3,2,7,1317,1470,79,19,91,zweiten,0.20515728977616454,0.6355240549828178,,,1396,1489
460,460,5,1,31,3,2,8,1404,1470,62,19,91,Mess-,0.21702964307320025,0.6355240549828178,,,1466,1489
461,461,4,1,31,3,3,0,884,1503,581,23,-1,,0.17763157894736842,0.6505584192439863,,,1465,1526
462,462,5,1,31,3,3,1,884,1503,61,23,30,gr√©Re,0.1383091349062311,0.6505584192439863,,,945,1526
463,463,5,1,31,3,3,2,952,1503,38,18,93,den,0.14685420447670902,0.6494845360824743,,,990,1521
464,464,5,1,31,3,3,3,1000,1503,194,23,92,Hydrationszustand,0.16591046581972171,0.6505584192439863,,,1194,1526
465,465,5,1,31,3,3,4,1203,1503,37,18,93,des,0.18473986690865093,0.6494845360824743,,,1240,1521
466,466,5,1,31,3,3,5,1248,1503,82,23,16,Korpers,0.19494857834240775,0.6505584192439863,,,1330,1526
467,467,5,1,31,3,3,6,1337,1508,24,13,93,zu,0.20402298850574713,0.6505584192439863,,,1361,1521
468,468,5,1,31,3,3,7,1369,1503,96,18,89,ermitteln.,0.21430732002419842,0.6494845360824743,,,1465,1521
469,469,4,1,31,3,4,0,885,1536,581,23,-1,,0.17778281911675742,0.664733676975945,,,1466,1559
470,470,5,1,31,3,4,1,885,1536,33,18,93,Die,0.13634301270417423,0.663659793814433,,,918,1554
471,471,5,1,31,3,4,2,930,1536,99,23,92,Erfindung,0.14813974591651544,0.664733676975945,,,1029,1559
472,472,5,1,31,3,4,3,1040,1536,93,18,91,offenbart,0.16432244404113733,0.663659793814433,,,1133,1554
473,473,5,1,31,3,4,4,1143,1536,49,18,96,auch,0.1765728977616455,0.663659793814433,,,1192,1554
474,474,5,1,31,3,4,5,1203,1536,30,18,92,ein,0.18421052631578946,0.663659793814433,,,1233,1554
475,475,5,1,31,3,4,6,1244,1536,168,23,91,entsprechendes,0.20084694494857835,0.664733676975945,,,1412,1559
476,476,5,1,31,3,4,7,1422,1536,44,18,92,Ver-,0.21839080459770116,0.663659793814433,,,1466,1554
477,477,4,1,31,3,5,0,883,1569,525,23,-1,,0.17324561403508773,0.6789089347079038,,,1408,1592
478,478,5,1,31,3,5,1,883,1569,66,18,95,fahren,0.1385359951603146,0.6778350515463918,,,949,1587
479,479,5,1,31,3,5,2,958,1574,43,13,93,zum,0.14813974591651544,0.6789089347079038,,,1001,1587
480,480,5,1,31,3,5,3,1010,1569,117,18,92,Bestimmen,0.1616001209921355,0.6778350515463918,,,1127,1587
481,481,5,1,31,3,5,4,1136,1569,37,18,93,des,0.17460677555958862,0.6778350515463918,,,1173,1587
482,482,5,1,31,3,5,5,1182,1569,226,23,92,Hydrationszustandes.,0.1958560193587417,0.6789089347079038,,,1408,1592
483,483,2,1,32,0,0,0,1156,1679,27,13,-1,,0.17687537810042347,0.7240120274914089,,,1183,1692
484,484,3,1,32,1,0,0,1156,1679,27,13,-1,,0.17687537810042347,0.7240120274914089,,,1183,1692
485,485,4,1,32,1,1,0,1156,1679,27,13,-1,,0.17687537810042347,0.7240120274914089,,,1183,1692
486,486,5,1,32,1,1,1,1156,1679,27,13,80,4100,0.17687537810042347,0.7240120274914089,,,1183,1692
487,487,2,1,33,0,0,0,914,1728,260,13,-1,,0.15789473684210525,0.7450601374570447,,,1174,1741
488,488,3,1,33,1,0,0,914,1728,260,13,-1,,0.15789473684210525,0.7450601374570447,,,1174,1741
489,489,4,1,33,1,1,0,914,1728,260,13,-1,,0.15789473684210525,0.7450601374570447,,,1174,1741
490,490,5,1,33,1,1,1,914,1728,26,13,91,118,0.14019963702359348,0.7450601374570447,,,940,1741
491,491,5,1,33,1,1,2,1029,1729,26,12,84,116,0.15759225650332728,0.7452749140893471,,,1055,1741
492,492,5,1,33,1,1,3,1147,1729,27,12,96,104,0.17551421657592256,0.7452749140893471,,,1174,1741
493,493,2,1,34,0,0,0,612,1862,581,6,-1,,0.13649425287356323,0.8011168384879725,,,1193,1868
494,494,3,1,34,1,0,0,612,1862,581,6,-1,,0.13649425287356323,0.8011168384879725,,,1193,1868
495,495,4,1,34,1,1,0,612,1862,581,6,-1,,0.13649425287356323,0.8011168384879725,,,1193,1868
496,496,5,1,34,1,1,1,612,1862,581,6,95, ,0.13649425287356323,0.8011168384879725,,,1193,1868
497,497,2,1,35,0,0,0,763,1946,429,5,-1,,0.14783726557773744,0.8369845360824743,,,1192,1951
498,498,3,1,35,1,0,0,763,1946,429,5,-1,,0.14783726557773744,0.8369845360824743,,,1192,1951
499,499,4,1,35,1,1,0,763,1946,429,5,-1,,0.14783726557773744,0.8369845360824743,,,1192,1951
500,500,5,1,35,1,1,1,763,1946,429,5,95, ,0.14783726557773744,0.8369845360824743,,,1192,1951
501,501,2,1,36,0,0,0,489,1866,623,136,-1,,0.12106775559588627,0.8307560137457045,,,1112,2002
502,502,3,1,36,1,0,0,489,1866,623,136,-1,,0.12106775559588627,0.8307560137457045,,,1112,2002
503,503,4,1,36,1,1,0,489,1866,623,136,-1,,0.12106775559588627,0.8307560137457045,,,1112,2002
504,504,5,1,36,1,1,1,489,1866,623,136,95,      ,0.12106775559588627,0.8307560137457045,,,1112,2002
505,505,2,1,37,0,0,0,489,1974,265,47,-1,,0.0939957652752571,0.8580326460481099,,,754,2021
506,506,3,1,37,1,0,0,489,1974,265,47,-1,,0.0939957652752571,0.8580326460481099,,,754,2021
507,507,4,1,37,1,1,0,489,1974,265,30,-1,,0.0939957652752571,0.854381443298969,,,754,2004
508,508,5,1,37,1,1,1,489,1974,138,30,95,  ,0.08439201451905626,0.854381443298969,,,627,2004
509,509,5,1,37,1,1,2,703,1976,51,28,95,    ,0.11017846339987901,0.8548109965635738,,,754,2004
510,510,4,1,37,1,2,0,606,2004,118,17,-1,,0.10057471264367816,0.8644759450171822,,,724,2021
511,511,5,1,37,1,2,1,606,2004,118,17,95,  ,0.10057471264367816,0.8644759450171822,,,724,2021
512,512,2,1,38,0,0,0,835,1840,3,212,-1,,0.1265124016938899,0.8359106529209622,,,838,2052
513,513,3,1,38,1,0,0,835,1840,3,212,-1,,0.1265124016938899,0.8359106529209622,,,838,2052
514,514,4,1,38,1,1,0,835,1840,3,212,-1,,0.1265124016938899,0.8359106529209622,,,838,2052
515,515,5,1,38,1,1,1,835,1840,3,212,95, ,0.1265124016938899,0.8359106529209622,,,838,2052
516,516,2,1,39,0,0,0,606,2002,471,54,-1,,0.12726860254083486,0.8715635738831615,,,1077,2056
517,517,3,1,39,1,0,0,606,2002,471,54,-1,,0.12726860254083486,0.8715635738831615,,,1077,2056
518,518,4,1,39,1,1,0,606,2002,471,20,-1,,0.12726860254083486,0.8642611683848798,,,1077,2022
519,519,5,1,39,1,1,1,606,2021,117,1,95, ,0.10049909255898366,0.8683419243986255,,,723,2022
520,520,5,1,39,1,1,2,1066,2002,11,20,95,   ,0.16205384150030247,0.8642611683848798,,,1077,2022
521,521,4,1,39,1,2,0,606,2022,470,7,-1,,0.12719298245614036,0.8700601374570447,,,1076,2029
522,522,5,1,39,1,2,1,606,2022,381,7,95, ,0.12046279491833031,0.8700601374570447,,,987,2029
523,523,5,1,39,1,2,2,1048,2022,28,7,95, ,0.16061705989110708,0.8700601374570447,,,1076,2029
524,524,4,1,39,1,3,0,606,2029,470,14,-1,,0.12719298245614036,0.8745704467353952,,,1076,2043
525,525,5,1,39,1,3,1,606,2029,470,14,95, ,0.12719298245614036,0.8745704467353952,,,1076,2043
526,526,4,1,39,1,4,0,606,2043,470,13,-1,,0.12719298245614036,0.8803694158075601,,,1076,2056
527,527,5,1,39,1,4,1,606,2043,470,13,95,  ,0.12719298245614036,0.8803694158075601,,,1076,2056
528,528,2,1,40,0,0,0,964,1760,4,293,-1,,0.14609800362976408,0.8189432989690721,,,968,2053
529,529,3,1,40,1,0,0,964,1760,4,293,-1,,0.14609800362976408,0.8189432989690721,,,968,2053
530,530,4,1,40,1,1,0,964,1760,4,293,-1,,0.14609800362976408,0.8189432989690721,,,968,2053
531,531,5,1,40,1,1,1,964,1760,4,293,95, ,0.14609800362976408,0.8189432989690721,,,968,2053
532,532,2,1,41,0,0,0,623,1764,556,308,-1,,0.13626739261947973,0.8238831615120275,,,1179,2072
533,533,3,1,41,1,0,0,745,1764,80,15,-1,,0.11872353297035693,0.7609536082474226,,,825,1779
534,534,4,1,41,1,1,0,745,1764,80,15,-1,,0.11872353297035693,0.7609536082474226,,,825,1779
535,535,5,1,41,1,1,1,745,1764,12,13,18,Gy,0.11358136721113128,0.7605240549828178,,,757,1777
536,536,5,1,41,1,1,2,823,1775,2,4,0,.,0.12462189957652753,0.7633161512027491,,,825,1779
537,537,3,1,41,2,0,0,623,1795,538,27,-1,,0.13490623109497882,0.7768470790378007,,,1161,1822
538,538,4,1,41,2,1,0,623,1795,538,27,-1,,0.13490623109497882,0.7768470790378007,,,1161,1822
539,539,5,1,41,2,1,1,623,1795,85,16,78,Temperatur,0.10065033272837265,0.7744845360824743,,,708,1811
540,540,5,1,41,2,1,2,759,1809,51,13,70,‚Äògungs-,0.11864791288566243,0.7798539518900344,,,810,1822
541,541,5,1,41,2,1,3,876,1797,54,16,89,"tigkeit-,",0.1365698729582577,0.7753436426116839,,,930,1813
542,542,5,1,41,2,1,4,1117,1799,44,12,80,Akku-,0.1722625529340593,0.7753436426116839,,,1161,1811
543,543,3,1,41,3,0,0,641,1817,527,33,-1,,0.1367967332123412,0.7875859106529209,,,1168,1850
544,544,4,1,41,3,1,0,641,1817,527,33,-1,,0.1367967332123412,0.7875859106529209,,,1168,1850
545,545,5,1,41,3,1,1,641,1819,50,9,96,sensor,0.10072595281306715,0.7832903780068728,,,691,1828
546,546,5,1,41,3,1,2,757,1829,56,10,69,sensor-,0.11872353297035693,0.7878006872852233,,,813,1839
547,547,5,1,41,3,1,3,861,1817,86,33,49,Temperatur,0.1367211131276467,0.7875859106529209,,,947,1850
548,548,5,1,41,3,1,4,1110,1819,58,13,60,mutator,0.1722625529340593,0.7841494845360825,,,1168,1832
549,549,3,1,41,4,0,0,627,1847,552,225,-1,,0.1365698729582577,0.8417096219931272,,,1179,2072
550,550,4,1,41,4,1,0,762,1847,45,13,-1,,0.11864791288566243,0.7961769759450171,,,807,1860
551,551,5,1,41,4,1,1,762,1847,45,13,53,modul,0.11864791288566243,0.7961769759450171,,,807,1860
552,552,4,1,41,4,2,0,627,1981,532,17,-1,,0.13505747126436782,0.8545962199312714,,,1159,1998
553,553,5,1,41,4,2,1,627,1981,76,14,41,Bluetooth-,0.10057471264367816,0.8539518900343642,,,703,1995
554,554,5,1,41,4,2,2,754,1982,61,13,88,Hautleit-,0.11864791288566243,0.8541666666666666,,,815,1995
555,555,5,1,41,4,2,3,980,1983,77,14,92,Sensoran-,0.15403811252268604,0.8548109965635738,,,1057,1997
556,556,5,1,41,4,2,4,1116,1985,43,13,91,Lade-,0.1720356926799758,0.8554553264604811,,,1159,1998
557,557,4,1,41,4,3,0,861,1993,10,12,-1,,0.1309739866908651,0.8586769759450171,,,871,2005
558,558,5,1,41,4,3,1,861,1993,10,12,37,Pe,0.1309739866908651,0.8586769759450171,,,871,2005
559,559,4,1,41,4,4,0,643,1993,536,29,-1,,0.13777979431336962,0.8623281786941581,,,1179,2022
560,560,5,1,41,4,4,1,643,2003,44,12,32,modu,0.10057471264367816,0.8629725085910653,,,687,2015
561,561,5,1,41,4,4,2,742,2004,83,12,90,wertsensor,0.11849667271627344,0.8634020618556701,,,825,2016
562,562,5,1,41,4,4,3,0,0,1653,2328,92,|,0.125,0.5,,,1653,2328
563,563,5,1,41,4,4,4,0,0,1653,2328,88,|,0.125,0.5,,,1653,2328
564,564,5,1,41,4,4,5,872,1993,73,13,69,Pulssensor,0.13740169388989715,0.8588917525773195,,,945,2006
565,565,5,1,41,4,4,6,0,0,1653,2328,80,|),0.125,0.5,,,1653,2328
566,566,5,1,41,4,4,7,987,2005,61,16,0,‚Äúcranung,0.15388687235329704,0.8646907216494846,,,1048,2021
567,567,5,1,41,4,4,8,0,0,1653,2328,53,|,0.125,0.5,,,1653,2328
568,568,5,1,41,4,4,9,0,0,1653,2328,92,|,0.125,0.5,,,1653,2328
569,569,5,1,41,4,4,10,1095,2005,84,17,90,einrichtung,0.17196007259528132,0.864905498281787,,,1179,2022
570,570,4,1,41,4,5,0,886,2052,257,20,-1,,0.15343315184513007,0.8857388316151202,,,1143,2072
571,571,5,1,41,4,5,1,886,2052,18,18,20,rv,0.1353599516031458,0.8853092783505154,,,904,2070
572,572,5,1,41,4,5,2,1001,2053,17,18,25,v7,0.15267695099818512,0.8857388316151202,,,1018,2071
573,573,5,1,41,4,5,3,1125,2054,18,18,24,7,0.17150635208711434,0.886168384879725,,,1143,2072
574,574,2,1,42,0,0,0,1189,1817,4,237,-1,,0.18012704174228675,0.8314003436426117,,,1193,2054
575,575,3,1,42,1,0,0,1189,1817,4,237,-1,,0.18012704174228675,0.8314003436426117,,,1193,2054
576,576,4,1,42,1,1,0,1189,1817,4,237,-1,,0.18012704174228675,0.8314003436426117,,,1193,2054
577,577,5,1,42,1,1,1,1189,1817,4,237,95, ,0.18012704174228675,0.8314003436426117,,,1193,2054
578,578,2,1,43,0,0,0,613,2048,578,6,-1,,0.13641863278886873,0.8810137457044673,,,1191,2054
579,579,3,1,43,1,0,0,613,2048,578,6,-1,,0.13641863278886873,0.8810137457044673,,,1191,2054
580,580,4,1,43,1,1,0,613,2048,578,6,-1,,0.13641863278886873,0.8810137457044673,,,1191,2054
581,581,5,1,43,1,1,1,613,2048,578,6,95, ,0.13641863278886873,0.8810137457044673,,,1191,2054
582,582,2,1,44,0,0,0,642,2077,142,13,-1,,0.10783424077434967,0.8949742268041238,,,784,2090
583,583,3,1,44,1,0,0,642,2077,142,13,-1,,0.10783424077434967,0.8949742268041238,,,784,2090
584,584,4,1,44,1,1,0,642,2077,142,13,-1,,0.10783424077434967,0.8949742268041238,,,784,2090
585,585,5,1,44,1,1,1,642,2077,27,13,92,124,0.09913793103448276,0.8949742268041238,,,669,2090
586,586,5,1,44,1,1,2,758,2078,26,12,89,112,0.11660617059891107,0.8951890034364262,,,784,2090
587,587,2,1,45,0,0,0,876,2077,142,14,-1,,0.14322444041137325,0.8951890034364262,,,1018,2091
588,588,3,1,45,1,0,0,876,2077,142,14,-1,,0.14322444041137325,0.8951890034364262,,,1018,2091
589,589,4,1,45,1,1,0,876,2077,142,14,-1,,0.14322444041137325,0.8951890034364262,,,1018,2091
590,590,5,1,45,1,1,1,876,2077,26,13,41,"""14",0.13445251058681185,0.8949742268041238,,,902,2090
591,591,5,1,45,1,1,2,992,2078,26,13,92,110,0.15199637023593465,0.8954037800687286,,,1018,2091
592,592,2,1,46,0,0,0,1025,2049,17,76,-1,,0.15630671506352087,0.8964776632302406,,,1042,2125
593,593,3,1,46,1,0,0,1025,2049,17,76,-1,,0.15630671506352087,0.8964776632302406,,,1042,2125
594,594,4,1,46,1,1,0,1025,2049,17,76,-1,,0.15630671506352087,0.8964776632302406,,,1042,2125
595,595,5,1,46,1,1,1,1025,2049,17,76,95, ,0.15630671506352087,0.8964776632302406,,,1042,2125
596,596,2,1,47,0,0,0,960,2141,130,14,-1,,0.15502117362371445,0.9226804123711341,,,1090,2155
597,597,3,1,47,1,0,0,960,2141,130,14,-1,,0.15502117362371445,0.9226804123711341,,,1090,2155
598,598,4,1,47,1,1,0,960,2141,130,14,-1,,0.15502117362371445,0.9226804123711341,,,1090,2155
599,599,5,1,47,1,1,1,960,2141,34,13,96,Haut,0.14776164549304296,0.9224656357388317,,,994,2154
600,600,5,1,47,1,1,2,1000,2141,26,13,89,des,0.1532062915910466,0.9224656357388317,,,1026,2154
601,601,5,1,47,1,1,3,1033,2141,57,14,89,Nutzers,0.16054143980641258,0.9226804123711341,,,1090,2155
602,602,2,1,48,0,0,0,1004,2186,26,13,-1,,0.15381125226860254,0.9417955326460481,,,1030,2199
603,603,3,1,48,1,0,0,1004,2186,26,13,-1,,0.15381125226860254,0.9417955326460481,,,1030,2199
604,604,4,1,48,1,1,0,1004,2186,26,13,-1,,0.15381125226860254,0.9417955326460481,,,1030,2199
605,605,5,1,48,1,1,1,1004,2186,26,13,96,126,0.15381125226860254,0.9417955326460481,,,1030,2199
606,606,2,1,49,0,0,0,930,2125,188,45,-1,,0.15486993345432548,0.9224656357388317,,,1118,2170
607,607,3,1,49,1,0,0,930,2125,188,45,-1,,0.15486993345432548,0.9224656357388317,,,1118,2170
608,608,4,1,49,1,1,0,930,2125,188,45,-1,,0.15486993345432548,0.9224656357388317,,,1118,2170
609,609,5,1,49,1,1,1,930,2125,4,45,95, ,0.14095583787053842,0.9224656357388317,,,934,2170
610,610,5,1,49,1,1,2,1116,2125,2,45,95, ,0.16893526920750151,0.9224656357388317,,,1118,2170
611,611,2,1,50,0,0,0,716,2270,259,16,-1,,0.1278735632183908,0.9785223367697594,,,975,2286
612,612,3,1,50,1,0,0,716,2270,259,16,-1,,0.1278735632183908,0.9785223367697594,,,975,2286
613,613,4,1,50,1,1,0,716,2270,259,16,-1,,0.1278735632183908,0.9785223367697594,,,975,2286
614,614,5,1,50,1,1,1,716,2270,49,12,96,Printed,0.11199334543254688,0.9776632302405498,,,765,2282
615,615,5,1,50,1,1,2,771,2270,15,16,96,by,0.1177404718693285,0.9785223367697594,,,786,2286
616,616,5,1,50,1,1,3,792,2270,45,14,96,"Jouve,",0.12318511796733213,0.9780927835051546,,,837,2284
617,617,5,1,50,1,1,4,843,2270,41,12,96,75001,0.13059588626739263,0.9776632302405498,,,884,2282
618,618,5,1,50,1,1,5,893,2270,46,12,96,PARIS,0.1385359951603146,0.9776632302405498,,,939,2282
619,619,5,1,50,1,1,6,945,2270,30,16,95,(FR),0.14519056261343014,0.9785223367697594,,,975,2286
