,Unnamed: 0,level,page_num,block_num,par_num,line_num,word_num,left,top,width,height,conf,text,x,y,label,target,right,bottom
0,0,1,1,0,0,0,0,0,0,1653,2328,-1,,0.125,0.5,,,1653,2328
1,1,2,1,1,0,0,0,144,1905,31,328,-1,,0.02412280701754386,0.8887457044673539,,,175,2233
2,2,3,1,1,1,0,0,144,1905,31,328,-1,,0.02412280701754386,0.8887457044673539,,,175,2233
3,3,4,1,1,1,1,0,144,1905,31,328,-1,,0.02412280701754386,0.8887457044673539,,,175,2233
4,4,5,1,1,1,1,1,144,2179,30,54,96,EP,0.024047186932849365,0.947594501718213,,,174,2233
5,5,5,1,1,1,1,2,144,2142,31,21,96,3,0.02412280701754386,0.9246134020618557,,,175,2163
6,6,5,1,1,1,1,3,144,2055,31,71,96,399,0.02412280701754386,0.8979810996563574,,,175,2126
7,7,5,1,1,1,1,4,144,1969,31,70,91,760,0.02412280701754386,0.8608247422680413,,,175,2039
8,8,5,1,1,1,1,5,144,1905,30,50,91,A1,0.024047186932849365,0.8290378006872853,,,174,1955
9,9,2,1,2,0,0,0,225,147,292,26,-1,,0.056110102843315184,0.06872852233676977,,,517,173
10,10,3,1,2,1,0,0,225,147,292,26,-1,,0.056110102843315184,0.06872852233676977,,,517,173
11,11,4,1,2,1,1,0,225,147,292,26,-1,,0.056110102843315184,0.06872852233676977,,,517,173
12,12,5,1,2,1,1,1,225,147,45,26,96,(19),0.037431941923774956,0.06872852233676977,,,270,173
13,13,5,1,2,1,1,2,429,153,88,16,82,Europaisches,0.07153660012099214,0.06915807560137457,,,517,169
14,14,2,1,3,0,0,0,429,170,71,11,-1,,0.07025105868118572,0.07538659793814433,,,500,181
15,15,3,1,3,1,0,0,429,170,71,11,-1,,0.07025105868118572,0.07538659793814433,,,500,181
16,16,4,1,3,1,1,0,429,170,71,11,-1,,0.07025105868118572,0.07538659793814433,,,500,181
17,17,5,1,3,1,1,1,429,170,71,11,94,Patentamt,0.07025105868118572,0.07538659793814433,,,500,181
18,18,2,1,4,0,0,0,429,196,89,28,-1,,0.07161222020568662,0.09020618556701031,,,518,224
19,19,3,1,4,1,0,0,429,196,89,28,-1,,0.07161222020568662,0.09020618556701031,,,518,224
20,20,4,1,4,1,1,0,429,196,63,15,-1,,0.06964609800362977,0.08741408934707903,,,492,211
21,21,5,1,4,1,1,1,429,196,63,15,95,European,0.06964609800362977,0.08741408934707903,,,492,211
22,22,4,1,4,1,2,0,429,212,89,12,-1,,0.07161222020568662,0.0936426116838488,,,518,224
23,23,5,1,4,1,2,1,429,213,43,11,96,Patent,0.06813369630973987,0.0938573883161512,,,472,224
24,24,5,1,4,1,2,2,478,212,40,12,90,Office,0.07531760435571688,0.0936426116838488,,,518,224
25,25,2,1,5,0,0,0,429,239,109,28,-1,,0.07312462189957653,0.10867697594501718,,,538,267
26,26,3,1,5,1,0,0,429,239,109,28,-1,,0.07312462189957653,0.10867697594501718,,,538,267
27,27,4,1,5,1,1,0,429,239,109,15,-1,,0.07312462189957653,0.10588487972508591,,,538,254
28,28,5,1,5,1,1,1,429,239,40,12,93,Office,0.06790683605565638,0.1052405498281787,,,469,251
29,29,5,1,5,1,1,2,474,239,64,15,93,europ√©en,0.0765275257108288,0.10588487972508591,,,538,254
30,30,4,1,5,1,2,0,429,255,77,12,-1,,0.0707047791893527,0.11211340206185567,,,506,267
31,31,5,1,5,1,2,1,429,255,22,12,95,des,0.06654567453115548,0.11211340206185567,,,451,267
32,32,5,1,5,1,2,2,457,255,49,12,82,brevets,0.07282214156079855,0.11211340206185567,,,506,267
33,33,2,1,6,0,0,0,281,136,274,150,-1,,0.06321839080459771,0.09063573883161512,,,555,286
34,34,3,1,6,1,0,0,281,136,274,150,-1,,0.06321839080459771,0.09063573883161512,,,555,286
35,35,4,1,6,1,1,0,281,136,274,150,-1,,0.06321839080459771,0.09063573883161512,,,555,286
36,36,5,1,6,1,1,1,281,136,274,150,95, ,0.06321839080459771,0.09063573883161512,,,555,286
37,37,2,1,7,0,0,0,1002,245,458,38,-1,,0.18617664851784635,0.1134020618556701,,,1460,283
38,38,3,1,7,1,0,0,1002,245,458,38,-1,,0.18617664851784635,0.1134020618556701,,,1460,283
39,39,4,1,7,1,1,0,1002,245,458,38,-1,,0.18617664851784635,0.1134020618556701,,,1460,283
40,40,5,1,7,1,1,1,1002,256,44,27,74,(11),0.15486993345432548,0.11576460481099657,,,1046,283
41,41,5,1,7,1,1,2,1146,245,52,32,95,EP,0.17725347852389595,0.11211340206185567,number,EP,1198,277
42,42,5,1,7,1,1,3,1214,245,20,32,95,3,0.1851179673321234,0.11211340206185567,number,3,1234,277
43,43,5,1,7,1,1,4,1249,245,68,32,95,399,0.1940411373260738,0.11211340206185567,number,399,1317,277
44,44,5,1,7,1,1,5,1332,245,66,32,93,760,0.20644283121597096,0.11211340206185567,number,760,1398,277
45,45,5,1,7,1,1,6,1413,245,47,32,88,A1,0.21725650332728372,0.11211340206185567,number,A1,1460,277
46,46,2,1,8,0,0,0,225,319,889,31,-1,,0.10125529340592862,0.14368556701030927,,,1114,350
47,47,3,1,8,1,0,0,225,319,889,31,-1,,0.10125529340592862,0.14368556701030927,,,1114,350
48,48,4,1,8,1,1,0,225,319,889,31,-1,,0.10125529340592862,0.14368556701030927,,,1114,350
49,49,5,1,8,1,1,1,225,324,45,26,95,(12),0.037431941923774956,0.14475945017182132,,,270,350
50,50,5,1,8,1,1,2,577,319,156,26,95,EUROPEAN,0.09906231094978826,0.14261168384879724,,,733,345
51,51,5,1,8,1,1,3,735,320,135,24,95,PATENT,0.12137023593466424,0.14261168384879724,,,870,344
52,52,5,1,8,1,1,4,873,319,241,26,96,APPLICATION,0.1502571082879613,0.14261168384879724,,,1114,345
53,53,2,1,9,0,0,0,225,395,378,53,-1,,0.06261343012704174,0.18105670103092783,,,603,448
54,54,3,1,9,1,0,0,225,395,378,53,-1,,0.06261343012704174,0.18105670103092783,,,603,448
55,55,4,1,9,1,1,0,225,395,262,26,-1,,0.05384150030248034,0.17525773195876287,,,487,421
56,56,5,1,9,1,1,1,225,395,45,26,95,(43),0.037431941923774956,0.17525773195876287,,,270,421
57,57,5,1,9,1,1,2,286,397,48,18,95,Date,0.04688445251058681,0.17439862542955326,,,334,415
58,58,5,1,9,1,1,3,342,397,20,18,96,of,0.05323653962492438,0.17439862542955326,,,362,415
59,59,5,1,9,1,1,4,370,397,117,23,96,publication:,0.0648064125831821,0.17547250859106528,,,487,420
60,60,4,1,9,1,2,0,286,430,317,18,-1,,0.06722625529340592,0.18857388316151202,,,603,448
61,61,5,1,9,1,2,1,286,430,117,18,96,07.11.2018,0.052102238354506954,0.18857388316151202,publication_date,07.11.2018,403,448
62,62,5,1,9,1,2,2,426,430,84,18,95,Bulletin,0.07078039927404718,0.18857388316151202,,,510,448
63,63,5,1,9,1,2,3,519,430,84,18,95,2018/45,0.08484573502722323,0.18857388316151202,,,603,448
64,64,2,1,10,0,0,0,225,493,402,26,-1,,0.06442831215970962,0.21735395189003437,,,627,519
65,65,3,1,10,1,0,0,225,493,402,26,-1,,0.06442831215970962,0.21735395189003437,,,627,519
66,66,4,1,10,1,1,0,225,493,402,26,-1,,0.06442831215970962,0.21735395189003437,,,627,519
67,67,5,1,10,1,1,1,225,493,45,26,96,(21),0.037431941923774956,0.21735395189003437,,,270,519
68,68,5,1,10,1,1,2,285,495,115,23,96,Application,0.051799758015728975,0.21756872852233677,,,400,518
69,69,5,1,10,1,1,3,410,495,83,18,93,number:,0.06828493647912885,0.21649484536082475,,,493,513
70,70,5,1,10,1,1,4,505,495,122,18,92,18178662.5,0.08560193587416817,0.21649484536082475,application_number,18178662.5,627,513
71,71,2,1,11,0,0,0,225,559,325,26,-1,,0.05860556563823351,0.24570446735395188,,,550,585
72,72,3,1,11,1,0,0,225,559,325,26,-1,,0.05860556563823351,0.24570446735395188,,,550,585
73,73,4,1,11,1,1,0,225,559,325,26,-1,,0.05860556563823351,0.24570446735395188,,,550,585
74,74,5,1,11,1,1,1,225,559,45,26,96,(22),0.037431941923774956,0.24570446735395188,,,270,585
75,75,5,1,11,1,1,2,286,561,48,18,96,Date,0.04688445251058681,0.24484536082474226,,,334,579
76,76,5,1,11,1,1,3,342,566,12,13,96,of,0.05263157894736842,0.24591924398625428,,,354,579
77,77,5,1,11,1,1,4,355,561,67,23,96,filing:,0.058756805807622506,0.24591924398625428,,,422,584
78,78,5,1,11,1,1,5,432,561,118,18,87,31.10.2012,0.07425892316999395,0.24484536082474226,filing_date,31.10.2012,550,579
79,79,2,1,12,0,0,0,862,395,126,26,-1,,0.13989715668481548,0.17525773195876287,,,988,421
80,80,3,1,12,1,0,0,862,395,126,26,-1,,0.13989715668481548,0.17525773195876287,,,988,421
81,81,4,1,12,1,1,0,862,395,126,26,-1,,0.13989715668481548,0.17525773195876287,,,988,421
82,82,5,1,12,1,1,1,862,395,44,26,67,(51),0.1336963097398669,0.17525773195876287,,,906,421
83,83,5,1,12,1,1,2,923,397,25,18,93,Int,0.1414851784633999,0.17439862542955326,,,948,415
84,84,5,1,12,1,1,3,955,397,33,18,65,Cl:,0.14692982456140352,0.17439862542955326,,,988,415
85,85,2,1,13,0,0,0,922,425,199,21,-1,,0.15449183303085298,0.1870704467353952,,,1121,446
86,86,3,1,13,1,0,0,922,425,199,21,-1,,0.15449183303085298,0.1870704467353952,,,1121,446
87,87,4,1,13,1,1,0,922,425,199,21,-1,,0.15449183303085298,0.1870704467353952,,,1121,446
88,88,5,1,13,1,1,1,922,428,61,18,51,HOA4N,0.1440562613430127,0.1877147766323024,class_international,H04N,983,446
89,89,5,1,13,1,1,2,992,428,56,18,61,19191,0.1542649727767695,0.1877147766323024,class_international,19/91,1048,446
90,90,5,1,13,1,1,3,1054,425,67,16,75,(2014.00),0.16447368421052633,0.18599656357388317,,,1121,441
91,91,2,1,14,0,0,0,224,614,1243,2,-1,,0.1278735632183908,0.26417525773195877,,,1467,616
92,92,3,1,14,1,0,0,224,614,1243,2,-1,,0.1278735632183908,0.26417525773195877,,,1467,616
93,93,4,1,14,1,1,0,224,614,1243,2,-1,,0.1278735632183908,0.26417525773195877,,,1467,616
94,94,5,1,14,1,1,1,224,614,1243,2,95, ,0.1278735632183908,0.26417525773195877,,,1467,616
95,95,2,1,15,0,0,0,225,631,599,119,-1,,0.07932546884452511,0.296606529209622,,,824,750
96,96,3,1,15,1,0,0,225,631,599,119,-1,,0.07932546884452511,0.296606529209622,,,824,750
97,97,4,1,15,1,1,0,225,631,388,27,-1,,0.0633696309739867,0.2768470790378007,,,613,658
98,98,5,1,15,1,1,1,225,631,45,27,96,(84),0.037431941923774956,0.2768470790378007,,,270,658
99,99,5,1,15,1,1,2,286,633,118,23,96,Designated,0.052177858439201454,0.2768470790378007,,,404,656
100,100,5,1,15,1,1,3,413,633,119,23,96,Contracting,0.07146098003629764,0.2768470790378007,,,532,656
101,101,5,1,15,1,1,4,542,633,71,19,96,States:,0.08734119782214156,0.2759879725085911,,,613,652
102,102,4,1,15,1,2,0,285,666,537,18,-1,,0.08371143375680581,0.28994845360824745,,,822,684
103,103,5,1,15,1,2,1,285,666,31,18,94,AL,0.04544767090139141,0.28994845360824745,,,316,684
104,104,5,1,15,1,2,2,323,666,31,18,94,AT,0.05119479733817302,0.28994845360824745,,,354,684
105,105,5,1,15,1,2,3,363,666,30,18,96,BE,0.05716878402903811,0.28994845360824745,,,393,684
106,106,5,1,15,1,2,4,403,666,32,18,96,BG,0.0633696309739867,0.28994845360824745,,,435,684
107,107,5,1,15,1,2,5,445,666,31,18,96,CH,0.06964609800362977,0.28994845360824745,,,476,684
108,108,5,1,15,1,2,6,486,666,32,18,95,CY,0.07592256503327284,0.28994845360824745,,,518,684
109,109,5,1,15,1,2,7,526,666,30,18,93,CZ,0.08182093163944344,0.28994845360824745,,,556,684
110,110,5,1,15,1,2,8,565,666,30,18,93,DE,0.08771929824561403,0.28994845360824745,,,595,684
111,111,5,1,15,1,2,9,605,666,32,18,95,DK,0.09392014519056262,0.28994845360824745,,,637,684
112,112,5,1,15,1,2,10,646,666,29,18,95,EE,0.0998941318814277,0.28994845360824745,,,675,684
113,113,5,1,15,1,2,11,684,666,29,18,93,ES,0.10564125831820932,0.28994845360824745,,,713,684
114,114,5,1,15,1,2,12,723,666,57,18,90,FIFR,0.11365698729582577,0.28994845360824745,,,780,684
115,115,5,1,15,1,2,13,788,666,34,18,95,GB,0.12174833635813673,0.28994845360824745,,,822,684
116,116,4,1,15,1,3,0,285,699,539,18,-1,,0.0838626739261948,0.30412371134020616,,,824,717
117,117,5,1,15,1,3,1,285,699,297,18,83,GRHRHUIEISITLILTLU,0.06556261343012704,0.30412371134020616,,,582,717
118,118,5,1,15,1,3,2,591,699,28,18,85,LV,0.09150030248033877,0.30412371134020616,,,619,717
119,119,5,1,15,1,3,3,627,699,35,18,85,MC,0.09747428917120388,0.30412371134020616,,,662,717
120,120,5,1,15,1,3,4,670,699,35,18,94,MK,0.10397761645493044,0.30412371134020616,,,705,717
121,121,5,1,15,1,3,5,713,699,32,18,91,MT,0.11025408348457351,0.30412371134020616,,,745,717
122,122,5,1,15,1,3,6,753,699,29,18,49,NL,0.11607683000604961,0.30412371134020616,,,782,717
123,123,5,1,15,1,3,7,791,699,33,18,49,NO,0.1221264367816092,0.30412371134020616,,,824,717
124,124,4,1,15,1,4,0,286,732,336,18,-1,,0.06866303690260134,0.31829896907216493,,,622,750
125,125,5,1,15,1,4,1,286,732,28,18,93,PL,0.045372050816696916,0.31829896907216493,,,314,750
126,126,5,1,15,1,4,2,323,732,29,18,92,PT,0.05104355716878403,0.31829896907216493,,,352,750
127,127,5,1,15,1,4,3,360,732,58,18,92,RORS,0.058832425892317,0.31829896907216493,,,418,750
128,128,5,1,15,1,4,4,420,732,52,18,92,SE,0.06745311554748941,0.31829896907216493,,,472,750
129,129,5,1,15,1,4,5,480,732,20,18,95,SI,0.07410768300060495,0.31829896907216493,,,500,750
130,130,5,1,15,1,4,6,510,732,31,18,93,SK,0.0794767090139141,0.31829896907216493,,,541,750
131,131,5,1,15,1,4,7,550,732,72,18,90,SMTR,0.08862673926194797,0.31829896907216493,,,622,750
132,132,2,1,16,0,0,0,225,795,513,53,-1,,0.07282214156079855,0.35287800687285226,,,738,848
133,133,3,1,16,1,0,0,225,795,513,53,-1,,0.07282214156079855,0.35287800687285226,,,738,848
134,134,4,1,16,1,1,0,225,795,513,27,-1,,0.07282214156079855,0.3472938144329897,,,738,822
135,135,5,1,16,1,1,1,225,795,45,27,96,(30),0.037431941923774956,0.3472938144329897,,,270,822
136,136,5,1,16,1,1,2,286,797,77,23,95,Priority:,0.04907743496672716,0.3472938144329897,,,363,820
137,137,5,1,16,1,1,3,383,797,116,19,95,31.10.2011,0.06669691470054447,0.34643470790378006,priority_date_eu,31.10.2011,499,816
138,138,5,1,16,1,1,4,520,797,30,19,96,US,0.0809134906231095,0.34643470790378006,,,550,816
139,139,5,1,16,1,1,5,559,797,157,19,93,201161553668,0.09641560798548095,0.34643470790378006,,,716,816
140,140,5,1,16,1,1,6,725,797,13,19,93,P,0.11063218390804598,0.34643470790378006,,,738,816
141,141,4,1,16,1,2,0,385,830,353,18,-1,,0.08492135511191773,0.3603951890034364,,,738,848
142,142,5,1,16,1,2,1,385,830,116,18,94,16.07.2012,0.06699939503932244,0.3603951890034364,,,501,848
143,143,5,1,16,1,2,2,520,830,30,18,95,US,0.0809134906231095,0.3603951890034364,,,550,848
144,144,5,1,16,1,2,3,559,830,157,18,93,201261671955,0.09641560798548095,0.3603951890034364,,,716,848
145,145,5,1,16,1,2,4,725,830,13,18,93,P,0.11063218390804598,0.3603951890034364,,,738,848
146,146,2,1,17,0,0,0,225,893,596,119,-1,,0.07909860859044163,0.40914948453608246,,,821,1012
147,147,3,1,17,1,0,0,225,893,596,119,-1,,0.07909860859044163,0.40914948453608246,,,821,1012
148,148,4,1,17,1,1,0,225,893,596,27,-1,,0.07909860859044163,0.3893900343642612,,,821,920
149,149,5,1,17,1,1,1,225,893,45,27,96,(62),0.037431941923774956,0.3893900343642612,,,270,920
150,150,5,1,17,1,1,2,286,895,107,19,96,Document,0.05134603750756201,0.38853092783505155,,,393,914
151,151,5,1,17,1,1,3,402,895,105,23,95,number(s),0.06873865698729582,0.3893900343642612,,,507,918
152,152,5,1,17,1,1,4,516,895,20,19,96,of,0.07955232909860858,0.38853092783505155,,,536,914
153,153,5,1,17,1,1,5,542,895,32,19,96,the,0.08439201451905626,0.38853092783505155,,,574,914
154,154,5,1,17,1,1,6,582,895,66,19,96,earlier,0.09301270417422867,0.38853092783505155,,,648,914
155,155,5,1,17,1,1,7,655,895,140,23,95,application(s),0.10964912280701754,0.3893900343642612,,,795,918
156,156,5,1,17,1,1,8,805,895,16,19,96,in,0.12295825771324864,0.38853092783505155,,,821,914
157,157,4,1,17,1,2,0,286,929,308,18,-1,,0.06654567453115548,0.4029209621993127,,,594,947
158,158,5,1,17,1,2,1,286,929,121,18,96,accordance,0.05240471869328494,0.4029209621993127,,,407,947
159,159,5,1,17,1,2,2,415,929,40,18,96,with,0.06578947368421052,0.4029209621993127,,,455,947
160,160,5,1,17,1,2,3,464,929,35,18,95,Art.,0.07282214156079855,0.4029209621993127,,,499,947
161,161,5,1,17,1,2,4,508,929,25,18,95,76,0.07872050816696914,0.4029209621993127,,,533,947
162,162,5,1,17,1,2,5,542,929,52,18,96,EPC:,0.08590441621294616,0.4029209621993127,,,594,947
163,163,4,1,17,1,3,0,286,961,250,19,-1,,0.06215970961887477,0.4168814432989691,,,536,980
164,164,5,1,17,1,3,1,286,961,124,19,87,16197055.3,0.05263157894736842,0.4168814432989691,,,410,980
165,165,5,1,17,1,3,2,417,961,7,19,87,/,0.06359649122807018,0.4168814432989691,,,424,980
166,166,5,1,17,1,3,3,432,961,11,19,93,3,0.066167574107683,0.4168814432989691,,,443,980
167,167,5,1,17,1,3,4,452,961,37,19,93,166,0.07115849969751967,0.4168814432989691,,,489,980
168,168,5,1,17,1,3,5,498,961,38,19,93,317,0.07819116757410768,0.4168814432989691,,,536,980
169,169,4,1,17,1,4,0,286,994,250,18,-1,,0.06215970961887477,0.43084192439862545,,,536,1012
170,170,5,1,17,1,4,1,286,994,125,18,73,12845496.4,0.05270719903206292,0.43084192439862545,,,411,1012
171,171,5,1,17,1,4,2,417,994,7,18,73,/,0.06359649122807018,0.43084192439862545,,,424,1012
172,172,5,1,17,1,4,3,432,994,11,18,84,2,0.066167574107683,0.43084192439862545,,,443,1012
173,173,5,1,17,1,4,4,451,994,38,18,84,773,0.07108287961282517,0.43084192439862545,,,489,1012
174,174,5,1,17,1,4,5,499,994,37,18,95,109,0.07826678765880218,0.43084192439862545,,,536,1012
175,175,2,1,18,0,0,0,225,1057,515,58,-1,,0.07297338173018754,0.46649484536082475,,,740,1115
176,176,3,1,18,1,0,0,225,1057,515,58,-1,,0.07297338173018754,0.46649484536082475,,,740,1115
177,177,4,1,18,1,1,0,225,1057,515,27,-1,,0.07297338173018754,0.45983676975945015,,,740,1084
178,178,5,1,18,1,1,1,225,1057,45,27,96,(71),0.037431941923774956,0.45983676975945015,,,270,1084
179,179,5,1,18,1,1,2,285,1059,103,23,96,Applicant:,0.05089231699939504,0.45983676975945015,,,388,1082
180,180,5,1,18,1,1,3,397,1059,105,23,96,Samsung,0.06798245614035088,0.45983676975945015,applicant_line_1,Samsung,502,1082
181,181,5,1,18,1,1,4,512,1059,126,19,93,Electronics,0.08696309739866909,0.45897766323024053,applicant_line_1,Electronics,638,1078
182,182,5,1,18,1,1,5,647,1059,42,22,92,"Co.,",0.10102843315184513,0.45962199312714774,applicant_line_1,"Co.,",689,1081
183,183,5,1,18,1,1,6,699,1059,41,19,96,Ltd.,0.1088173018753781,0.45897766323024053,applicant_line_1,Ltd.,740,1078
184,184,4,1,18,1,2,0,286,1092,274,23,-1,,0.06397459165154265,0.4740120274914089,,,560,1115
185,185,5,1,18,1,2,1,286,1092,145,23,95,Gyeonggi-do,0.05421960072595281,0.4740120274914089,,,431,1115
186,186,5,1,18,1,2,2,441,1092,63,18,96,16677,0.07146098003629764,0.4729381443298969,,,504,1110
187,187,5,1,18,1,2,3,512,1092,48,23,96,(KR),0.08106473079249849,0.4740120274914089,,,560,1115
188,188,2,1,19,0,0,0,845,614,2,533,-1,,0.1279491833030853,0.37822164948453607,,,847,1147
189,189,3,1,19,1,0,0,845,614,2,533,-1,,0.1279491833030853,0.37822164948453607,,,847,1147
190,190,4,1,19,1,1,0,845,614,2,533,-1,,0.1279491833030853,0.37822164948453607,,,847,1147
191,191,5,1,19,1,1,1,845,614,2,533,95, ,0.1279491833030853,0.37822164948453607,,,847,1147
192,192,2,1,20,0,0,0,862,631,162,27,-1,,0.1426194797338173,0.2768470790378007,,,1024,658
193,193,3,1,20,1,0,0,862,631,162,27,-1,,0.1426194797338173,0.2768470790378007,,,1024,658
194,194,4,1,20,1,1,0,862,631,162,27,-1,,0.1426194797338173,0.2768470790378007,,,1024,658
195,195,5,1,20,1,1,1,862,631,44,27,94,(72),0.1336963097398669,0.2768470790378007,,,906,658
196,196,5,1,20,1,1,2,923,633,101,19,94,Inventors:,0.1472323049001815,0.2759879725085911,,,1024,652
197,197,2,1,21,0,0,0,898,666,320,122,-1,,0.1600120992135511,0.3122852233676976,,,1218,788
198,198,3,1,21,1,0,0,898,666,152,23,-1,,0.147307924984876,0.29102233676975947,,,1050,689
199,199,4,1,21,1,1,0,898,666,152,23,-1,,0.147307924984876,0.29102233676975947,,,1050,689
200,200,5,1,21,1,1,1,898,671,7,8,43,¬´,0.13634301270417423,0.28994845360824745,,,905,679
201,201,5,1,21,1,1,2,923,666,55,18,92,"PIAO,",0.14375378100423472,0.28994845360824745,inventor_line_1,"PIAO,",978,684
202,202,5,1,21,1,1,3,981,666,69,23,92,Yin-ji,0.15358439201451907,0.29102233676975947,inventor_line_1,Yin-ji,1050,689
203,203,3,1,21,2,0,0,898,699,320,56,-1,,0.1600120992135511,0.3122852233676976,,,1218,755
204,204,4,1,21,2,1,0,922,699,296,23,-1,,0.161826981246219,0.30519759450171824,,,1218,722
205,205,5,1,21,2,1,1,922,699,86,18,96,443-744,0.14594676346037508,0.30412371134020616,,,1008,717
206,206,5,1,21,2,1,2,1016,699,145,23,96,Gyeonggi-do,0.1646249243799153,0.30519759450171824,,,1161,722
207,207,5,1,21,2,1,3,1170,699,48,23,96,(KR),0.18058076225045372,0.30519759450171824,,,1218,722
208,208,4,1,21,2,2,0,898,732,185,23,-1,,0.14980338777979432,0.31937285223367695,,,1083,755
209,209,5,1,21,2,2,1,898,737,7,8,60,¬´,0.13634301270417423,0.31829896907216493,,,905,745
210,210,5,1,21,2,2,2,923,732,47,22,91,"MIN,",0.14314882032667878,0.31915807560137455,,,970,754
211,211,5,1,21,2,2,3,978,732,105,23,91,Jung-hye,0.1558529945553539,0.31937285223367695,,,1083,755
212,212,3,1,21,3,0,0,922,765,296,23,-1,,0.161826981246219,0.3335481099656357,,,1218,788
213,213,4,1,21,3,1,0,922,765,296,23,-1,,0.161826981246219,0.3335481099656357,,,1218,788
214,214,5,1,21,3,1,1,922,765,85,18,96,443-745,0.14587114337568058,0.3324742268041237,,,1007,783
215,215,5,1,21,3,1,2,1016,765,145,23,96,Gyeonggi-do,0.1646249243799153,0.3335481099656357,,,1161,788
216,216,5,1,21,3,1,3,1170,765,48,23,96,(KR),0.18058076225045372,0.3335481099656357,,,1218,788
217,217,2,1,22,0,0,0,862,828,490,26,-1,,0.16742286751361163,0.36125429553264604,,,1352,854
218,218,3,1,22,1,0,0,862,828,490,26,-1,,0.16742286751361163,0.36125429553264604,,,1352,854
219,219,4,1,22,1,1,0,862,828,490,26,-1,,0.16742286751361163,0.36125429553264604,,,1352,854
220,220,5,1,22,1,1,1,862,828,44,26,96,(74),0.1336963097398669,0.36125429553264604,,,906,854
221,221,5,1,22,1,1,2,923,830,163,23,96,Representative:,0.15192075015124018,0.36146907216494845,,,1086,853
222,222,5,1,22,1,1,3,1095,830,115,23,96,Appleyard,0.17430429522081065,0.36146907216494845,representative_line_1_eu,Appleyard,1210,853
223,223,5,1,22,1,1,4,1220,830,51,18,96,Lees,0.18836963097398668,0.3603951890034364,representative_line_1_eu,Lees,1271,848
224,224,5,1,22,1,1,5,1281,830,20,18,96,IP,0.19525105868118572,0.3603951890034364,representative_line_1_eu,IP,1301,848
225,225,5,1,22,1,1,6,1310,830,42,18,96,LLP,0.2013006654567453,0.3603951890034364,representative_line_1_eu,LLP,1352,848
226,226,2,1,23,0,0,0,923,863,239,55,-1,,0.15766787658802178,0.38251718213058417,,,1162,918
227,227,3,1,23,1,0,0,923,863,239,55,-1,,0.15766787658802178,0.38251718213058417,,,1162,918
228,228,4,1,23,1,1,0,923,863,155,18,-1,,0.1513157894736842,0.3745704467353952,,,1078,881
229,229,5,1,23,1,1,1,923,863,23,18,96,15,0.1413339382940109,0.3745704467353952,,,946,881
230,230,5,1,23,1,1,2,955,863,58,18,96,Clare,0.14882032667876588,0.3745704467353952,,,1013,881
231,231,5,1,23,1,1,3,1022,863,56,18,96,Road,0.1588021778584392,0.3745704467353952,,,1078,881
232,232,4,1,23,1,2,0,923,895,239,23,-1,,0.15766787658802178,0.3893900343642612,,,1162,918
233,233,5,1,23,1,2,1,923,895,76,19,92,Halifax,0.1453418027828191,0.38853092783505155,,,999,914
234,234,5,1,23,1,2,2,1008,895,41,19,79,HX1,0.15555051421657592,0.38853092783505155,,,1049,914
235,235,5,1,23,1,2,3,1060,895,45,19,79,2HY,0.16371748336358136,0.38853092783505155,,,1105,914
236,236,5,1,23,1,2,4,1113,895,49,23,96,(GB),0.1720356926799758,0.3893900343642612,,,1162,918
237,237,2,1,24,0,0,0,862,961,99,19,-1,,0.13785541439806412,0.4168814432989691,,,961,980
238,238,3,1,24,1,0,0,862,961,99,19,-1,,0.13785541439806412,0.4168814432989691,,,961,980
239,239,4,1,24,1,1,0,862,961,99,19,-1,,0.13785541439806412,0.4168814432989691,,,961,980
240,240,5,1,24,1,1,1,862,961,99,19,96,Remarks:,0.13785541439806412,0.4168814432989691,,,961,980
241,241,2,1,25,0,0,0,922,994,522,84,-1,,0.17891712038717483,0.44501718213058417,,,1444,1078
242,242,3,1,25,1,0,0,922,994,522,84,-1,,0.17891712038717483,0.44501718213058417,,,1444,1078
243,243,4,1,25,1,1,0,922,994,477,23,-1,,0.17551421657592256,0.4319158075601375,,,1399,1017
244,244,5,1,25,1,1,1,922,994,43,18,96,This,0.1426950998185118,0.43084192439862545,,,965,1012
245,245,5,1,25,1,1,2,974,994,111,23,96,application,0.15570175438596492,0.4319158075601375,,,1085,1017
246,246,5,1,25,1,1,3,1093,999,42,13,96,was,0.16848154869933454,0.4319158075601375,,,1135,1012
247,247,5,1,25,1,1,4,1142,994,43,18,96,filed,0.17596793708408953,0.43084192439862545,,,1185,1012
248,248,5,1,25,1,1,5,1193,999,25,13,95,on,0.1823200241984271,0.4319158075601375,,,1218,1012
249,249,5,1,25,1,1,6,1228,994,119,18,96,19-06-2018,0.19472171808832425,0.43084192439862545,,,1347,1012
250,250,5,1,25,1,1,7,1355,999,24,13,95,as,0.20674531155474893,0.4319158075601375,,,1379,1012
251,251,5,1,25,1,1,8,1387,999,12,13,95,a,0.21067755595886267,0.4319158075601375,,,1399,1012
252,252,4,1,25,1,2,0,922,1027,522,23,-1,,0.17891712038717483,0.44609106529209624,,,1444,1050
253,253,5,1,25,1,2,1,922,1027,96,18,95,divisional,0.14670296430732002,0.44501718213058417,,,1018,1045
254,254,5,1,25,1,2,2,1027,1027,111,23,96,application,0.16371748336358136,0.44609106529209624,,,1138,1050
255,255,5,1,25,1,2,3,1147,1027,19,18,96,to,0.17490925589836662,0.44501718213058417,,,1166,1045
256,256,5,1,25,1,2,4,1174,1027,31,18,96,the,0.17990018148820328,0.44501718213058417,,,1205,1045
257,257,5,1,25,1,2,5,1214,1027,112,23,96,application,0.19207501512401695,0.44609106529209624,,,1326,1050
258,258,5,1,25,1,2,6,1336,1027,108,18,96,mentioned,0.2102238354506957,0.44501718213058417,,,1444,1045
259,259,4,1,25,1,3,0,923,1059,209,19,-1,,0.15539927404718692,0.45897766323024053,,,1132,1078
260,260,5,1,25,1,3,1,923,1059,59,19,93,under,0.1440562613430127,0.45897766323024053,,,982,1078
261,261,5,1,25,1,3,2,991,1059,45,19,91,INID,0.15328191167574107,0.45897766323024053,,,1036,1078
262,262,5,1,25,1,3,3,1044,1059,50,19,96,code,0.16167574107683,0.45897766323024053,,,1094,1078
263,263,5,1,25,1,3,4,1103,1059,29,19,96,62.,0.16901088929219601,0.45897766323024053,,,1132,1078
264,264,2,1,26,0,0,0,224,1145,1243,2,-1,,0.1278735632183908,0.49226804123711343,,,1467,1147
265,265,3,1,26,1,0,0,224,1145,1243,2,-1,,0.1278735632183908,0.49226804123711343,,,1467,1147
266,266,4,1,26,1,1,0,224,1145,1243,2,-1,,0.1278735632183908,0.49226804123711343,,,1467,1147
267,267,5,1,26,1,1,1,224,1145,1243,2,95, ,0.1278735632183908,0.49226804123711343,,,1467,1147
268,268,2,1,27,0,0,0,225,1165,1201,54,-1,,0.12484875983061101,0.5120274914089347,,,1426,1219
269,269,3,1,27,1,0,0,225,1165,1201,54,-1,,0.12484875983061101,0.5120274914089347,,,1426,1219
270,270,4,1,27,1,1,0,225,1165,1201,26,-1,,0.12484875983061101,0.5060137457044673,,,1426,1191
271,271,5,1,27,1,1,1,225,1165,45,26,89,(54),0.037431941923774956,0.5060137457044673,,,270,1191
272,272,5,1,27,1,1,2,316,1165,112,21,89,METHOD,0.056261343012704176,0.5049398625429553,title_line_1,METHOD,428,1186
273,273,5,1,27,1,1,3,437,1165,56,20,95,AND,0.07032667876588022,0.5047250859106529,title_line_1,AND,493,1185
274,274,5,1,27,1,1,4,502,1165,146,21,96,APPARATUS,0.08696309739866909,0.5049398625429553,title_line_1,APPARATUS,648,1186
275,275,5,1,27,1,1,5,651,1165,79,21,96,FOR,0.1044313369630974,0.5049398625429553,title_line_1,FOR,730,1186
276,276,5,1,27,1,1,6,740,1165,182,21,96,DETERMINING,0.12568058076225044,0.5049398625429553,title_line_1,DETERMINING,922,1186
277,277,5,1,27,1,1,7,931,1165,19,20,95,A,0.14224137931034483,0.5047250859106529,title_line_1,A,950,1185
278,278,5,1,27,1,1,8,959,1165,126,21,95,CONTEXT,0.15456745311554748,0.5049398625429553,title_line_1,CONTEXT,1085,1186
279,279,5,1,27,1,1,9,1094,1165,93,21,96,MODEL,0.17248941318814276,0.5049398625429553,title_line_1,MODEL,1187,1186
280,280,5,1,27,1,1,10,1197,1165,54,21,96,FOR,0.1851179673321234,0.5049398625429553,title_line_1,FOR,1251,1186
281,281,5,1,27,1,1,11,1260,1165,166,21,95,TRANSFORM,0.20311554748941318,0.5049398625429553,title_line_1,TRANSFORM,1426,1186
282,282,4,1,27,1,2,0,316,1198,769,21,-1,,0.1059437386569873,0.5191151202749141,,,1085,1219
283,283,5,1,27,1,2,1,316,1198,176,21,96,COEFFICIENT,0.06110102843315184,0.5191151202749141,,,492,1219
284,284,5,1,27,1,2,2,501,1198,82,20,96,LEVEL,0.08197217180883243,0.5189003436426117,,,583,1218
285,285,5,1,27,1,2,3,594,1198,125,21,96,ENTROPY,0.09928917120387175,0.5191151202749141,,,719,1219
286,286,5,1,27,1,2,4,729,1198,140,21,96,ENCODING,0.12084089534180278,0.5191151202749141,,,869,1219
287,287,5,1,27,1,2,5,878,1198,57,20,96,AND,0.13709921355111918,0.5189003436426117,,,935,1218
288,288,5,1,27,1,2,6,945,1198,140,21,96,DECODING,0.15350877192982457,0.5191151202749141,,,1085,1219
289,289,2,1,28,0,0,0,225,1272,582,413,-1,,0.0780399274047187,0.635094501718213,,,807,1685
290,290,3,1,28,1,0,0,225,1272,582,413,-1,,0.0780399274047187,0.635094501718213,,,807,1685
291,291,4,1,28,1,1,0,225,1272,582,26,-1,,0.0780399274047187,0.5519759450171822,,,807,1298
292,292,5,1,28,1,1,1,225,1272,45,26,92,(57),0.037431941923774956,0.5519759450171822,,,270,1298
293,293,5,1,28,1,1,2,316,1274,91,18,20,Provided,0.05467332123411978,0.5511168384879725,,,407,1292
294,294,5,1,28,1,1,3,415,1278,33,14,96,are,0.06526013309134907,0.5519759450171822,,,448,1292
295,295,5,1,28,1,1,4,455,1278,11,14,96,a,0.06964609800362977,0.5519759450171822,,,466,1292
296,296,5,1,28,1,1,5,473,1274,77,18,96,method,0.07735934664246824,0.5511168384879725,,,550,1292
297,297,5,1,28,1,1,6,558,1274,37,18,96,and,0.08718995765275257,0.5511168384879725,,,595,1292
298,298,5,1,28,1,1,7,603,1274,91,23,96,apparatus,0.09807924984875983,0.5521907216494846,,,694,1297
299,299,5,1,28,1,1,8,696,1274,44,18,93,for,0.10859044162129462,0.5511168384879725,,,740,1292
300,300,5,1,28,1,1,9,746,1274,61,18,91,deter-,0.11743799153055051,0.5511168384879725,,,807,1292
301,301,4,1,28,1,2,0,226,1306,581,23,-1,,0.07811554748941318,0.5659364261168385,,,807,1329
302,302,5,1,28,1,2,1,226,1306,67,23,96,mining,0.03924682395644283,0.5659364261168385,,,293,1329
303,303,5,1,28,1,2,2,300,1311,11,14,96,a,0.04620387174833636,0.5661512027491409,,,311,1325
304,304,5,1,28,1,2,3,319,1307,76,18,96,context,0.053992740471869326,0.5652920962199313,,,395,1325
305,305,5,1,28,1,2,4,402,1306,57,19,96,model,0.06510889292196008,0.5650773195876289,,,459,1325
306,306,5,1,28,1,2,5,462,1306,36,19,96,for,0.07259528130671507,0.5650773195876289,,,498,1325
307,307,5,1,28,1,2,6,504,1307,79,22,96,entropy,0.08219903206291591,0.5661512027491409,,,583,1329
308,308,5,1,28,1,2,7,588,1306,96,23,96,encoding,0.09618874773139746,0.5659364261168385,,,684,1329
309,309,5,1,28,1,2,8,690,1306,38,19,93,and,0.10722928009679371,0.5650773195876289,,,728,1325
310,310,5,1,28,1,2,9,735,1306,72,19,91,decod-,0.11660617059891107,0.5650773195876289,,,807,1325
311,311,4,1,28,1,3,0,226,1339,581,23,-1,,0.07811554748941318,0.5801116838487973,,,807,1362
312,312,5,1,28,1,3,1,226,1339,28,23,97,ing,0.036297640653357534,0.5801116838487973,,,254,1362
313,313,5,1,28,1,3,2,260,1339,20,18,96,of,0.04083484573502722,0.5790378006872853,,,280,1357
314,314,5,1,28,1,3,3,285,1344,11,13,92,a,0.043935269207501515,0.5801116838487973,,,296,1357
315,315,5,1,28,1,3,4,302,1339,150,18,92,transformation,0.05701754385964912,0.5790378006872853,,,452,1357
316,316,5,1,28,1,3,5,459,1339,111,18,96,coefficient.,0.07781306715063521,0.5790378006872853,,,570,1357
317,317,5,1,28,1,3,6,576,1339,104,23,96,According,0.09497882637628555,0.5801116838487973,,,680,1362
318,318,5,1,28,1,3,7,686,1340,19,17,96,to,0.10518753781004235,0.5792525773195877,,,705,1357
319,319,5,1,28,1,3,8,710,1339,32,18,93,the,0.10980036297640654,0.5790378006872853,,,742,1357
320,320,5,1,28,1,3,9,749,1339,58,18,92,meth-,0.117664851784634,0.5790378006872853,,,807,1357
321,321,4,1,28,1,4,0,225,1372,582,23,-1,,0.0780399274047187,0.594286941580756,,,807,1395
322,322,5,1,28,1,4,1,225,1372,24,19,96,od,0.03584392014519056,0.5934278350515464,,,249,1391
323,323,5,1,28,1,4,2,258,1372,37,19,96,and,0.04181790683605566,0.5934278350515464,,,295,1391
324,324,5,1,28,1,4,3,304,1373,110,22,96,"apparatus,",0.05429522081064731,0.5945017182130584,,,414,1395
325,325,5,1,28,1,4,4,422,1377,11,14,96,a,0.06465517241379311,0.5945017182130584,,,433,1391
326,326,5,1,28,1,4,5,442,1373,68,18,96,context,0.07199032062915911,0.5936426116838488,,,510,1391
327,327,5,1,28,1,4,6,512,1373,43,18,96,set,0.08068663036902601,0.5936426116838488,,,555,1391
328,328,5,1,28,1,4,7,563,1372,55,19,93,index,0.08930732002419843,0.5934278350515464,,,618,1391
329,329,5,1,28,1,4,8,626,1373,61,18,92,ctxset,0.09928917120387175,0.5936426116838488,,,687,1391
330,330,5,1,28,1,4,9,695,1372,15,19,96,is,0.10624621899576528,0.5934278350515464,,,710,1391
331,331,5,1,28,1,4,10,717,1372,90,19,96,obtained,0.11524500907441017,0.5934278350515464,,,807,1391
332,332,4,1,28,1,5,0,226,1405,581,23,-1,,0.07811554748941318,0.6084621993127147,,,807,1428
333,333,5,1,28,1,5,1,226,1405,61,18,96,based,0.03879310344827586,0.6073883161512027,,,287,1423
334,334,5,1,28,1,5,2,297,1410,24,13,96,on,0.04673321234119782,0.6084621993127147,,,321,1423
335,335,5,1,28,1,5,3,331,1405,50,18,96,color,0.05384150030248034,0.6073883161512027,,,381,1423
336,336,5,1,28,1,5,4,390,1410,109,18,96,component,0.06722625529340592,0.6095360824742269,,,499,1428
337,337,5,1,28,1,5,5,501,1405,129,18,96,information,0.08552631578947369,0.6073883161512027,,,630,1423
338,338,5,1,28,1,5,6,639,1405,20,18,96,of,0.09815486993345432,0.6073883161512027,,,659,1423
339,339,5,1,28,1,5,7,666,1410,11,13,93,a,0.10155777374470659,0.6084621993127147,,,677,1423
340,340,5,1,28,1,5,8,686,1405,121,18,91,transforma-,0.11290078644888082,0.6073883161512027,,,807,1423
341,341,4,1,28,1,6,0,225,1438,582,21,-1,,0.0780399274047187,0.6222079037800687,,,807,1459
342,342,5,1,28,1,6,1,225,1438,36,18,96,tion,0.0367513611615245,0.6215635738831615,,,261,1456
343,343,5,1,28,1,6,2,269,1438,41,21,91,"unit,",0.04378402903811252,0.6222079037800687,,,310,1459
344,344,5,1,28,1,6,3,317,1442,11,14,90,a,0.04877495462794918,0.6224226804123711,,,328,1456
345,345,5,1,28,1,6,4,335,1438,79,18,90,location,0.05663944343617665,0.6215635738831615,,,414,1456
346,346,5,1,28,1,6,5,420,1438,20,18,96,of,0.06503327283726558,0.6215635738831615,,,440,1456
347,347,5,1,28,1,6,6,444,1442,12,14,94,a,0.06805807622504537,0.6224226804123711,,,456,1456
348,348,5,1,28,1,6,7,462,1438,74,18,67,current,0.07546884452510587,0.6215635738831615,,,536,1456
349,349,5,1,28,1,6,8,540,1438,75,21,67,"subset,",0.08734119782214156,0.6222079037800687,,,615,1459
350,350,5,1,28,1,6,9,622,1438,37,18,96,and,0.09686932849364792,0.6215635738831615,,,659,1456
351,351,5,1,28,1,6,10,664,1438,76,18,96,whether,0.10617059891107078,0.6215635738831615,,,740,1456
352,352,5,1,28,1,6,11,742,1438,65,18,96,there,0.11713551119177254,0.6215635738831615,,,807,1456
353,353,4,1,28,1,7,0,226,1470,581,23,-1,,0.07811554748941318,0.6363831615120275,,,807,1493
354,354,5,1,28,1,7,1,226,1470,14,19,96,is,0.035238959467634605,0.6355240549828178,,,240,1489
355,355,5,1,28,1,7,2,249,1475,11,14,96,a,0.038490623109497885,0.6365979381443299,,,260,1489
356,356,5,1,28,1,7,3,269,1470,105,23,96,significant,0.048623714458560195,0.6363831615120275,,,374,1493
357,357,5,1,28,1,7,4,381,1470,151,19,96,transformation,0.06904113732607381,0.6355240549828178,,,532,1489
358,358,5,1,28,1,7,5,541,1470,106,19,96,coefficient,0.08983666061705989,0.6355240549828178,,,647,1489
359,359,5,1,28,1,7,6,656,1470,67,23,96,having,0.10428009679370841,0.6363831615120275,,,723,1493
360,360,5,1,28,1,7,7,732,1475,11,14,96,a,0.11153962492437991,0.6365979381443299,,,743,1489
361,361,5,1,28,1,7,8,751,1470,56,19,96,value,0.11781609195402298,0.6355240549828178,,,807,1489
362,362,4,1,28,1,8,0,225,1503,582,23,-1,,0.0780399274047187,0.6505584192439863,,,807,1526
363,363,5,1,28,1,8,1,225,1504,66,22,96,greater,0.03901996370235935,0.6507731958762887,,,291,1526
364,364,5,1,28,1,8,2,293,1503,56,18,94,than,0.048548094373865695,0.6494845360824743,,,349,1521
365,365,5,1,28,1,8,3,0,0,1653,2328,63,a,0.125,0.5,,,1653,2328
366,366,5,1,28,1,8,4,356,1503,48,18,63,first,0.05747126436781609,0.6494845360824743,,,404,1521
367,367,5,1,28,1,8,5,406,1503,77,18,95,critical,0.06722625529340592,0.6494845360824743,,,483,1521
368,368,5,1,28,1,8,6,489,1503,56,18,96,value,0.07819116757410768,0.6494845360824743,,,545,1521
369,369,5,1,28,1,8,7,552,1503,15,18,93,in,0.08461887477313974,0.6494845360824743,,,567,1521
370,370,5,1,28,1,8,8,574,1508,12,13,93,a,0.08771929824561403,0.6505584192439863,,,586,1521
371,371,5,1,28,1,8,9,593,1503,88,23,96,previous,0.09633998790078645,0.6505584192439863,,,681,1526
372,372,5,1,28,1,8,10,687,1503,74,22,96,"subset,",0.10949788263762855,0.6503436426116839,,,761,1525
373,373,5,1,28,1,8,11,769,1503,38,18,96,and,0.1191772534785239,0.6494845360824743,,,807,1521
374,374,4,1,28,1,9,0,225,1536,582,23,-1,,0.0780399274047187,0.664733676975945,,,807,1559
375,375,5,1,28,1,9,1,225,1540,11,14,92,a,0.034860859044162126,0.6645189003436426,,,236,1554
376,376,5,1,28,1,9,2,248,1536,75,18,92,context,0.043179068360556565,0.663659793814433,,,323,1554
377,377,5,1,28,1,9,3,332,1536,59,18,92,offset,0.05467332123411978,0.663659793814433,,,391,1554
378,378,5,1,28,1,9,4,401,1536,20,18,90,c1,0.06215970961887477,0.663659793814433,,,421,1554
379,379,5,1,28,1,9,5,436,1536,14,18,96,is,0.06699939503932244,0.663659793814433,,,450,1554
380,380,5,1,28,1,9,6,461,1536,89,18,96,obtained,0.0764519056261343,0.663659793814433,,,550,1554
381,381,5,1,28,1,9,7,562,1536,62,18,96,based,0.0896854204476709,0.663659793814433,,,624,1554
382,382,5,1,28,1,9,8,635,1540,24,14,95,on,0.09785238959467635,0.6645189003436426,,,659,1554
383,383,5,1,28,1,9,9,670,1540,12,14,96,a,0.10223835450695705,0.6645189003436426,,,682,1554
384,384,5,1,28,1,9,10,693,1536,63,23,95,length,0.10957350272232305,0.664733676975945,,,756,1559
385,385,5,1,28,1,9,11,766,1536,20,18,96,of,0.11736237144585603,0.663659793814433,,,786,1554
386,386,5,1,28,1,9,12,796,1540,11,14,96,a,0.12121899576527526,0.6645189003436426,,,807,1554
387,387,4,1,28,1,10,0,226,1569,581,23,-1,,0.07811554748941318,0.6789089347079038,,,807,1592
388,388,5,1,28,1,10,1,226,1569,88,23,96,previous,0.04083484573502722,0.6789089347079038,,,314,1592
389,389,5,1,28,1,10,2,324,1569,151,18,96,transformation,0.06042044767090139,0.6778350515463918,,,475,1587
390,390,5,1,28,1,10,3,487,1569,106,18,96,coefficient,0.08166969147005444,0.6778350515463918,,,593,1587
391,391,5,1,28,1,10,4,604,1569,67,23,96,having,0.09641560798548095,0.6789089347079038,,,671,1592
392,392,5,1,28,1,10,5,683,1569,124,18,96,consecutive,0.11267392619479734,0.6778350515463918,,,807,1587
393,393,4,1,28,1,11,0,227,1602,580,23,-1,,0.07819116757410768,0.6930841924398625,,,807,1625
394,394,5,1,28,1,11,1,227,1602,27,18,95,1s.,0.03637326073805203,0.6920103092783505,,,254,1620
395,395,5,1,28,1,11,2,261,1602,51,21,96,"Also,",0.04333030852994555,0.6926546391752577,,,312,1623
396,396,5,1,28,1,11,3,320,1606,11,14,96,a,0.04922867513611615,0.6928694158075601,,,331,1620
397,397,5,1,28,1,11,4,339,1602,76,18,96,context,0.05701754385964912,0.6920103092783505,,,415,1620
398,398,5,1,28,1,11,5,422,1602,55,18,93,index,0.06798245614035088,0.6920103092783505,,,477,1620
399,399,5,1,28,1,11,6,484,1602,59,18,92,ctxids,0.07766182698124621,0.6920103092783505,,,543,1620
400,400,5,1,28,1,11,7,548,1602,28,18,95,for,0.08499697519661222,0.6920103092783505,,,576,1620
401,401,5,1,28,1,11,8,582,1602,79,23,95,entropy,0.0939957652752571,0.6930841924398625,,,661,1625
402,402,5,1,28,1,11,9,667,1602,94,23,96,encoding,0.10798548094373865,0.6930841924398625,,,761,1625
403,403,5,1,28,1,11,10,769,1602,38,18,96,and,0.1191772534785239,0.6920103092783505,,,807,1620
404,404,4,1,28,1,12,0,225,1634,582,23,-1,,0.0780399274047187,0.7068298969072165,,,807,1657
405,405,5,1,28,1,12,1,225,1634,94,23,96,decoding,0.0411373260738052,0.7068298969072165,,,319,1657
406,406,5,1,28,1,12,2,327,1639,12,14,96,of,0.050362976406533574,0.7070446735395189,,,339,1653
407,407,5,1,28,1,12,3,340,1634,24,19,78,a,0.05323653962492438,0.7059707903780069,,,364,1653
408,408,5,1,28,1,12,4,371,1634,31,19,78,first,0.05845432546884453,0.7059707903780069,,,402,1653
409,409,5,1,28,1,12,5,403,1634,78,19,96,critical,0.06684815486993345,0.7059707903780069,,,481,1653
410,410,5,1,28,1,12,6,489,1634,55,19,96,value,0.07811554748941318,0.7059707903780069,,,544,1653
411,411,5,1,28,1,12,7,550,1634,38,23,95,flag,0.08605565638233514,0.7068298969072165,,,588,1657
412,412,5,1,28,1,12,8,597,1634,14,19,95,is,0.09134906231094979,0.7059707903780069,,,611,1653
413,413,5,1,28,1,12,9,618,1634,118,19,96,determined,0.10238959467634604,0.7059707903780069,,,736,1653
414,414,5,1,28,1,12,10,744,1634,63,19,96,based,0.11728675136116153,0.7059707903780069,,,807,1653
415,415,4,1,28,1,13,0,225,1667,581,18,-1,,0.0779643073200242,0.7199312714776632,,,806,1685
416,416,5,1,28,1,13,1,225,1672,24,13,96,on,0.03584392014519056,0.7210051546391752,,,249,1685
417,417,5,1,28,1,13,2,257,1667,32,18,96,the,0.04128856624319419,0.7199312714776632,,,289,1685
418,418,5,1,28,1,13,3,296,1667,89,18,96,obtained,0.051497277676950996,0.7199312714776632,,,385,1685
419,419,5,1,28,1,13,4,394,1668,68,17,96,context,0.0647307924984876,0.7201460481099656,,,462,1685
420,420,5,1,28,1,13,5,464,1668,43,17,96,set,0.07342710223835451,0.7201460481099656,,,507,1685
421,421,5,1,28,1,13,6,515,1667,55,18,96,index,0.08204779189352691,0.7199312714776632,,,570,1685
422,422,5,1,28,1,13,7,577,1667,37,18,96,and,0.09006352087114337,0.7199312714776632,,,614,1685
423,423,5,1,28,1,13,8,622,1667,32,18,97,the,0.09649122807017543,0.7199312714776632,,,654,1685
424,424,5,1,28,1,13,9,661,1668,69,17,96,context,0.10518753781004235,0.7201460481099656,,,730,1685
425,425,5,1,28,1,13,10,731,1667,75,18,96,offset.,0.1162280701754386,0.7199312714776632,,,806,1685
426,426,2,1,29,0,0,0,1095,1304,100,19,-1,,0.17316999395039323,0.5642182130584192,,,1195,1323
427,427,3,1,29,1,0,0,1095,1304,100,19,-1,,0.17316999395039323,0.5642182130584192,,,1195,1323
428,428,4,1,29,1,1,0,1095,1304,100,19,-1,,0.17316999395039323,0.5642182130584192,,,1195,1323
429,429,5,1,29,1,1,1,1095,1304,50,19,96,FIG.,0.1693889897156685,0.5642182130584192,,,1145,1323
430,430,5,1,29,1,1,2,1165,1304,30,19,96,25,0.17846339987900786,0.5642182130584192,,,1195,1323
431,431,2,1,30,0,0,0,936,1442,417,77,-1,,0.17309437386569873,0.6359536082474226,,,1353,1519
432,432,3,1,30,1,0,0,936,1442,417,77,-1,,0.17309437386569873,0.6359536082474226,,,1353,1519
433,433,4,1,30,1,1,0,936,1442,417,14,-1,,0.17309437386569873,0.6224226804123711,,,1353,1456
434,434,5,1,30,1,1,1,936,1442,41,14,95,SPLIT,0.14466122202056866,0.6224226804123711,,,977,1456
435,435,5,1,30,1,1,2,984,1442,143,14,95,TRANSFORMATION,0.15963399879007864,0.6224226804123711,,,1127,1456
436,436,5,1,30,1,1,3,1135,1442,34,14,94,UNIT,0.17422867513611615,0.6224226804123711,,,1169,1456
437,437,5,1,30,1,1,4,1176,1442,36,14,94,INTO,0.18058076225045372,0.6224226804123711,,,1212,1456
438,438,5,1,30,1,1,5,1218,1442,71,14,96,SUBSETS,0.18957955232909862,0.6224226804123711,,,1289,1456
439,439,5,1,30,1,1,6,1296,1442,57,14,91,HAVING,0.20031760435571688,0.6224226804123711,,,1353,1456
440,440,4,1,30,1,2,0,957,1462,376,15,-1,,0.17316999395039323,0.6312285223367697,,,1333,1477
441,441,5,1,30,1,2,1,957,1462,119,15,92,PREDETERMINED,0.15373563218390804,0.6312285223367697,,,1076,1477
442,442,5,1,30,1,2,2,1078,1462,49,15,96,SIZE,0.16674228675136116,0.6312285223367697,,,1127,1477
443,443,5,1,30,1,2,3,1134,1462,32,15,96,AND,0.17392619479733817,0.6312285223367697,,,1166,1477
444,444,5,1,30,1,2,4,1173,1462,56,15,95,OBTAIN,0.18163944343617666,0.6312285223367697,,,1229,1477
445,445,5,1,30,1,2,5,1237,1462,96,15,96,SIGNIFICANT,0.19434361766485178,0.6312285223367697,,,1333,1477
446,446,4,1,30,1,3,0,942,1484,404,14,-1,,0.17301875378100423,0.6404639175257731,,,1346,1498
447,447,5,1,30,1,3,1,942,1484,143,14,96,TRANSFORMATION,0.15328191167574107,0.6404639175257731,,,1085,1498
448,448,5,1,30,1,3,2,1093,1484,102,14,96,COEFFICIENT,0.17301875378100423,0.6404639175257731,,,1195,1498
449,449,5,1,30,1,3,3,1201,1484,32,13,96,THAT,0.1840592861464005,0.6402491408934707,,,1233,1497
450,450,5,1,30,1,3,4,1233,1484,28,14,83,IS,0.18859649122807018,0.6404639175257731,,,1261,1498
451,451,5,1,30,1,3,5,1268,1484,78,14,76,INCLUDED,0.19767090139140955,0.6404639175257731,,,1346,1498
452,452,4,1,30,1,4,0,1024,1504,242,15,-1,,0.17316999395039323,0.6492697594501718,,,1266,1519
453,453,5,1,30,1,4,1,1024,1504,13,15,96,IN,0.1558529945553539,0.6492697594501718,,,1037,1519
454,454,5,1,30,1,4,2,1045,1504,42,15,96,EACH,0.16122202056866303,0.6492697594501718,,,1087,1519
455,455,5,1,30,1,4,3,1094,1504,51,15,96,SUBSET,0.169313369630974,0.6492697594501718,,,1145,1519
456,456,5,1,30,1,4,4,1146,1504,36,15,96,AND,0.17604355716878403,0.6492697594501718,,,1182,1519
457,457,5,1,30,1,4,5,1184,1504,29,15,95,IS,0.18126134301270416,0.6492697594501718,,,1213,1519
458,458,5,1,30,1,4,6,1221,1504,30,15,93,NOT,0.1869328493647913,0.6492697594501718,,,1251,1519
459,459,5,1,30,1,4,7,1257,1505,9,14,93,0,0.19078947368421054,0.6494845360824743,,,1266,1519
460,460,2,1,31,0,0,0,885,1425,541,144,-1,,0.17475801572897762,0.6430412371134021,,,1426,1569
461,461,3,1,31,1,0,0,885,1425,541,144,-1,,0.17475801572897762,0.6430412371134021,,,1426,1569
462,462,4,1,31,1,1,0,1396,1425,30,38,-1,,0.2133998790078645,0.6202749140893471,,,1426,1463
463,463,5,1,31,1,1,1,1396,1425,30,38,95,  ,0.2133998790078645,0.6202749140893471,,,1426,1463
464,464,4,1,31,1,2,0,1396,1463,30,21,-1,,0.2133998790078645,0.632946735395189,,,1426,1484
465,465,5,1,31,1,2,1,1396,1463,30,21,95, ,0.2133998790078645,0.632946735395189,,,1426,1484
466,466,4,1,31,1,3,0,885,1484,541,42,-1,,0.17475801572897762,0.6464776632302406,,,1426,1526
467,467,5,1,31,1,3,1,885,1505,139,21,95, ,0.1443587416817907,0.6509879725085911,,,1024,1526
468,468,5,1,31,1,3,2,1266,1484,160,42,95,  ,0.20356926799758016,0.6464776632302406,,,1426,1526
469,469,4,1,31,1,4,0,885,1526,522,43,-1,,0.1733212341197822,0.664733676975945,,,1407,1569
470,470,5,1,31,1,4,1,885,1526,522,43,95, ,0.1733212341197822,0.664733676975945,,,1407,1569
471,471,2,1,32,0,0,0,887,1561,515,2,-1,,0.17309437386569873,0.6709621993127147,,,1402,1563
472,472,3,1,32,1,0,0,887,1561,515,2,-1,,0.17309437386569873,0.6709621993127147,,,1402,1563
473,473,4,1,32,1,1,0,887,1561,515,2,-1,,0.17309437386569873,0.6709621993127147,,,1402,1563
474,474,5,1,32,1,1,1,887,1561,515,2,95, ,0.17309437386569873,0.6709621993127147,,,1402,1563
475,475,2,1,33,0,0,0,887,1427,2,655,-1,,0.13430127041742287,0.7536512027491409,,,889,2082
476,476,3,1,33,1,0,0,887,1427,2,655,-1,,0.13430127041742287,0.7536512027491409,,,889,2082
477,477,4,1,33,1,1,0,887,1427,2,655,-1,,0.13430127041742287,0.7536512027491409,,,889,2082
478,478,5,1,33,1,1,1,887,1427,2,655,95, ,0.13430127041742287,0.7536512027491409,,,889,2082
479,479,2,1,34,0,0,0,896,1576,496,244,-1,,0.17301875378100423,0.729381443298969,,,1392,1820
480,480,3,1,34,1,0,0,896,1576,496,244,-1,,0.17301875378100423,0.729381443298969,,,1392,1820
481,481,4,1,34,1,1,0,919,1576,451,14,-1,,0.17309437386569873,0.6799828178694158,,,1370,1590
482,482,5,1,34,1,1,1,919,1576,57,14,96,OBTAIN,0.14330006049606775,0.6799828178694158,,,976,1590
483,483,5,1,34,1,1,2,983,1576,71,14,96,CONTEXT,0.15403811252268604,0.6799828178694158,,,1054,1590
484,484,5,1,34,1,1,3,1061,1576,29,14,96,SET,0.16265880217785844,0.6799828178694158,,,1090,1590
485,485,5,1,34,1,1,4,1097,1576,45,14,96,INDEX,0.169313369630974,0.6799828178694158,,,1142,1590
486,486,5,1,34,1,1,5,1149,1576,31,14,96,FOR,0.17611917725347853,0.6799828178694158,,,1180,1590
487,487,5,1,34,1,1,6,1186,1576,105,14,96,DETERMINING,0.18731094978826376,0.6799828178694158,,,1291,1590
488,488,5,1,34,1,1,7,1299,1576,71,14,96,CONTEXT,0.20183000604960677,0.6799828178694158,,,1370,1590
489,489,4,1,34,1,2,0,934,1596,421,15,-1,,0.17309437386569873,0.6887886597938144,,,1355,1611
490,490,5,1,34,1,2,1,934,1596,29,15,96,SET,0.14345130066545675,0.6887886597938144,,,963,1611
491,491,5,1,34,1,2,2,969,1596,42,15,96,USED,0.14972776769509982,0.6887886597938144,,,1011,1611
492,492,5,1,34,1,2,3,1019,1596,13,15,96,IN,0.15509679370840895,0.6887886597938144,,,1032,1611
493,493,5,1,34,1,2,4,1039,1596,72,15,96,ENTROPY,0.16258318209316394,0.6887886597938144,,,1111,1611
494,494,5,1,34,1,2,5,1118,1596,81,15,96,ENCODING,0.1752117362371446,0.6887886597938144,,,1199,1611
495,495,5,1,34,1,2,6,1206,1596,33,15,93,AND,0.18489110707803993,0.6887886597938144,,,1239,1611
496,496,5,1,34,1,2,7,1246,1596,82,15,92,CECODING,0.19464609800362975,0.6887886597938144,,,1328,1611
497,497,5,1,34,1,2,8,1334,1596,21,15,96,OF,0.20334240774349668,0.6887886597938144,,,1355,1611
498,498,4,1,34,1,3,0,945,1618,399,14,-1,,0.17309437386569873,0.6980240549828178,,,1344,1632
499,499,5,1,34,1,3,1,945,1618,43,13,96,FIRST,0.14617362371445855,0.6978092783505154,,,988,1631
500,500,5,1,34,1,3,2,994,1618,71,13,96,CRITICAL,0.15570175438596492,0.6978092783505154,,,1065,1631
501,501,5,1,34,1,3,3,1070,1618,50,14,96,VALUE,0.16560798548094374,0.6980240549828178,,,1120,1632
502,502,5,1,34,1,3,4,1127,1618,39,14,96,FLAG,0.1733968542044767,0.6980240549828178,,,1166,1632
503,503,5,1,34,1,3,5,1174,1618,87,13,96,INDICATING,0.184134906231095,0.6978092783505154,,,1261,1631
504,504,5,1,34,1,3,6,1268,1618,76,13,95,WHETHER,0.19751966122202058,0.6978092783505154,,,1344,1631
505,505,4,1,34,1,4,0,926,1638,437,15,-1,,0.17309437386569873,0.7068298969072165,,,1363,1653
506,506,5,1,34,1,4,1,926,1638,97,15,96,SIGNIFICANT,0.14738354506957047,0.7068298969072165,,,1023,1653
507,507,5,1,34,1,4,2,1030,1638,102,15,96,COEFFICIENT,0.16349062310949788,0.7068298969072165,,,1132,1653
508,508,5,1,34,1,4,3,1139,1638,43,15,96,FROM,0.17551421657592256,0.7068298969072165,,,1182,1653
509,509,5,1,34,1,4,4,1189,1638,58,15,96,AMONG,0.18421052631578946,0.7068298969072165,,,1247,1653
510,510,5,1,34,1,4,5,1255,1638,81,15,96,PLURALITY,0.19593163944343617,0.7068298969072165,,,1336,1653
511,511,5,1,34,1,4,6,1343,1638,20,15,96,OF,0.2046279491833031,0.7068298969072165,,,1363,1653
512,512,4,1,34,1,5,0,919,1658,451,15,-1,,0.17309437386569873,0.7154209621993127,,,1370,1673
513,513,5,1,34,1,5,1,919,1658,73,15,96,CONTEXT,0.14450998185117966,0.7154209621993127,,,992,1673
514,514,5,1,34,1,5,2,998,1658,38,15,96,SETS,0.15381125226860254,0.7154209621993127,,,1036,1673
515,515,5,1,34,1,5,3,1043,1658,84,15,96,INCLUDING,0.16409558378705383,0.7154209621993127,,,1127,1673
516,516,5,1,34,1,5,4,1135,1659,83,14,96,PLURALITY,0.1779340592861464,0.7156357388316151,,,1218,1673
517,517,5,1,34,1,5,5,1224,1658,20,15,96,OF,0.18663036902601332,0.7154209621993127,,,1244,1673
518,518,5,1,34,1,5,6,1251,1658,81,15,96,CONTEXTS,0.19532667876588022,0.7154209621993127,,,1332,1673
519,519,5,1,34,1,5,7,1339,1658,31,15,96,HAS,0.20485480943738657,0.7154209621993127,,,1370,1673
520,520,4,1,34,1,6,0,918,1678,452,17,-1,,0.17301875378100423,0.7244415807560137,,,1370,1695
521,521,5,1,34,1,6,1,918,1679,51,14,96,VALUE,0.1426950998185118,0.7242268041237113,,,969,1693
522,522,5,1,34,1,6,2,975,1679,72,14,96,GREATER,0.1529038112522686,0.7242268041237113,,,1047,1693
523,523,5,1,34,1,6,3,1054,1679,41,14,96,THAN,0.16250756200846944,0.7242268041237113,,,1095,1693
524,524,5,1,34,1,6,4,1103,1679,42,14,96,FIRST,0.16999395039322443,0.7242268041237113,,,1145,1693
525,525,5,1,34,1,6,5,1152,1678,70,15,96,CRITICAL,0.1795220810647308,0.7240120274914089,,,1222,1693
526,526,5,1,34,1,6,6,1228,1679,54,16,96,"VALUE,",0.1898064125831821,0.7246563573883161,,,1282,1695
527,527,5,1,34,1,6,7,1290,1679,52,14,96,BASED,0.19903206291591047,0.7242268041237113,,,1342,1693
528,528,5,1,34,1,6,8,1348,1679,22,14,96,ON,0.205535390199637,0.7242268041237113,,,1370,1693
529,529,4,1,34,1,7,0,896,1700,496,16,-1,,0.17301875378100423,0.7336769759450171,,,1392,1716
530,530,5,1,34,1,7,1,896,1700,53,14,83,COLOR,0.139519056261343,0.7332474226804123,,,949,1714
531,531,5,1,34,1,7,2,956,1700,90,14,95,COMPONENT,0.1513914095583787,0.7332474226804123,,,1046,1714
532,532,5,1,34,1,7,3,1047,1700,121,14,96,INFORMATION,0.1674984875983061,0.7332474226804123,,,1168,1714
533,533,5,1,34,1,7,4,1175,1700,21,14,96,OF,0.1792952208106473,0.7332474226804123,,,1196,1714
534,534,5,1,34,1,7,5,1202,1700,143,14,96,TRANSFORMATION,0.1926043557168784,0.7332474226804123,,,1345,1714
535,535,5,1,34,1,7,6,1353,1700,39,16,81,UNIT.,0.20757713248638837,0.7336769759450171,,,1392,1716
536,536,4,1,34,1,8,0,917,1722,456,14,-1,,0.17316999395039323,0.7426975945017182,,,1373,1736
537,537,5,1,34,1,8,1,917,1722,77,14,90,LOCATION,0.14450998185117966,0.7426975945017182,,,994,1736
538,538,5,1,34,1,8,2,1001,1722,21,14,96,OF,0.1529794313369631,0.7426975945017182,,,1022,1736
539,539,5,1,34,1,8,3,1029,1722,42,14,96,FIRST,0.1588021778584392,0.7426975945017182,,,1071,1736
540,540,5,1,34,1,8,4,1078,1722,61,14,97,SUBSET,0.1676497277676951,0.7426975945017182,,,1139,1736
541,541,5,1,34,1,8,5,1145,1722,40,14,96,THAT,0.17619479733817303,0.7426975945017182,,,1185,1736
542,542,5,1,34,1,8,6,1193,1722,76,14,96,INCLUDES,0.18617664851784635,0.7426975945017182,,,1269,1736
543,543,5,1,34,1,8,7,1276,1722,97,14,95,SIGNIFICANT,0.20031760435571688,0.7426975945017182,,,1373,1736
544,544,4,1,34,1,9,0,940,1742,410,16,-1,,0.17316999395039323,0.7517182130584192,,,1350,1758
545,545,5,1,34,1,9,1,940,1742,106,16,96,"COEFFICIENT,",0.1501814882032668,0.7517182130584192,,,1046,1758
546,546,5,1,34,1,9,2,1054,1742,33,13,96,AND,0.1619026013309135,0.751073883161512,,,1087,1755
547,547,5,1,34,1,9,3,1093,1742,76,13,96,WHETHER,0.17105263157894737,0.751073883161512,,,1169,1755
548,548,5,1,34,1,9,4,1176,1742,41,13,95,THERE,0.1809588626739262,0.751073883161512,,,1217,1755
549,549,5,1,34,1,9,5,1219,1742,28,14,83,IS,0.18647912885662432,0.7512886597938144,,,1247,1756
550,550,5,1,34,1,9,6,1253,1742,97,14,87,SIGNIFICANT,0.1968390804597701,0.7512886597938144,,,1350,1756
551,551,4,1,34,1,10,0,954,1764,380,14,-1,,0.17301875378100423,0.7607388316151202,,,1334,1778
552,552,5,1,34,1,10,1,954,1764,144,14,96,TRANSFORMATION,0.15517241379310345,0.7607388316151202,,,1098,1778
553,553,5,1,34,1,10,2,1105,1764,103,14,96,COEFFICIENT,0.17490925589836662,0.7607388316151202,,,1208,1778
554,554,5,1,34,1,10,3,1214,1764,72,14,96,GREATER,0.18905021173623715,0.7607388316151202,,,1286,1778
555,555,5,1,34,1,10,4,1292,1764,42,14,96,THAN,0.1985783424077435,0.7607388316151202,,,1334,1778
556,556,4,1,34,1,11,0,942,1785,405,15,-1,,0.17309437386569873,0.7699742268041238,,,1347,1800
557,557,5,1,34,1,11,1,942,1785,120,14,92,PREDETERMINED,0.1515426497277677,0.7697594501718213,,,1062,1799
558,558,5,1,34,1,11,2,1064,1785,59,15,96,FIRST,0.16538112522686024,0.7699742268041238,,,1123,1800
559,559,5,1,34,1,11,3,1130,1785,69,15,96,CRITICAL,0.17611917725347853,0.7699742268041238,,,1199,1800
560,560,5,1,34,1,11,4,1205,1785,51,15,96,VALUE,0.18610102843315185,0.7699742268041238,,,1256,1800
561,561,5,1,34,1,11,5,1262,1785,13,14,96,IN,0.19184815486993345,0.7697594501718213,,,1275,1799
562,562,5,1,34,1,11,6,1282,1785,65,15,95,SECOND,0.19880520266182697,0.7699742268041238,,,1347,1800
563,563,4,1,34,1,12,0,937,1805,415,15,-1,,0.17309437386569873,0.7785652920962199,,,1352,1820
564,564,5,1,34,1,12,1,937,1805,61,15,96,SUBSET,0.14632486388384755,0.7785652920962199,,,998,1820
565,565,5,1,34,1,12,2,1005,1806,39,14,96,THAT,0.15494555353901995,0.7787800687285223,,,1044,1820
566,566,5,1,34,1,12,3,1052,1805,12,15,90,|S,0.1600120992135511,0.7785652920962199,,,1064,1820
567,567,5,1,34,1,12,4,1072,1805,94,15,96,PROCESSED,0.1692377495462795,0.7785652920962199,,,1166,1820
568,568,5,1,34,1,12,5,1174,1805,52,15,96,BEFORE,0.18148820326678766,0.7785652920962199,,,1226,1820
569,569,5,1,34,1,12,6,1227,1805,58,15,96,FIRST,0.1899576527525711,0.7785652920962199,,,1285,1820
570,570,5,1,34,1,12,7,1291,1805,61,15,96,SUBSET,0.1998638838475499,0.7785652920962199,,,1352,1820
571,571,2,1,35,0,0,0,884,1569,541,581,-1,,0.17460677555958862,0.7987542955326461,,,1425,2150
572,572,3,1,35,1,0,0,884,1569,541,581,-1,,0.17460677555958862,0.7987542955326461,,,1425,2150
573,573,4,1,35,1,1,0,1396,1569,11,28,-1,,0.2119630973986691,0.6799828178694158,,,1407,1597
574,574,5,1,35,1,1,1,1396,1569,11,28,95, ,0.2119630973986691,0.6799828178694158,,,1407,1597
575,575,4,1,35,1,2,0,1396,1597,11,42,-1,,0.2119630973986691,0.6950171821305842,,,1407,1639
576,576,5,1,35,1,2,1,1396,1597,11,42,95,  ,0.2119630973986691,0.6950171821305842,,,1407,1639
577,577,4,1,35,1,3,0,1396,1639,11,21,-1,,0.2119630973986691,0.7085481099656358,,,1407,1660
578,578,5,1,35,1,3,1,1396,1639,11,21,95, ,0.2119630973986691,0.7085481099656358,,,1407,1660
579,579,4,1,35,1,4,0,1396,1660,29,20,-1,,0.21332425892317,0.7173539518900344,,,1425,1680
580,580,5,1,35,1,4,1,1396,1660,29,20,95, ,0.21332425892317,0.7173539518900344,,,1425,1680
581,581,4,1,35,1,5,0,1396,1680,29,23,-1,,0.21332425892317,0.7265893470790378,,,1425,1703
582,582,5,1,35,1,5,1,1396,1680,29,23,95, ,0.21332425892317,0.7265893470790378,,,1425,1703
583,583,4,1,35,1,6,0,1396,1703,29,40,-1,,0.21332425892317,0.7401202749140894,,,1425,1743
584,584,5,1,35,1,6,1,1396,1703,29,40,95,  ,0.21332425892317,0.7401202749140894,,,1425,1743
585,585,4,1,35,1,7,0,1396,1743,11,23,-1,,0.2119630973986691,0.7536512027491409,,,1407,1766
586,586,5,1,35,1,7,1,1396,1743,11,23,95, ,0.2119630973986691,0.7536512027491409,,,1407,1766
587,587,4,1,35,1,8,0,1396,1766,11,19,-1,,0.2119630973986691,0.7626718213058419,,,1407,1785
588,588,5,1,35,1,8,1,1396,1766,11,19,95, ,0.2119630973986691,0.7626718213058419,,,1407,1785
589,589,4,1,35,1,9,0,884,1785,523,85,-1,,0.17324561403508773,0.7850085910652921,,,1407,1870
590,590,5,1,35,1,9,1,884,1785,523,85,95,    ,0.17324561403508773,0.7850085910652921,,,1407,1870
591,591,4,1,35,1,10,0,884,1870,541,29,-1,,0.17460677555958862,0.8094931271477663,,,1425,1899
592,592,5,1,35,1,10,1,884,1870,52,21,95, ,0.13762855414398065,0.8077749140893471,,,936,1891
593,593,5,1,35,1,10,2,1354,1870,71,29,95,  ,0.2101482153660012,0.8094931271477663,,,1425,1899
594,594,4,1,35,1,11,0,1396,1899,29,42,-1,,0.21332425892317,0.8247422680412371,,,1425,1941
595,595,5,1,35,1,11,1,1396,1899,29,42,95,   ,0.21332425892317,0.8247422680412371,,,1425,1941
596,596,4,1,35,1,12,0,884,1941,523,63,-1,,0.17324561403508773,0.8472938144329897,,,1407,2004
597,597,5,1,35,1,12,1,884,1941,523,63,95,   ,0.17324561403508773,0.8472938144329897,,,1407,2004
598,598,4,1,35,1,13,0,884,2004,45,21,-1,,0.13709921355111918,0.8653350515463918,,,929,2025
599,599,5,1,35,1,13,1,884,2004,45,21,95, ,0.13709921355111918,0.8653350515463918,,,929,2025
600,600,4,1,35,1,14,0,884,2054,541,96,-1,,0.17460677555958862,0.9029209621993127,,,1425,2150
601,601,5,1,35,1,14,1,884,2054,541,96,95,   ,0.17460677555958862,0.9029209621993127,,,1425,2150
602,602,2,1,36,0,0,0,1426,1691,36,14,-1,,0.21839080459770116,0.729381443298969,,,1462,1705
603,603,3,1,36,1,0,0,1426,1691,36,14,-1,,0.21839080459770116,0.729381443298969,,,1462,1705
604,604,4,1,36,1,1,0,1426,1691,36,14,-1,,0.21839080459770116,0.729381443298969,,,1462,1705
605,605,5,1,36,1,1,1,1426,1691,36,14,95,2520,0.21839080459770116,0.729381443298969,,,1462,1705
606,606,2,1,37,0,0,0,891,1877,507,77,-1,,0.17309437386569873,0.8228092783505154,,,1398,1954
607,607,3,1,37,1,0,0,901,1877,487,57,-1,,0.17309437386569873,0.8185137457044673,,,1388,1934
608,608,4,1,37,1,1,0,936,1877,418,15,-1,,0.17316999395039323,0.8094931271477663,,,1354,1892
609,609,5,1,37,1,1,1,936,1877,56,15,96,OBTAIN,0.14579552329098608,0.8094931271477663,,,992,1892
610,610,5,1,37,1,1,2,999,1877,72,15,96,CONTEXT,0.15653357531760437,0.8094931271477663,,,1071,1892
611,611,5,1,37,1,1,3,1078,1877,60,15,96,OFFSET,0.1675741076830006,0.8094931271477663,,,1138,1892
612,612,5,1,37,1,1,4,1145,1877,30,15,96,FOR,0.17543859649122806,0.8094931271477663,,,1175,1892
613,613,5,1,37,1,1,5,1182,1877,105,15,96,DETERMINING,0.1867059891107078,0.8094931271477663,,,1287,1892
614,614,5,1,37,1,1,6,1294,1877,32,15,96,ONE,0.19812462189957653,0.8094931271477663,,,1326,1892
615,615,5,1,37,1,1,7,1333,1877,21,15,96,OF,0.20319116757410768,0.8094931271477663,,,1354,1892
616,616,4,1,37,1,2,0,901,1898,487,14,-1,,0.17309437386569873,0.8182989690721649,,,1388,1912
617,617,5,1,37,1,2,1,901,1898,83,14,96,PLURALITY,0.1425438596491228,0.8182989690721649,,,984,1912
618,618,5,1,37,1,2,2,990,1898,20,14,96,OF,0.1512401693889897,0.8182989690721649,,,1010,1912
619,619,5,1,37,1,2,3,1017,1898,82,14,96,CONTEXTS,0.1600120992135511,0.8182989690721649,,,1099,1912
620,620,5,1,37,1,2,4,1106,1898,79,14,96,INCLUDED,0.17324561403508773,0.8182989690721649,,,1185,1912
621,621,5,1,37,1,2,5,1192,1898,13,14,96,IN,0.18126134301270416,0.8182989690721649,,,1205,1912
622,622,5,1,37,1,2,6,1212,1898,72,14,96,CONTEXT,0.18874773139745918,0.8182989690721649,,,1284,1912
623,623,5,1,37,1,2,7,1290,1898,29,14,96,SET,0.19729280096793708,0.8182989690721649,,,1319,1912
624,624,5,1,37,1,2,8,1326,1898,42,14,96,USED,0.20372050816696916,0.8182989690721649,,,1368,1912
625,625,5,1,37,1,2,9,1375,1898,13,14,91,IN,0.20893829401088929,0.8182989690721649,,,1388,1912
626,626,4,1,37,1,3,0,901,1919,487,15,-1,,0.17309437386569873,0.8275343642611683,,,1388,1934
627,627,5,1,37,1,3,1,901,1919,73,15,96,ENTROPY,0.14178765880217786,0.8275343642611683,,,974,1934
628,628,5,1,37,1,3,2,980,1919,82,15,96,ENCODING,0.1544162129461585,0.8275343642611683,,,1062,1934
629,629,5,1,37,1,3,3,1069,1919,21,15,96,OR,0.16326376285541438,0.8275343642611683,,,1090,1934
630,630,5,1,37,1,3,4,1098,1919,82,15,96,DECODING,0.1722625529340593,0.8275343642611683,,,1180,1934
631,631,5,1,37,1,3,5,1187,1919,20,15,96,OF,0.1810344827586207,0.8275343642611683,,,1207,1934
632,632,5,1,37,1,3,6,1214,1919,42,15,96,FIRST,0.1867816091954023,0.8275343642611683,,,1256,1934
633,633,5,1,37,1,3,7,1263,1919,70,15,96,CRITICAL,0.19630973986690864,0.8275343642611683,,,1333,1934
634,634,5,1,37,1,3,8,1338,1919,50,15,87,VALUE,0.20614035087719298,0.8275343642611683,,,1388,1934
635,635,3,1,37,2,0,0,891,1939,507,15,-1,,0.17309437386569873,0.8361254295532646,,,1398,1954
636,636,4,1,37,2,1,0,891,1939,507,15,-1,,0.17309437386569873,0.8361254295532646,,,1398,1954
637,637,5,1,37,2,1,1,891,1940,13,14,89,IN,0.13573805202661826,0.836340206185567,,,904,1954
638,638,5,1,37,2,1,2,911,1939,65,15,96,SECOND,0.1426950998185118,0.8361254295532646,,,976,1954
639,639,5,1,37,2,1,3,984,1939,60,15,96,SUBSET,0.15335753176043557,0.8361254295532646,,,1044,1954
640,640,5,1,37,2,1,4,1050,1940,32,14,96,THAT,0.16122202056866303,0.836340206185567,,,1082,1954
641,641,5,1,37,2,1,5,1082,1939,29,15,96,IS,0.16583484573502721,0.8361254295532646,,,1111,1954
642,642,5,1,37,2,1,6,1118,1939,95,15,96,PROCESSED,0.1762704174228675,0.8361254295532646,,,1213,1954
643,643,5,1,37,2,1,7,1220,1939,61,15,96,BEFORE,0.18912583182093165,0.8361254295532646,,,1281,1954
644,644,5,1,37,2,1,8,1288,1939,43,15,96,FIRST,0.19804900181488203,0.8361254295532646,,,1331,1954
645,645,5,1,37,2,1,9,1337,1939,61,15,17,"SUBSET,",0.20682093163944343,0.8361254295532646,,,1398,1954
646,646,2,1,38,0,0,0,1426,1909,36,14,-1,,0.21839080459770116,0.8230240549828178,,,1462,1923
647,647,3,1,38,1,0,0,1426,1909,36,14,-1,,0.21839080459770116,0.8230240549828178,,,1462,1923
648,648,4,1,38,1,1,0,1426,1909,36,14,-1,,0.21839080459770116,0.8230240549828178,,,1462,1923
649,649,5,1,38,1,1,1,1426,1909,36,14,96,2530,0.21839080459770116,0.8230240549828178,,,1462,1923
650,650,2,1,39,0,0,0,1360,2004,65,50,-1,,0.21060193587416817,0.8715635738831615,,,1425,2054
651,651,3,1,39,1,0,0,1360,2004,65,50,-1,,0.21060193587416817,0.8715635738831615,,,1425,2054
652,652,4,1,39,1,1,0,1360,2004,65,29,-1,,0.21060193587416817,0.867053264604811,,,1425,2033
653,653,5,1,39,1,1,1,1360,2004,65,29,95,  ,0.21060193587416817,0.867053264604811,,,1425,2033
654,654,4,1,39,1,2,0,1396,2033,29,21,-1,,0.21332425892317,0.8777920962199313,,,1425,2054
655,655,5,1,39,1,2,1,1396,2033,29,21,95, ,0.21332425892317,0.8777920962199313,,,1425,2054
656,656,2,1,40,0,0,0,896,2011,498,57,-1,,0.17316999395039323,0.876073883161512,,,1394,2068
657,657,3,1,40,1,0,0,896,2011,498,57,-1,,0.17316999395039323,0.876073883161512,,,1394,2068
658,658,4,1,40,1,1,0,929,2011,431,15,-1,,0.17309437386569873,0.867053264604811,,,1360,2026
659,659,5,1,40,1,1,1,929,2011,57,15,96,OBTAIN,0.14481246218995766,0.867053264604811,,,986,2026
660,660,5,1,40,1,1,2,993,2011,72,15,96,CONTEXT,0.15562613430127042,0.867053264604811,,,1065,2026
661,661,5,1,40,1,1,3,1072,2011,45,14,96,INDEX,0.16553236539624924,0.8668384879725086,,,1117,2025
662,662,5,1,40,1,1,4,1124,2011,88,15,93,INDICATING,0.17664851784633998,0.867053264604811,,,1212,2026
663,663,5,1,40,1,1,5,1219,2011,72,15,0,CON‚ÄùEXT,0.1898064125831821,0.867053264604811,,,1291,2026
664,664,5,1,40,1,1,6,1298,2011,30,15,96,USED,0.1985783424077435,0.867053264604811,,,1328,2026
665,665,5,1,40,1,1,7,1330,2011,30,14,95,IN,0.20341802782819116,0.8668384879725086,,,1360,2025
666,666,4,1,40,1,2,0,896,2032,498,15,-1,,0.17316999395039323,0.876073883161512,,,1394,2047
667,667,5,1,40,1,2,1,896,2032,72,15,96,ENTROPY,0.14095583787053842,0.876073883161512,,,968,2047
668,668,5,1,40,1,2,2,975,2032,82,15,96,ENCODING,0.15366001209921354,0.876073883161512,,,1057,2047
669,669,5,1,40,1,2,3,1063,2033,32,13,96,AND,0.1631881427707199,0.876073883161512,,,1095,2046
670,670,5,1,40,1,2,4,1103,2032,82,15,95,DECODING,0.17301875378100423,0.876073883161512,,,1185,2047
671,671,5,1,40,1,2,5,1192,2032,20,15,96,OF,0.18179068360556563,0.876073883161512,,,1212,2047
672,672,5,1,40,1,2,6,1219,2032,42,15,82,FIRS‚Äù,0.18753781004234724,0.876073883161512,,,1261,2047
673,673,5,1,40,1,2,7,1268,2032,70,15,95,CRITICAL,0.1970659407138536,0.876073883161512,,,1338,2047
674,674,5,1,40,1,2,8,1344,2033,50,14,79,VALUE,0.20704779189352693,0.8762886597938144,,,1394,2047
675,675,4,1,40,1,3,0,911,2053,469,15,-1,,0.17324561403508773,0.885094501718213,,,1380,2068
676,676,5,1,40,1,3,1,911,2053,38,15,96,FLAG,0.14065335753176045,0.885094501718213,,,949,2068
677,677,5,1,40,1,3,2,957,2053,19,14,96,BY,0.14617362371445855,0.8848797250859106,,,976,2067
678,678,5,1,40,1,3,3,983,2053,47,15,96,USING,0.15222323049001815,0.885094501718213,,,1030,2068
679,679,5,1,40,1,3,4,1037,2053,72,15,96,CONTEXT,0.16228070175438597,0.885094501718213,,,1109,2068
680,680,5,1,40,1,3,5,1116,2053,28,15,96,SET,0.17090139140955837,0.885094501718213,,,1144,2068
681,681,5,1,40,1,3,6,1151,2053,45,14,96,INDEX,0.17748033877797942,0.8848797250859106,,,1196,2067
682,682,5,1,40,1,3,7,1202,2053,33,14,96,AND,0.18428614640048396,0.8848797250859106,,,1235,2067
683,683,5,1,40,1,3,8,1242,2053,71,15,96,CONTEXT,0.19320931639443437,0.885094501718213,,,1313,2068
684,684,5,1,40,1,3,9,1320,2053,60,15,96,OFFSET,0.20417422867513613,0.885094501718213,,,1380,2068
685,685,2,1,41,0,0,0,1426,2033,36,13,-1,,0.21839080459770116,0.876073883161512,,,1462,2046
686,686,3,1,41,1,0,0,1426,2033,36,13,-1,,0.21839080459770116,0.876073883161512,,,1462,2046
687,687,4,1,41,1,1,0,1426,2033,36,13,-1,,0.21839080459770116,0.876073883161512,,,1462,2046
688,688,5,1,41,1,1,1,1426,2033,36,13,96,2540,0.21839080459770116,0.876073883161512,,,1462,2046
689,689,2,1,42,0,0,0,716,2270,259,16,-1,,0.1278735632183908,0.9785223367697594,,,975,2286
690,690,3,1,42,1,0,0,716,2270,259,16,-1,,0.1278735632183908,0.9785223367697594,,,975,2286
691,691,4,1,42,1,1,0,716,2270,259,16,-1,,0.1278735632183908,0.9785223367697594,,,975,2286
692,692,5,1,42,1,1,1,716,2270,49,12,96,Printed,0.11199334543254688,0.9776632302405498,,,765,2282
693,693,5,1,42,1,1,2,771,2270,15,16,96,by,0.1177404718693285,0.9785223367697594,,,786,2286
694,694,5,1,42,1,1,3,792,2270,45,14,96,"Jouve,",0.12318511796733213,0.9780927835051546,,,837,2284
695,695,5,1,42,1,1,4,843,2270,41,12,96,75001,0.13059588626739263,0.9776632302405498,,,884,2282
696,696,5,1,42,1,1,5,893,2270,46,12,96,PARIS,0.1385359951603146,0.9776632302405498,,,939,2282
697,697,5,1,42,1,1,6,945,2270,30,16,95,(FR),0.14519056261343014,0.9785223367697594,,,975,2286
