,Unnamed: 0,level,page_num,block_num,par_num,line_num,word_num,left,top,width,height,conf,text,x,y,label,target,right,bottom
0,0,1,1,0,0,0,0,0,0,1653,2328,-1,,0.125,0.5,,,1653,2328
1,1,2,1,1,0,0,0,144,1900,31,333,-1,,0.02412280701754386,0.8876718213058419,,,175,2233
2,2,3,1,1,1,0,0,144,1900,31,333,-1,,0.02412280701754386,0.8876718213058419,,,175,2233
3,3,4,1,1,1,1,0,144,1900,31,333,-1,,0.02412280701754386,0.8876718213058419,,,175,2233
4,4,5,1,1,1,1,1,144,2179,30,54,96,EP,0.024047186932849365,0.947594501718213,,,174,2233
5,5,5,1,1,1,1,2,144,2142,31,21,95,3,0.02412280701754386,0.9246134020618557,,,175,2163
6,6,5,1,1,1,1,3,144,2055,31,71,95,375,0.02412280701754386,0.8979810996563574,,,175,2126
7,7,5,1,1,1,1,4,144,1969,31,71,93,930,0.02412280701754386,0.8610395189003437,,,175,2040
8,8,5,1,1,1,1,5,144,1900,30,55,92,A2,0.024047186932849365,0.8279639175257731,,,174,1955
9,9,2,1,2,0,0,0,429,153,88,28,-1,,0.07153660012099214,0.07173539518900343,,,517,181
10,10,3,1,2,1,0,0,429,153,88,28,-1,,0.07153660012099214,0.07173539518900343,,,517,181
11,11,4,1,2,1,1,0,429,153,88,16,-1,,0.07153660012099214,0.06915807560137457,,,517,169
12,12,5,1,2,1,1,1,429,153,88,16,84,Europaisches,0.07153660012099214,0.06915807560137457,,,517,169
13,13,4,1,2,1,2,0,429,170,71,11,-1,,0.07025105868118572,0.07538659793814433,,,500,181
14,14,5,1,2,1,2,1,429,170,71,11,96,Patentamt,0.07025105868118572,0.07538659793814433,,,500,181
15,15,2,1,3,0,0,0,429,196,89,28,-1,,0.07161222020568662,0.09020618556701031,,,518,224
16,16,3,1,3,1,0,0,429,196,89,28,-1,,0.07161222020568662,0.09020618556701031,,,518,224
17,17,4,1,3,1,1,0,429,196,63,15,-1,,0.06964609800362977,0.08741408934707903,,,492,211
18,18,5,1,3,1,1,1,429,196,63,15,95,European,0.06964609800362977,0.08741408934707903,,,492,211
19,19,4,1,3,1,2,0,429,212,89,12,-1,,0.07161222020568662,0.0936426116838488,,,518,224
20,20,5,1,3,1,2,1,429,213,43,11,96,Patent,0.06813369630973987,0.0938573883161512,,,472,224
21,21,5,1,3,1,2,2,478,212,40,12,90,Office,0.07531760435571688,0.0936426116838488,,,518,224
22,22,2,1,4,0,0,0,429,239,109,28,-1,,0.07312462189957653,0.10867697594501718,,,538,267
23,23,3,1,4,1,0,0,429,239,109,28,-1,,0.07312462189957653,0.10867697594501718,,,538,267
24,24,4,1,4,1,1,0,429,239,109,15,-1,,0.07312462189957653,0.10588487972508591,,,538,254
25,25,5,1,4,1,1,1,429,239,40,12,93,Office,0.06790683605565638,0.1052405498281787,,,469,251
26,26,5,1,4,1,1,2,474,239,64,15,93,europ√©en,0.0765275257108288,0.10588487972508591,,,538,254
27,27,4,1,4,1,2,0,429,255,77,12,-1,,0.0707047791893527,0.11211340206185567,,,506,267
28,28,5,1,4,1,2,1,429,255,22,12,95,des,0.06654567453115548,0.11211340206185567,,,451,267
29,29,5,1,4,1,2,2,457,255,49,12,82,brevets,0.07282214156079855,0.11211340206185567,,,506,267
30,30,2,1,5,0,0,0,281,136,274,150,-1,,0.06321839080459771,0.09063573883161512,,,555,286
31,31,3,1,5,1,0,0,281,136,274,150,-1,,0.06321839080459771,0.09063573883161512,,,555,286
32,32,4,1,5,1,1,0,281,136,274,150,-1,,0.06321839080459771,0.09063573883161512,,,555,286
33,33,5,1,5,1,1,1,281,136,274,150,95, ,0.06321839080459771,0.09063573883161512,,,555,286
34,34,2,1,6,0,0,0,225,324,45,26,-1,,0.037431941923774956,0.14475945017182132,,,270,350
35,35,3,1,6,1,0,0,225,324,45,26,-1,,0.037431941923774956,0.14475945017182132,,,270,350
36,36,4,1,6,1,1,0,225,324,45,26,-1,,0.037431941923774956,0.14475945017182132,,,270,350
37,37,5,1,6,1,1,1,225,324,45,26,96,(12),0.037431941923774956,0.14475945017182132,,,270,350
38,38,2,1,7,0,0,0,225,395,415,53,-1,,0.06541137326073805,0.18105670103092783,,,640,448
39,39,3,1,7,1,0,0,225,395,415,53,-1,,0.06541137326073805,0.18105670103092783,,,640,448
40,40,4,1,7,1,1,0,225,395,282,26,-1,,0.05535390199637023,0.17525773195876287,,,507,421
41,41,5,1,7,1,1,1,225,395,45,26,92,(43),0.037431941923774956,0.17525773195876287,,,270,421
42,42,5,1,7,1,1,2,285,397,222,23,90,Verdffentlichungstag:,0.05989110707803993,0.17547250859106528,,,507,420
43,43,4,1,7,1,2,0,287,430,353,18,-1,,0.07009981851179674,0.18857388316151202,,,640,448
44,44,5,1,7,1,2,1,287,430,116,18,92,19.09.2018,0.052177858439201454,0.18857388316151202,publication_date,19.09.2018,403,448
45,45,5,1,7,1,2,2,426,430,121,18,92,Patentblatt,0.0735783424077435,0.18857388316151202,,,547,448
46,46,5,1,7,1,2,3,555,430,85,18,95,2018/38,0.09036600120992136,0.18857388316151202,,,640,448
47,47,2,1,8,0,0,0,225,493,379,26,-1,,0.06268905021173624,0.21735395189003437,,,604,519
48,48,3,1,8,1,0,0,225,493,379,26,-1,,0.06268905021173624,0.21735395189003437,,,604,519
49,49,4,1,8,1,1,0,225,493,379,26,-1,,0.06268905021173624,0.21735395189003437,,,604,519
50,50,5,1,8,1,1,1,225,493,45,26,91,(21),0.037431941923774956,0.21735395189003437,,,270,519
51,51,5,1,8,1,1,2,285,495,186,18,91,Anmeldenummer:,0.05716878402903811,0.21649484536082475,,,471,513
52,52,5,1,8,1,1,3,481,495,123,18,92,18155788.5,0.08204779189352691,0.21649484536082475,application_number,18155788.5,604,513
53,53,2,1,9,0,0,0,225,559,319,26,-1,,0.05815184513006655,0.24570446735395188,,,544,585
54,54,3,1,9,1,0,0,225,559,319,26,-1,,0.05815184513006655,0.24570446735395188,,,544,585
55,55,4,1,9,1,1,0,225,559,319,26,-1,,0.05815184513006655,0.24570446735395188,,,544,585
56,56,5,1,9,1,1,1,225,559,45,26,93,(22),0.037431941923774956,0.24570446735395188,,,270,585
57,57,5,1,9,1,1,2,285,561,131,23,92,Anmeldetag:,0.0530096793708409,0.24591924398625428,,,416,584
58,58,5,1,9,1,1,3,426,561,118,18,96,08.02.2018,0.07335148215366001,0.24484536082474226,filing_date,08.02.2018,544,579
59,59,2,1,10,0,0,0,1002,245,463,38,-1,,0.18655474894131882,0.1134020618556701,,,1465,283
60,60,3,1,10,1,0,0,1002,245,463,38,-1,,0.18655474894131882,0.1134020618556701,,,1465,283
61,61,4,1,10,1,1,0,1002,245,463,38,-1,,0.18655474894131882,0.1134020618556701,,,1465,283
62,62,5,1,10,1,1,1,1002,256,44,27,74,(11),0.15486993345432548,0.11576460481099657,,,1046,283
63,63,5,1,10,1,1,2,1146,245,52,32,95,EP,0.17725347852389595,0.11211340206185567,number,EP,1198,277
64,64,5,1,10,1,1,3,1214,245,20,32,94,3,0.1851179673321234,0.11211340206185567,number,3,1234,277
65,65,5,1,10,1,1,4,1249,245,68,32,94,375,0.1940411373260738,0.11211340206185567,number,375,1317,277
66,66,5,1,10,1,1,5,1331,245,67,32,89,930,0.20636721113127646,0.11211340206185567,number,930,1398,277
67,67,5,1,10,1,1,6,1413,245,52,32,89,A2,0.2176346037507562,0.11211340206185567,number,A2,1465,277
68,68,2,1,11,0,0,0,559,314,573,31,-1,,0.1278735632183908,0.14153780068728522,,,1132,345
69,69,3,1,11,1,0,0,559,314,573,31,-1,,0.1278735632183908,0.14153780068728522,,,1132,345
70,70,4,1,11,1,1,0,559,314,573,31,-1,,0.1278735632183908,0.14153780068728522,,,1132,345
71,71,5,1,11,1,1,1,559,314,230,31,92,EUROPAISCHE,0.10193587416817906,0.14153780068728522,,,789,345
72,72,5,1,11,1,1,2,802,319,330,26,91,PATENTANMELDUNG,0.14624924379915305,0.14261168384879724,,,1132,345
73,73,2,1,12,0,0,0,862,395,256,51,-1,,0.14972776769509982,0.18062714776632302,,,1118,446
74,74,3,1,12,1,0,0,862,395,256,51,-1,,0.14972776769509982,0.18062714776632302,,,1118,446
75,75,4,1,12,1,1,0,862,395,126,26,-1,,0.13989715668481548,0.17525773195876287,,,988,421
76,76,5,1,12,1,1,1,862,395,44,26,67,(51),0.1336963097398669,0.17525773195876287,,,906,421
77,77,5,1,12,1,1,2,923,397,25,18,93,Int,0.1414851784633999,0.17439862542955326,,,948,415
78,78,5,1,12,1,1,3,955,397,33,18,65,Cl:,0.14692982456140352,0.17439862542955326,,,988,415
79,79,4,1,12,1,2,0,922,425,196,21,-1,,0.1542649727767695,0.1870704467353952,,,1118,446
80,80,5,1,12,1,2,1,922,428,59,18,44,DO6F,0.14390502117362372,0.1877147766323024,class_international,D06F,981,446
81,81,5,1,12,1,2,2,987,428,46,18,96,58/28,0.15275257108287962,0.1877147766323024,class_international,58/28,1033,446
82,82,5,1,12,1,2,3,1034,425,84,21,90,(2006.07),0.16273442226255294,0.1870704467353952,,,1118,446
83,83,2,1,13,0,0,0,224,613,1243,4,-1,,0.1278735632183908,0.26417525773195877,,,1467,617
84,84,3,1,13,1,0,0,224,613,1243,4,-1,,0.1278735632183908,0.26417525773195877,,,1467,617
85,85,4,1,13,1,1,0,224,613,1243,4,-1,,0.1278735632183908,0.26417525773195877,,,1467,617
86,86,5,1,13,1,1,1,224,613,1243,4,95, ,0.1278735632183908,0.26417525773195877,,,1467,617
87,87,2,1,14,0,0,0,225,631,599,250,-1,,0.07932546884452511,0.3247422680412371,,,824,881
88,88,3,1,14,1,0,0,225,631,599,250,-1,,0.07932546884452511,0.3247422680412371,,,824,881
89,89,4,1,14,1,1,0,225,631,342,27,-1,,0.05989110707803993,0.2768470790378007,,,567,658
90,90,5,1,14,1,1,1,225,631,45,27,93,(84),0.037431941923774956,0.2768470790378007,,,270,658
91,91,5,1,14,1,1,2,286,633,100,19,93,Benannte,0.050816696914700546,0.2759879725085911,,,386,652
92,92,5,1,14,1,1,3,393,633,174,23,92,Vertragsstaaten:,0.07259528130671507,0.2768470790378007,,,567,656
93,93,4,1,14,1,2,0,285,666,537,18,-1,,0.08371143375680581,0.28994845360824745,,,822,684
94,94,5,1,14,1,2,1,285,666,31,18,94,AL,0.04544767090139141,0.28994845360824745,,,316,684
95,95,5,1,14,1,2,2,323,666,31,18,94,AT,0.05119479733817302,0.28994845360824745,,,354,684
96,96,5,1,14,1,2,3,363,666,30,18,95,BE,0.05716878402903811,0.28994845360824745,,,393,684
97,97,5,1,14,1,2,4,403,666,32,18,95,BG,0.0633696309739867,0.28994845360824745,,,435,684
98,98,5,1,14,1,2,5,445,666,31,18,95,CH,0.06964609800362977,0.28994845360824745,,,476,684
99,99,5,1,14,1,2,6,486,666,32,18,96,CY,0.07592256503327284,0.28994845360824745,,,518,684
100,100,5,1,14,1,2,7,526,666,30,18,96,CZ,0.08182093163944344,0.28994845360824745,,,556,684
101,101,5,1,14,1,2,8,565,666,30,18,96,DE,0.08771929824561403,0.28994845360824745,,,595,684
102,102,5,1,14,1,2,9,605,666,32,18,93,DK,0.09392014519056262,0.28994845360824745,,,637,684
103,103,5,1,14,1,2,10,646,666,29,18,93,EE,0.0998941318814277,0.28994845360824745,,,675,684
104,104,5,1,14,1,2,11,684,666,29,18,93,ES,0.10564125831820932,0.28994845360824745,,,713,684
105,105,5,1,14,1,2,12,723,666,99,18,86,FIFRGB,0.11683303085299455,0.28994845360824745,,,822,684
106,106,4,1,14,1,3,0,285,699,539,18,-1,,0.0838626739261948,0.30412371134020616,,,824,717
107,107,5,1,14,1,3,1,285,699,35,18,94,GR,0.04575015124016939,0.30412371134020616,,,320,717
108,108,5,1,14,1,3,2,328,699,32,18,94,HR,0.05202661826981246,0.30412371134020616,,,360,717
109,109,5,1,14,1,3,3,368,699,14,18,41,HU,0.05671506352087114,0.30412371134020616,,,382,717
110,110,5,1,14,1,3,4,385,699,43,18,41,IE,0.06147912885662432,0.30412371134020616,,,428,717
111,111,5,1,14,1,3,5,436,699,20,18,47,IS,0.06745311554748941,0.30412371134020616,,,456,717
112,112,5,1,14,1,3,6,464,699,20,18,47,IT,0.07168784029038112,0.30412371134020616,,,484,717
113,113,5,1,14,1,3,7,492,699,54,18,83,LILT,0.07849364791288566,0.30412371134020616,,,546,717
114,114,5,1,14,1,3,8,554,699,28,18,75,LU,0.08590441621294616,0.30412371134020616,,,582,717
115,115,5,1,14,1,3,9,591,699,28,18,75,LV,0.09150030248033877,0.30412371134020616,,,619,717
116,116,5,1,14,1,3,10,627,699,35,18,95,MC,0.09747428917120388,0.30412371134020616,,,662,717
117,117,5,1,14,1,3,11,670,699,35,18,94,MK,0.10397761645493044,0.30412371134020616,,,705,717
118,118,5,1,14,1,3,12,713,699,32,18,93,MT,0.11025408348457351,0.30412371134020616,,,745,717
119,119,5,1,14,1,3,13,753,699,29,18,20,NL,0.11607683000604961,0.30412371134020616,,,782,717
120,120,5,1,14,1,3,14,791,699,33,18,20,NO,0.1221264367816092,0.30412371134020616,,,824,717
121,121,4,1,14,1,4,0,286,732,336,18,-1,,0.06866303690260134,0.31829896907216493,,,622,750
122,122,5,1,14,1,4,1,286,732,28,18,95,PL,0.045372050816696916,0.31829896907216493,,,314,750
123,123,5,1,14,1,4,2,323,732,29,18,92,PT,0.05104355716878403,0.31829896907216493,,,352,750
124,124,5,1,14,1,4,3,360,732,58,18,92,RORS,0.058832425892317,0.31829896907216493,,,418,750
125,125,5,1,14,1,4,4,420,732,52,18,96,SE,0.06745311554748941,0.31829896907216493,,,472,750
126,126,5,1,14,1,4,5,480,732,20,18,91,SI,0.07410768300060495,0.31829896907216493,,,500,750
127,127,5,1,14,1,4,6,510,732,31,18,91,SK,0.0794767090139141,0.31829896907216493,,,541,750
128,128,5,1,14,1,4,7,550,732,72,18,91,SMTR,0.08862673926194797,0.31829896907216493,,,622,750
129,129,4,1,14,1,5,0,286,765,330,23,-1,,0.06820931639443437,0.3335481099656357,,,616,788
130,130,5,1,14,1,5,1,286,765,100,18,92,Benannte,0.050816696914700546,0.3324742268041237,,,386,783
131,131,5,1,14,1,5,2,395,765,221,23,91,Erstreckungsstaaten:,0.0764519056261343,0.3335481099656357,,,616,788
132,132,4,1,14,1,6,0,286,797,74,19,-1,,0.04885057471264368,0.34643470790378006,,,360,816
133,133,5,1,14,1,6,1,286,797,33,19,96,BA,0.04575015124016939,0.34643470790378006,,,319,816
134,134,5,1,14,1,6,2,327,797,33,19,96,ME,0.05195099818511797,0.34643470790378006,,,360,816
135,135,4,1,14,1,7,0,286,830,322,23,-1,,0.06760435571687841,0.36146907216494845,,,608,853
136,136,5,1,14,1,7,1,286,830,100,18,92,Benannte,0.050816696914700546,0.3603951890034364,,,386,848
137,137,5,1,14,1,7,2,393,830,215,23,92,Validierungsstaaten:,0.07569570477918935,0.36146907216494845,,,608,853
138,138,4,1,14,1,8,0,286,863,116,18,-1,,0.05202661826981246,0.3745704467353952,,,402,881
139,139,5,1,14,1,8,1,286,863,35,18,95,MA,0.04590139140955838,0.3745704467353952,,,321,881
140,140,5,1,14,1,8,2,330,863,34,18,94,MD,0.05248033877797943,0.3745704467353952,,,364,881
141,141,5,1,14,1,8,3,373,863,29,18,92,TN,0.05860556563823351,0.3745704467353952,,,402,881
142,142,2,1,15,0,0,0,225,927,491,26,-1,,0.07115849969751967,0.40378006872852235,,,716,953
143,143,3,1,15,1,0,0,225,927,491,26,-1,,0.07115849969751967,0.40378006872852235,,,716,953
144,144,4,1,15,1,1,0,225,927,491,26,-1,,0.07115849969751967,0.40378006872852235,,,716,953
145,145,5,1,15,1,1,1,225,927,45,26,91,(30),0.037431941923774956,0.40378006872852235,,,270,953
146,146,5,1,15,1,1,2,286,929,86,18,67,Prioritat:,0.04975801572897762,0.4029209621993127,,,372,947
147,147,5,1,15,1,1,3,383,929,118,18,95,21.02.2017,0.06684815486993345,0.4029209621993127,priority_date_eu,21.02.2017,501,947
148,148,5,1,15,1,1,4,520,929,30,18,95,DE,0.0809134906231095,0.4029209621993127,,,550,947
149,149,5,1,15,1,1,5,559,929,157,18,96,102017103500,0.09641560798548095,0.4029209621993127,,,716,947
150,150,2,1,16,0,0,0,845,614,2,369,-1,,0.1279491833030853,0.3429982817869416,,,847,983
151,151,3,1,16,1,0,0,845,614,2,369,-1,,0.1279491833030853,0.3429982817869416,,,847,983
152,152,4,1,16,1,1,0,845,614,2,369,-1,,0.1279491833030853,0.3429982817869416,,,847,983
153,153,5,1,16,1,1,1,845,614,2,369,95, ,0.1279491833030853,0.3429982817869416,,,847,983
154,154,2,1,17,0,0,0,862,631,349,58,-1,,0.15676043557168784,0.28350515463917525,,,1211,689
155,155,3,1,17,1,0,0,862,631,349,58,-1,,0.15676043557168784,0.28350515463917525,,,1211,689
156,156,4,1,17,1,1,0,862,631,349,27,-1,,0.15676043557168784,0.2768470790378007,,,1211,658
157,157,5,1,17,1,1,1,862,631,44,27,93,(71),0.1336963097398669,0.2768470790378007,,,906,658
158,158,5,1,17,1,1,2,921,633,107,19,92,Anmelder:,0.14738354506957047,0.2759879725085911,,,1028,652
159,159,5,1,17,1,1,3,1038,633,57,19,93,Miele,0.16129764065335753,0.2759879725085911,applicant_line_1,Miele,1095,652
160,160,5,1,17,1,1,4,1104,633,15,19,93,&,0.16810344827586207,0.2759879725085911,applicant_line_1,&,1119,652
161,161,5,1,17,1,1,5,1128,633,41,19,96,Cie.,0.1736993345432547,0.2759879725085911,applicant_line_1,Cie.,1169,652
162,162,5,1,17,1,1,6,1179,633,32,19,96,KG,0.18073200241984272,0.2759879725085911,applicant_line_1,KG,1211,652
163,163,4,1,17,1,2,0,922,666,239,23,-1,,0.15751663641863278,0.29102233676975947,,,1161,689
164,164,5,1,17,1,2,1,922,666,64,18,93,33332,0.1442831215970962,0.28994845360824745,,,986,684
165,165,5,1,17,1,2,2,995,666,110,18,88,Giitersloh,0.1588021778584392,0.28994845360824745,,,1105,684
166,166,5,1,17,1,2,3,1114,666,47,23,96,(DE),0.1720356926799758,0.29102233676975947,,,1161,689
167,167,2,1,18,0,0,0,862,730,306,156,-1,,0.15350877192982457,0.3470790378006873,,,1168,886
168,168,3,1,18,1,0,0,862,730,306,156,-1,,0.15350877192982457,0.3470790378006873,,,1168,886
169,169,4,1,18,1,1,0,862,730,147,26,-1,,0.1414851784633999,0.31915807560137455,,,1009,756
170,170,5,1,18,1,1,1,862,730,44,26,85,(72),0.1336963097398669,0.31915807560137455,,,906,756
171,171,5,1,18,1,1,2,923,732,86,18,85,Erfinder:,0.14609800362976408,0.31829896907216493,,,1009,750
172,172,4,1,18,1,2,0,898,765,169,23,-1,,0.1485934664246824,0.3335481099656357,,,1067,788
173,173,5,1,18,1,2,1,898,770,7,8,57,¬¢,0.13634301270417423,0.3324742268041237,,,905,778
174,174,5,1,18,1,2,2,922,765,91,23,91,"Sieding,",0.14632486388384755,0.3335481099656357,inventor_line_1,"Sieding,",1013,788
175,175,5,1,18,1,2,3,1022,765,45,18,96,Dirk,0.15797035692679975,0.3324742268041237,inventor_line_1,Dirk,1067,783
176,176,4,1,18,1,3,0,922,797,198,23,-1,,0.1544162129461585,0.3472938144329897,,,1120,820
177,177,5,1,18,1,3,1,922,797,65,19,96,44534,0.1443587416817907,0.34643470790378006,,,987,816
178,178,5,1,18,1,3,2,996,797,68,19,48,Linen,0.1557773744706594,0.34643470790378006,,,1064,816
179,179,5,1,18,1,3,3,1073,797,47,23,96,(DE),0.16583484573502721,0.3472938144329897,,,1120,820
180,180,4,1,18,1,4,0,898,830,226,22,-1,,0.1529038112522686,0.36125429553264604,,,1124,852
181,181,5,1,18,1,4,1,898,835,7,8,61,¬¢,0.13634301270417423,0.3603951890034364,,,905,843
182,182,5,1,18,1,4,2,923,830,77,22,6,"L6ffler,",0.1454174228675136,0.36125429553264604,,,1000,852
183,183,5,1,18,1,4,3,1009,830,115,18,96,Alexander,0.16129764065335753,0.3603951890034364,,,1124,848
184,184,4,1,18,1,5,0,922,863,246,23,-1,,0.15804597701149425,0.3756443298969072,,,1168,886
185,185,5,1,18,1,5,1,922,863,64,18,96,33102,0.1442831215970962,0.3745704467353952,,,986,881
186,186,5,1,18,1,5,2,996,863,116,18,95,Paderborn,0.15940713853599517,0.3745704467353952,,,1112,881
187,187,5,1,18,1,5,3,1121,863,47,23,96,(DE),0.17309437386569873,0.3756443298969072,,,1168,886
188,188,2,1,19,0,0,0,224,980,1243,4,-1,,0.1278735632183908,0.4218213058419244,,,1467,984
189,189,3,1,19,1,0,0,224,980,1243,4,-1,,0.1278735632183908,0.4218213058419244,,,1467,984
190,190,4,1,19,1,1,0,224,980,1243,4,-1,,0.1278735632183908,0.4218213058419244,,,1467,984
191,191,5,1,19,1,1,1,224,980,1243,4,95, ,0.1278735632183908,0.4218213058419244,,,1467,984
192,192,2,1,20,0,0,0,225,1001,45,26,-1,,0.037431941923774956,0.43556701030927836,,,270,1027
193,193,3,1,20,1,0,0,225,1001,45,26,-1,,0.037431941923774956,0.43556701030927836,,,270,1027
194,194,4,1,20,1,1,0,225,1001,45,26,-1,,0.037431941923774956,0.43556701030927836,,,270,1027
195,195,5,1,20,1,1,1,225,1001,45,26,96,(54),0.037431941923774956,0.43556701030927836,,,270,1027
196,196,2,1,21,0,0,0,315,996,930,29,-1,,0.11796733212341198,0.4340635738831615,,,1245,1025
197,197,3,1,21,1,0,0,315,996,930,29,-1,,0.11796733212341198,0.4340635738831615,,,1245,1025
198,198,4,1,21,1,1,0,315,996,930,29,-1,,0.11796733212341198,0.4340635738831615,,,1245,1025
199,199,5,1,21,1,1,1,315,1001,163,20,92,VERFAHREN,0.05996672716273442,0.43427835051546393,title_line_1,VERFAHREN,478,1021
200,200,5,1,21,1,1,2,487,1001,56,21,93,ZUM,0.0778886872353297,0.43449312714776633,,,543,1022
201,201,5,1,21,1,1,3,552,1001,148,21,91,TROCKNEN,0.09467634603750756,0.43449312714776633,title_line_1,TROCKNEN,700,1022
202,202,5,1,21,1,1,4,710,1001,56,21,93,VON,0.11161524500907441,0.43449312714776633,title_line_1,VON,766,1022
203,203,5,1,21,1,1,5,775,996,123,29,91,"WASCHE,",0.1265124016938899,0.4340635738831615,title_line_1,"W‚àö√ëSCHE,",898,1025
204,204,5,1,21,1,1,6,909,1001,269,21,92,STEUERVERFAHREN,0.15781911675741075,0.43449312714776633,title_line_1,STEUERVERFAHREN,1178,1022
205,205,5,1,21,1,1,7,1190,1001,55,21,96,UND,0.184134906231095,0.43449312714776633,title_line_1,UND,1245,1022
206,206,2,1,22,0,0,0,316,1033,1007,21,-1,,0.12394131881427707,0.4482388316151203,,,1323,1054
207,207,3,1,22,1,0,0,316,1033,1007,21,-1,,0.12394131881427707,0.4482388316151203,,,1323,1054
208,208,4,1,22,1,1,0,316,1033,1007,21,-1,,0.12394131881427707,0.4482388316151203,,,1323,1054
209,209,5,1,22,1,1,1,316,1033,302,21,88,STEUERVORRICHTUNG,0.0706291591046582,0.4482388316151203,,,618,1054
210,210,5,1,22,1,1,2,628,1034,55,20,92,ZUM,0.09913793103448276,0.4484536082474227,title_line_1,ZUM,683,1054
211,211,5,1,22,1,1,3,693,1033,124,21,86,STEUERN,0.11418632788868724,0.4482388316151203,,,817,1054
212,212,5,1,22,1,1,4,829,1033,76,21,93,EINES,0.13112522686025407,0.4482388316151203,,,905,1054
213,213,5,1,22,1,1,5,914,1033,344,21,92,TROCKNUNGSVORGANGS,0.16424682395644283,0.4482388316151203,,,1258,1054
214,214,5,1,22,1,1,6,1268,1034,55,20,96,UND,0.19593163944343617,0.4484536082474227,,,1323,1054
215,215,2,1,23,0,0,0,315,1066,250,21,-1,,0.06654567453115548,0.46241408934707906,,,565,1087
216,216,3,1,23,1,0,0,315,1066,250,21,-1,,0.06654567453115548,0.46241408934707906,,,565,1087
217,217,4,1,23,1,1,0,315,1066,250,21,-1,,0.06654567453115548,0.46241408934707906,,,565,1087
218,218,5,1,23,1,1,1,315,1066,250,21,90,WASCHTROCKNER,0.06654567453115548,0.46241408934707906,,,565,1087
219,219,2,1,24,0,0,0,224,1140,584,255,-1,,0.0780399274047187,0.5444587628865979,,,808,1395
220,220,3,1,24,1,0,0,224,1140,584,255,-1,,0.0780399274047187,0.5444587628865979,,,808,1395
221,221,4,1,24,1,1,0,225,1140,582,26,-1,,0.0780399274047187,0.4952749140893471,,,807,1166
222,222,5,1,24,1,1,1,225,1140,45,26,92,(57),0.037431941923774956,0.4952749140893471,,,270,1166
223,223,5,1,24,1,1,2,316,1142,33,18,29,Die,0.05028735632183908,0.4944158075601375,,,349,1160
224,224,5,1,24,1,1,3,359,1142,85,18,92,Erfindung,0.06072292800967937,0.4944158075601375,,,444,1160
225,225,5,1,24,1,1,4,447,1142,85,23,91,betrifft,0.07403206291591047,0.4954896907216495,,,532,1165
226,226,5,1,24,1,1,5,539,1142,30,18,96,ein,0.0837870538415003,0.4944158075601375,,,569,1160
227,227,5,1,24,1,1,6,577,1142,103,18,95,Verfahren,0.09505444646098003,0.4944158075601375,,,680,1160
228,228,5,1,24,1,1,7,689,1147,43,13,93,zum,0.1074561403508772,0.4954896907216495,,,732,1160
229,229,5,1,24,1,1,8,741,1142,66,18,89,Trock-,0.11705989110707804,0.4944158075601375,,,807,1160
230,230,4,1,24,1,2,0,226,1175,580,24,-1,,0.0780399274047187,0.5098797250859106,,,806,1199
231,231,5,1,24,1,2,1,226,1180,37,14,96,nen,0.036978221415607984,0.5098797250859106,,,263,1194
232,232,5,1,24,1,2,2,274,1180,36,14,93,von,0.044162129461584994,0.5098797250859106,,,310,1194
233,233,5,1,24,1,2,3,321,1175,72,19,76,Wasche,0.053992740471869326,0.5088058419243986,,,393,1194
234,234,5,1,24,1,2,4,395,1175,76,24,96,(102),0.06548699334543255,0.5098797250859106,,,471,1199
235,235,5,1,24,1,2,5,482,1175,27,19,44,fiir,0.0749395039322444,0.5088058419243986,,,509,1194
236,236,5,1,24,1,2,6,519,1175,57,19,93,einen,0.08280399274047187,0.5088058419243986,,,576,1194
237,237,5,1,24,1,2,7,586,1175,220,24,90,"Waschtrockner(100),",0.10526315789473684,0.5098797250859106,,,806,1199
238,238,4,1,24,1,3,0,224,1208,584,23,-1,,0.0780399274047187,0.523840206185567,,,808,1231
239,239,5,1,24,1,3,1,224,1208,62,19,92,wobei,0.03856624319419238,0.5229810996563574,,,286,1227
240,240,5,1,24,1,3,2,297,1208,33,19,93,der,0.04741379310344827,0.5229810996563574,,,330,1227
241,241,5,1,24,1,3,3,340,1208,159,19,92,Waschtrockner,0.06344525105868118,0.5229810996563574,,,499,1227
242,242,5,1,24,1,3,4,510,1208,53,23,95,(100),0.08114035087719298,0.523840206185567,,,563,1231
243,243,5,1,24,1,3,5,575,1208,56,19,93,einen,0.0911978221415608,0.5229810996563574,,,631,1227
244,244,5,1,24,1,3,6,644,1208,164,23,53,Laugenbehdlter,0.10980036297640654,0.523840206185567,,,808,1231
245,245,4,1,24,1,4,0,225,1241,582,23,-1,,0.0780399274047187,0.5380154639175257,,,807,1264
246,246,5,1,24,1,4,1,225,1241,54,23,96,(108),0.038112522686025406,0.5380154639175257,,,279,1264
247,247,5,1,24,1,4,2,286,1241,37,18,96,und,0.046052631578947366,0.5369415807560137,,,323,1259
248,248,5,1,24,1,4,3,330,1241,44,18,95,eine,0.05323653962492438,0.5369415807560137,,,374,1259
249,249,5,1,24,1,4,4,382,1241,15,18,95,in,0.05890804597701149,0.5369415807560137,,,397,1259
250,250,5,1,24,1,4,5,403,1241,45,18,93,dem,0.06435269207501512,0.5369415807560137,,,448,1259
251,251,5,1,24,1,4,6,456,1241,164,23,73,Laugenbehalter,0.08136721113127647,0.5380154639175257,,,620,1264
252,252,5,1,24,1,4,7,626,1241,54,23,93,(108),0.09875983061101029,0.5380154639175257,,,680,1264
253,253,5,1,24,1,4,8,686,1241,121,23,91,angeordne-,0.11290078644888082,0.5380154639175257,,,807,1264
254,254,4,1,24,1,5,0,225,1274,582,23,-1,,0.0780399274047187,0.5521907216494846,,,807,1297
255,255,5,1,24,1,5,1,225,1274,18,18,93,te,0.03539019963702359,0.5511168384879725,,,243,1292
256,256,5,1,24,1,5,2,249,1274,93,18,91,Trommel,0.04469147005444646,0.5511168384879725,,,342,1292
257,257,5,1,24,1,5,3,348,1274,54,22,96,(104),0.05671506352087114,0.5519759450171822,,,402,1296
258,258,5,1,24,1,5,4,408,1278,43,14,93,zum,0.06495765275257108,0.5519759450171822,,,451,1292
259,259,5,1,24,1,5,5,457,1274,121,18,92,Aufnehmen,0.07826678765880218,0.5511168384879725,,,578,1292
260,260,5,1,24,1,5,6,585,1274,34,18,93,der,0.0910465819721718,0.5511168384879725,,,619,1292
261,261,5,1,24,1,5,7,623,1274,72,18,91,Wasche,0.09966727162734422,0.5511168384879725,,,695,1292
262,262,5,1,24,1,5,8,697,1274,72,23,92,(102),0.11085904416212947,0.5521907216494846,,,769,1297
263,263,5,1,24,1,5,9,775,1278,32,14,91,so-,0.11963097398669087,0.5519759450171822,,,807,1292
264,264,4,1,24,1,6,0,224,1306,583,23,-1,,0.0779643073200242,0.5659364261168385,,,807,1329
265,265,5,1,24,1,6,1,224,1306,35,19,97,wie,0.03652450090744102,0.5650773195876289,,,259,1325
266,266,5,1,24,1,6,2,268,1306,44,19,91,eine,0.043859649122807015,0.5650773195876289,,,312,1325
267,267,5,1,24,1,6,3,321,1306,272,23,90,Kondensationseinrichtung,0.0691167574107683,0.5659364261168385,,,593,1329
268,268,5,1,24,1,6,4,603,1306,54,23,96,(124),0.09528130671506352,0.5659364261168385,,,657,1329
269,269,5,1,24,1,6,5,666,1311,42,14,92,zum,0.10390199637023594,0.5661512027491409,,,708,1325
270,270,5,1,24,1,6,6,719,1306,88,19,92,Konden-,0.11539624924379915,0.5650773195876289,,,807,1325
271,271,4,1,24,1,7,0,225,1339,582,23,-1,,0.0780399274047187,0.5801116838487973,,,807,1362
272,272,5,1,24,1,7,1,225,1339,62,18,92,sieren,0.03871748336358137,0.5790378006872853,,,287,1357
273,273,5,1,24,1,7,2,295,1344,36,13,96,von,0.04733817301875378,0.5801116838487973,,,331,1357
274,274,5,1,24,1,7,3,339,1344,37,13,95,aus,0.054068360556563826,0.5801116838487973,,,376,1357
275,275,5,1,24,1,7,4,383,1339,34,18,93,der,0.060496067755595885,0.5790378006872853,,,417,1357
276,276,5,1,24,1,7,5,423,1339,88,18,92,Trommel,0.0706291591046582,0.5790378006872853,,,511,1357
277,277,5,1,24,1,7,6,514,1339,62,23,93,(104),0.0824258923169994,0.5801116838487973,,,576,1362
278,278,5,1,24,1,7,7,584,1339,128,23,92,abgeleiteten,0.09800362976406533,0.5801116838487973,,,712,1362
279,279,5,1,24,1,7,8,719,1339,88,18,91,Wasser-,0.11539624924379915,0.5790378006872853,,,807,1357
280,280,4,1,24,1,8,0,225,1372,583,23,-1,,0.07811554748941318,0.594286941580756,,,808,1395
281,281,5,1,24,1,8,1,225,1372,66,23,91,dampf,0.03901996370235935,0.594286941580756,,,291,1395
282,282,5,1,24,1,8,2,296,1372,92,19,91,aufweist.,0.05172413793103448,0.5934278350515464,,,388,1391
283,283,5,1,24,1,8,3,396,1372,40,19,96,Das,0.06291591046581972,0.5934278350515464,,,436,1391
284,284,5,1,24,1,8,4,442,1372,103,19,93,Verfahren,0.07463702359346643,0.5934278350515464,,,545,1391
285,285,5,1,24,1,8,5,554,1372,74,19,91,umfasst,0.08938294010889292,0.5934278350515464,,,628,1391
286,286,5,1,24,1,8,6,629,1372,36,19,93,das,0.09785238959467635,0.5934278350515464,,,665,1391
287,287,5,1,24,1,8,7,668,1372,81,19,93,Bilden,0.10715366001209921,0.5934278350515464,,,749,1391
288,288,5,1,24,1,8,8,756,1372,52,19,96,einer,0.11826981246218995,0.5934278350515464,,,808,1391
289,289,2,1,25,0,0,0,705,1468,35,17,-1,,0.10927102238354507,0.6342353951890034,,,740,1485
290,290,3,1,25,1,0,0,705,1468,35,17,-1,,0.10927102238354507,0.6342353951890034,,,740,1485
291,291,4,1,25,1,1,0,705,1468,35,17,-1,,0.10927102238354507,0.6342353951890034,,,740,1485
292,292,5,1,25,1,1,1,705,1468,35,17,96,122,0.10927102238354507,0.6342353951890034,,,740,1485
293,293,2,1,26,0,0,0,883,1142,583,215,-1,,0.17763157894736842,0.5367268041237113,,,1466,1357
294,294,3,1,26,1,0,0,883,1142,583,215,-1,,0.17763157894736842,0.5367268041237113,,,1466,1357
295,295,4,1,26,1,1,0,885,1142,580,23,-1,,0.17770719903206292,0.4954896907216495,,,1465,1165
296,296,5,1,26,1,1,1,885,1142,200,23,79,Flussigkeitsvorlage,0.14897156684815488,0.4954896907216495,,,1085,1165
297,297,5,1,26,1,1,2,1094,1142,53,23,96,(118),0.169464609800363,0.4954896907216495,,,1147,1165
298,298,5,1,26,1,1,3,1156,1142,15,18,96,in,0.17596793708408953,0.4944158075601375,,,1171,1160
299,299,5,1,26,1,1,4,1180,1142,44,18,93,dem,0.18179068360556563,0.4944158075601375,,,1224,1160
300,300,5,1,26,1,1,5,1234,1142,164,23,90,Laugenbehalter,0.19903206291591047,0.4954896907216495,,,1398,1165
301,301,5,1,26,1,1,6,1406,1142,59,23,96,"(108),",0.21710526315789475,0.4954896907216495,,,1465,1165
302,302,4,1,26,1,2,0,883,1175,583,24,-1,,0.17763157894736842,0.5098797250859106,,,1466,1199
303,303,5,1,26,1,2,1,883,1175,61,19,93,wobei,0.13815789473684212,0.5088058419243986,,,944,1194
304,304,5,1,26,1,2,2,956,1175,41,19,96,sich,0.14768602540834846,0.5088058419243986,,,997,1194
305,305,5,1,26,1,2,3,1009,1175,30,19,93,die,0.15486993345432548,0.5088058419243986,,,1039,1194
306,306,5,1,26,1,2,4,1051,1175,92,19,91,Trommel,0.16591046581972171,0.5088058419243986,,,1143,1194
307,307,5,1,26,1,2,5,1156,1175,54,24,93,(104),0.17891712038717483,0.5098797250859106,,,1210,1199
308,308,5,1,26,1,2,6,1222,1175,106,19,62,auBerhalb,0.1928312159709619,0.5088058419243986,,,1328,1194
309,309,5,1,26,1,2,7,1339,1175,34,19,93,der,0.20508166969147004,0.5088058419243986,,,1373,1194
310,310,5,1,26,1,2,8,1385,1175,81,24,42,Fltssig-,0.21559286146400483,0.5098797250859106,,,1466,1199
311,311,4,1,26,1,3,0,885,1208,581,23,-1,,0.17778281911675742,0.523840206185567,,,1466,1231
312,312,5,1,26,1,3,1,885,1208,125,23,90,keitsvorlage,0.14330006049606775,0.523840206185567,,,1010,1231
313,313,5,1,26,1,3,2,1017,1208,53,23,91,(118),0.15781911675741075,0.523840206185567,,,1070,1231
314,314,5,1,26,1,3,3,1077,1208,89,22,91,"befindet,",0.16961584996975196,0.5236254295532646,,,1166,1230
315,315,5,1,26,1,3,4,1174,1208,36,19,96,und,0.18027828191167575,0.5229810996563574,,,1210,1227
316,316,5,1,26,1,3,5,1217,1208,30,19,93,ein,0.18632788868723532,0.5229810996563574,,,1247,1227
317,317,5,1,26,1,3,6,1255,1208,111,23,92,Einbringen,0.19820024198427103,0.523840206185567,,,1366,1231
318,318,5,1,26,1,3,7,1373,1213,36,14,93,von,0.2103750756200847,0.5240549828178694,,,1409,1227
319,319,5,1,26,1,3,8,1415,1208,51,19,89,War-,0.2178614640048397,0.5229810996563574,,,1466,1227
320,320,4,1,26,1,4,0,885,1241,581,23,-1,,0.17778281911675742,0.5380154639175257,,,1466,1264
321,321,5,1,26,1,4,1,885,1241,110,23,92,meenergie,0.14216575922565033,0.5380154639175257,,,995,1264
322,322,5,1,26,1,4,2,1006,1241,16,18,96,in,0.15335753176043557,0.5369415807560137,,,1022,1259
323,323,5,1,26,1,4,3,1033,1241,31,18,93,die,0.15857531760435573,0.5369415807560137,,,1064,1259
324,324,5,1,26,1,4,4,1074,1241,87,18,91,Trommel,0.16901088929219601,0.5369415807560137,,,1161,1259
325,325,5,1,26,1,4,5,1164,1241,73,23,96,"(104),",0.18156382335148216,0.5380154639175257,,,1237,1264
326,326,5,1,26,1,4,6,1249,1246,30,13,96,um,0.191167574107683,0.5380154639175257,,,1279,1259
327,327,5,1,26,1,4,7,1290,1246,37,13,96,von,0.19789776164549305,0.5380154639175257,,,1327,1259
328,328,5,1,26,1,4,8,1338,1241,34,18,93,der,0.20493042952208107,0.5369415807560137,,,1372,1259
329,329,5,1,26,1,4,9,1381,1241,85,18,91,Wasche,0.21529038112522686,0.5369415807560137,,,1466,1259
330,330,4,1,26,1,5,0,885,1274,581,23,-1,,0.17778281911675742,0.5521907216494846,,,1466,1297
331,331,5,1,26,1,5,1,885,1274,52,23,93,(102),0.13777979431336962,0.5521907216494846,,,937,1297
332,332,5,1,26,1,5,2,944,1274,176,23,91,aufgenommenes,0.1560798548094374,0.5521907216494846,,,1120,1297
333,333,5,1,26,1,5,3,1124,1274,73,18,95,Wasser,0.17551421657592256,0.5511168384879725,,,1197,1292
334,334,5,1,26,1,5,4,1199,1274,28,18,95,in,0.18345432546884452,0.5511168384879725,,,1227,1292
335,335,5,1,26,1,5,5,1233,1278,24,14,95,an,0.1882940108892922,0.5519759450171822,,,1257,1292
336,336,5,1,26,1,5,6,1263,1274,34,18,93,der,0.19358741681790684,0.5511168384879725,,,1297,1292
337,337,5,1,26,1,5,7,1303,1274,163,23,24,Fllssigkeitsvor-,0.20939201451905626,0.5521907216494846,,,1466,1297
338,338,4,1,26,1,6,0,885,1306,581,23,-1,,0.17778281911675742,0.5659364261168385,,,1466,1329
339,339,5,1,26,1,6,1,885,1306,42,23,96,lage,0.13702359346642468,0.5659364261168385,,,927,1329
340,340,5,1,26,1,6,2,938,1306,54,23,93,(118),0.14594676346037508,0.5659364261168385,,,992,1329
341,341,5,1,26,1,6,3,1003,1306,175,19,91,kondensierbaren,0.16492740471869327,0.5650773195876289,,,1178,1325
342,342,5,1,26,1,6,4,1189,1306,147,23,91,Wasserdampf,0.1909407138535995,0.5659364261168385,,,1336,1329
343,343,5,1,26,1,6,5,1344,1311,24,14,92,zu,0.20508166969147004,0.5661512027491409,,,1368,1325
344,344,5,1,26,1,6,6,1380,1306,86,19,79,Uberfiih-,0.21521476104053236,0.5650773195876289,,,1466,1325
345,345,4,1,26,1,7,0,885,1344,38,13,-1,,0.1367211131276467,0.5801116838487973,,,923,1357
346,346,5,1,26,1,7,1,885,1344,38,13,96,ren.,0.1367211131276467,0.5801116838487973,,,923,1357
347,347,2,1,27,0,0,0,754,1471,269,34,-1,,0.13437689050211737,0.6391752577319587,,,1023,1505
348,348,3,1,27,1,0,0,754,1471,269,34,-1,,0.13437689050211737,0.6391752577319587,,,1023,1505
349,349,4,1,27,1,1,0,754,1471,269,34,-1,,0.13437689050211737,0.6391752577319587,,,1023,1505
350,350,5,1,27,1,1,1,754,1480,35,18,82,100,0.11668179068360557,0.6396048109965635,,,789,1498
351,351,5,1,27,1,1,2,811,1471,34,18,85,120,0.12522686025408347,0.6357388316151202,,,845,1489
352,352,5,1,27,1,1,3,855,1482,34,18,85,449,0.13188142770719904,0.6404639175257731,,,889,1500
353,353,5,1,27,1,1,4,989,1486,34,19,85,116,0.15214761040532365,0.6423969072164949,,,1023,1505
354,354,2,1,28,0,0,0,622,1564,264,48,-1,,0.11403508771929824,0.6821305841924399,,,886,1612
355,355,3,1,28,1,0,0,622,1564,264,48,-1,,0.11403508771929824,0.6821305841924399,,,886,1612
356,356,4,1,28,1,1,0,622,1564,264,48,-1,,0.11403508771929824,0.6821305841924399,,,886,1612
357,357,5,1,28,1,1,1,622,1564,64,48,57,CA\,0.09891107078039928,0.6821305841924399,,,686,1612
358,358,5,1,28,1,1,2,679,1568,207,18,24,ear,0.11834543254688445,0.677405498281787,,,886,1586
359,359,2,1,29,0,0,0,631,1624,15,167,-1,,0.09656684815486993,0.7334621993127147,,,646,1791
360,360,3,1,29,1,0,0,631,1624,15,167,-1,,0.09656684815486993,0.7334621993127147,,,646,1791
361,361,4,1,29,1,1,0,631,1624,15,167,-1,,0.09656684815486993,0.7334621993127147,,,646,1791
362,362,5,1,29,1,1,1,631,1624,15,167,30,CZ,0.09656684815486993,0.7334621993127147,,,646,1791
363,363,2,1,30,0,0,0,568,1793,35,17,-1,,0.08855111917725347,0.773840206185567,,,603,1810
364,364,3,1,30,1,0,0,568,1793,35,17,-1,,0.08855111917725347,0.773840206185567,,,603,1810
365,365,4,1,30,1,1,0,568,1793,35,17,-1,,0.08855111917725347,0.773840206185567,,,603,1810
366,366,5,1,30,1,1,1,568,1793,35,17,96,124,0.08855111917725347,0.773840206185567,,,603,1810
367,367,2,1,31,0,0,0,592,1510,495,550,-1,,0.12696612220205686,0.7667525773195877,,,1087,2060
368,368,3,1,31,1,0,0,592,1510,495,550,-1,,0.12696612220205686,0.7667525773195877,,,1087,2060
369,369,4,1,31,1,1,0,592,1510,495,550,-1,,0.12696612220205686,0.7667525773195877,,,1087,2060
370,370,5,1,31,1,1,1,592,1510,495,550,95,   ,0.12696612220205686,0.7667525773195877,,,1087,2060
371,371,5,1,31,1,1,2,917,1889,27,171,95, ,0.14072897761645492,0.8481529209621993,,,944,2060
372,372,2,1,32,0,0,0,613,1928,488,168,-1,,0.1296128251663642,0.8642611683848798,,,1101,2096
373,373,3,1,32,1,0,0,613,1928,488,168,-1,,0.1296128251663642,0.8642611683848798,,,1101,2096
374,374,4,1,32,1,1,0,613,1928,488,125,-1,,0.1296128251663642,0.8550257731958762,,,1101,2053
375,375,5,1,32,1,1,1,613,1980,36,73,21,pe,0.0954325468844525,0.8661941580756014,,,649,2053
376,376,5,1,32,1,1,2,648,2000,9,15,28,%,0.09868421052631579,0.8623281786941581,,,657,2015
377,377,5,1,32,1,1,3,661,1928,356,125,18,a,0.12689050211736236,0.8550257731958762,,,1017,2053
378,378,5,1,32,1,1,4,1067,1987,34,18,96,104,0.16394434361766486,0.8573883161512027,,,1101,2005
379,379,4,1,32,1,2,0,691,2077,34,19,-1,,0.10707803992740472,0.8962628865979382,,,725,2096
380,380,5,1,32,1,2,1,691,2077,34,19,95,110,0.10707803992740472,0.8962628865979382,,,725,2096
381,381,2,1,33,0,0,0,982,1622,31,48,-1,,0.15086206896551724,0.7070446735395189,,,1013,1670
382,382,3,1,33,1,0,0,982,1622,31,48,-1,,0.15086206896551724,0.7070446735395189,,,1013,1670
383,383,4,1,33,1,1,0,982,1622,31,48,-1,,0.15086206896551724,0.7070446735395189,,,1013,1670
384,384,5,1,33,1,1,1,982,1622,31,48,0,r\,0.15086206896551724,0.7070446735395189,,,1013,1670
385,385,2,1,34,0,0,0,970,1886,117,174,-1,,0.15555051421657592,0.8475085910652921,,,1087,2060
386,386,3,1,34,1,0,0,970,1886,117,174,-1,,0.15555051421657592,0.8475085910652921,,,1087,2060
387,387,4,1,34,1,1,0,970,1886,117,174,-1,,0.15555051421657592,0.8475085910652921,,,1087,2060
388,388,5,1,34,1,1,1,970,1886,117,174,95,  ,0.15555051421657592,0.8475085910652921,,,1087,2060
389,389,2,1,35,0,0,0,973,1863,43,59,-1,,0.15040834845735027,0.8129295532646048,,,1016,1922
390,390,3,1,35,1,0,0,973,1863,43,59,-1,,0.15040834845735027,0.8129295532646048,,,1016,1922
391,391,4,1,35,1,1,0,973,1863,43,59,-1,,0.15040834845735027,0.8129295532646048,,,1016,1922
392,392,5,1,35,1,1,1,973,1863,43,59,59,Lh,0.15040834845735027,0.8129295532646048,,,1016,1922
393,393,2,1,36,0,0,0,976,2075,22,18,-1,,0.14927404718693285,0.8951890034364262,,,998,2093
394,394,3,1,36,1,0,0,976,2075,22,18,-1,,0.14927404718693285,0.8951890034364262,,,998,2093
395,395,4,1,36,1,1,0,976,2075,22,18,-1,,0.14927404718693285,0.8951890034364262,,,998,2093
396,396,5,1,36,1,1,1,976,2075,22,18,94,14,0.14927404718693285,0.8951890034364262,,,998,2093
397,397,2,1,37,0,0,0,799,2165,63,23,-1,,0.12560496067755597,0.9349226804123711,,,862,2188
398,398,3,1,37,1,0,0,799,2165,63,23,-1,,0.12560496067755597,0.9349226804123711,,,862,2188
399,399,4,1,37,1,1,0,799,2165,63,23,-1,,0.12560496067755597,0.9349226804123711,,,862,2188
400,400,5,1,37,1,1,1,799,2165,43,23,92,FIG,0.12409255898366606,0.9349226804123711,,,842,2188
401,401,5,1,37,1,1,2,854,2165,8,22,92,1,0.1297640653357532,0.9347079037800687,,,862,2187
402,402,2,1,38,0,0,0,716,2270,259,16,-1,,0.1278735632183908,0.9785223367697594,,,975,2286
403,403,3,1,38,1,0,0,716,2270,259,16,-1,,0.1278735632183908,0.9785223367697594,,,975,2286
404,404,4,1,38,1,1,0,716,2270,259,16,-1,,0.1278735632183908,0.9785223367697594,,,975,2286
405,405,5,1,38,1,1,1,716,2270,49,12,96,Printed,0.11199334543254688,0.9776632302405498,,,765,2282
406,406,5,1,38,1,1,2,771,2270,15,16,96,by,0.1177404718693285,0.9785223367697594,,,786,2286
407,407,5,1,38,1,1,3,792,2270,45,14,96,"Jouve,",0.12318511796733213,0.9780927835051546,,,837,2284
408,408,5,1,38,1,1,4,843,2270,41,12,96,75001,0.13059588626739263,0.9776632302405498,,,884,2282
409,409,5,1,38,1,1,5,893,2270,46,12,96,PARIS,0.1385359951603146,0.9776632302405498,,,939,2282
410,410,5,1,38,1,1,6,945,2270,30,16,95,(FR),0.14519056261343014,0.9785223367697594,,,975,2286
