,Unnamed: 0,level,page_num,block_num,par_num,line_num,word_num,left,top,width,height,conf,text,x,y,label,target,right,bottom
0,0,1,1,0,0,0,0,0,0,1653,2328,-1,,0.125,0.5,,,1653,2328
1,1,2,1,1,0,0,0,144,1905,31,328,-1,,0.02412280701754386,0.8887457044673539,,,175,2233
2,2,3,1,1,1,0,0,144,1905,31,328,-1,,0.02412280701754386,0.8887457044673539,,,175,2233
3,3,4,1,1,1,1,0,144,1905,31,328,-1,,0.02412280701754386,0.8887457044673539,,,175,2233
4,4,5,1,1,1,1,1,144,2179,30,54,96,EP,0.024047186932849365,0.947594501718213,,,174,2233
5,5,5,1,1,1,1,2,144,2142,31,21,95,3,0.02412280701754386,0.9246134020618557,,,175,2163
6,6,5,1,1,1,1,3,144,2055,31,71,96,366,0.02412280701754386,0.8979810996563574,,,175,2126
7,7,5,1,1,1,1,4,144,1968,31,72,86,925,0.02412280701754386,0.8608247422680413,,,175,2040
8,8,5,1,1,1,1,5,144,1905,30,50,86,A1,0.024047186932849365,0.8290378006872853,,,174,1955
9,9,2,1,2,0,0,0,429,153,88,28,-1,,0.07153660012099214,0.07173539518900343,,,517,181
10,10,3,1,2,1,0,0,429,153,88,28,-1,,0.07153660012099214,0.07173539518900343,,,517,181
11,11,4,1,2,1,1,0,429,153,88,16,-1,,0.07153660012099214,0.06915807560137457,,,517,169
12,12,5,1,2,1,1,1,429,153,88,16,84,Europaisches,0.07153660012099214,0.06915807560137457,,,517,169
13,13,4,1,2,1,2,0,429,170,71,11,-1,,0.07025105868118572,0.07538659793814433,,,500,181
14,14,5,1,2,1,2,1,429,170,71,11,96,Patentamt,0.07025105868118572,0.07538659793814433,,,500,181
15,15,2,1,3,0,0,0,429,196,89,28,-1,,0.07161222020568662,0.09020618556701031,,,518,224
16,16,3,1,3,1,0,0,429,196,89,28,-1,,0.07161222020568662,0.09020618556701031,,,518,224
17,17,4,1,3,1,1,0,429,196,63,15,-1,,0.06964609800362977,0.08741408934707903,,,492,211
18,18,5,1,3,1,1,1,429,196,63,15,95,European,0.06964609800362977,0.08741408934707903,,,492,211
19,19,4,1,3,1,2,0,429,212,89,12,-1,,0.07161222020568662,0.0936426116838488,,,518,224
20,20,5,1,3,1,2,1,429,213,43,11,96,Patent,0.06813369630973987,0.0938573883161512,,,472,224
21,21,5,1,3,1,2,2,478,212,40,12,90,Office,0.07531760435571688,0.0936426116838488,,,518,224
22,22,2,1,4,0,0,0,429,239,109,28,-1,,0.07312462189957653,0.10867697594501718,,,538,267
23,23,3,1,4,1,0,0,429,239,109,28,-1,,0.07312462189957653,0.10867697594501718,,,538,267
24,24,4,1,4,1,1,0,429,239,109,15,-1,,0.07312462189957653,0.10588487972508591,,,538,254
25,25,5,1,4,1,1,1,429,239,40,12,93,Office,0.06790683605565638,0.1052405498281787,,,469,251
26,26,5,1,4,1,1,2,474,239,64,15,93,europ√©en,0.0765275257108288,0.10588487972508591,,,538,254
27,27,4,1,4,1,2,0,429,255,77,12,-1,,0.0707047791893527,0.11211340206185567,,,506,267
28,28,5,1,4,1,2,1,429,255,22,12,95,des,0.06654567453115548,0.11211340206185567,,,451,267
29,29,5,1,4,1,2,2,457,255,49,12,82,brevets,0.07282214156079855,0.11211340206185567,,,506,267
30,30,2,1,5,0,0,0,281,136,274,150,-1,,0.06321839080459771,0.09063573883161512,,,555,286
31,31,3,1,5,1,0,0,281,136,274,150,-1,,0.06321839080459771,0.09063573883161512,,,555,286
32,32,4,1,5,1,1,0,281,136,274,150,-1,,0.06321839080459771,0.09063573883161512,,,555,286
33,33,5,1,5,1,1,1,281,136,274,150,95, ,0.06321839080459771,0.09063573883161512,,,555,286
34,34,2,1,6,0,0,0,225,324,45,26,-1,,0.037431941923774956,0.14475945017182132,,,270,350
35,35,3,1,6,1,0,0,225,324,45,26,-1,,0.037431941923774956,0.14475945017182132,,,270,350
36,36,4,1,6,1,1,0,225,324,45,26,-1,,0.037431941923774956,0.14475945017182132,,,270,350
37,37,5,1,6,1,1,1,225,324,45,26,96,(12),0.037431941923774956,0.14475945017182132,,,270,350
38,38,2,1,7,0,0,0,225,395,415,53,-1,,0.06541137326073805,0.18105670103092783,,,640,448
39,39,3,1,7,1,0,0,225,395,415,53,-1,,0.06541137326073805,0.18105670103092783,,,640,448
40,40,4,1,7,1,1,0,225,395,282,26,-1,,0.05535390199637023,0.17525773195876287,,,507,421
41,41,5,1,7,1,1,1,225,395,45,26,92,(43),0.037431941923774956,0.17525773195876287,,,270,421
42,42,5,1,7,1,1,2,285,397,222,23,90,Verdffentlichungstag:,0.05989110707803993,0.17547250859106528,,,507,420
43,43,4,1,7,1,2,0,286,430,354,18,-1,,0.07002419842710224,0.18857388316151202,,,640,448
44,44,5,1,7,1,2,1,286,430,117,18,90,29.08.2018,0.052102238354506954,0.18857388316151202,publication_date,29.08.2018,403,448
45,45,5,1,7,1,2,2,426,430,121,18,91,Patentblatt,0.0735783424077435,0.18857388316151202,,,547,448
46,46,5,1,7,1,2,3,555,430,85,18,96,2018/35,0.09036600120992136,0.18857388316151202,,,640,448
47,47,2,1,8,0,0,0,225,493,379,26,-1,,0.06268905021173624,0.21735395189003437,,,604,519
48,48,3,1,8,1,0,0,225,493,379,26,-1,,0.06268905021173624,0.21735395189003437,,,604,519
49,49,4,1,8,1,1,0,225,493,379,26,-1,,0.06268905021173624,0.21735395189003437,,,604,519
50,50,5,1,8,1,1,1,225,493,45,26,93,(21),0.037431941923774956,0.21735395189003437,,,270,519
51,51,5,1,8,1,1,2,285,495,186,18,91,Anmeldenummer:,0.05716878402903811,0.21649484536082475,,,471,513
52,52,5,1,8,1,1,3,481,495,123,18,92,18000143.0,0.08204779189352691,0.21649484536082475,application_number,18000143,604,513
53,53,2,1,9,0,0,0,225,559,319,26,-1,,0.05815184513006655,0.24570446735395188,,,544,585
54,54,3,1,9,1,0,0,225,559,319,26,-1,,0.05815184513006655,0.24570446735395188,,,544,585
55,55,4,1,9,1,1,0,225,559,319,26,-1,,0.05815184513006655,0.24570446735395188,,,544,585
56,56,5,1,9,1,1,1,225,559,45,26,93,(22),0.037431941923774956,0.24570446735395188,,,270,585
57,57,5,1,9,1,1,2,285,561,131,23,91,Anmeldetag:,0.0530096793708409,0.24591924398625428,,,416,584
58,58,5,1,9,1,1,3,427,561,117,18,96,15.02.2018,0.07342710223835451,0.24484536082474226,filing_date,15.02.2018,544,579
59,59,2,1,10,0,0,0,1002,245,458,38,-1,,0.18617664851784635,0.1134020618556701,,,1460,283
60,60,3,1,10,1,0,0,1002,245,458,38,-1,,0.18617664851784635,0.1134020618556701,,,1460,283
61,61,4,1,10,1,1,0,1002,245,458,38,-1,,0.18617664851784635,0.1134020618556701,,,1460,283
62,62,5,1,10,1,1,1,1002,256,44,27,74,(11),0.15486993345432548,0.11576460481099657,,,1046,283
63,63,5,1,10,1,1,2,1146,245,52,32,95,EP,0.17725347852389595,0.11211340206185567,number,EP,1198,277
64,64,5,1,10,1,1,3,1214,245,20,32,95,3,0.1851179673321234,0.11211340206185567,number,3,1234,277
65,65,5,1,10,1,1,4,1249,245,68,32,96,366,0.1940411373260738,0.11211340206185567,number,366,1317,277
66,66,5,1,10,1,1,5,1331,245,69,32,87,925,0.20651845130066546,0.11211340206185567,number,925,1400,277
67,67,5,1,10,1,1,6,1413,245,47,32,87,A1,0.21725650332728372,0.11211340206185567,number,A1,1460,277
68,68,2,1,11,0,0,0,559,314,573,31,-1,,0.1278735632183908,0.14153780068728522,,,1132,345
69,69,3,1,11,1,0,0,559,314,573,31,-1,,0.1278735632183908,0.14153780068728522,,,1132,345
70,70,4,1,11,1,1,0,559,314,573,31,-1,,0.1278735632183908,0.14153780068728522,,,1132,345
71,71,5,1,11,1,1,1,559,314,230,31,92,EUROPAISCHE,0.10193587416817906,0.14153780068728522,,,789,345
72,72,5,1,11,1,1,2,802,319,330,26,91,PATENTANMELDUNG,0.14624924379915305,0.14261168384879724,,,1132,345
73,73,2,1,12,0,0,0,862,395,126,26,-1,,0.13989715668481548,0.17525773195876287,,,988,421
74,74,3,1,12,1,0,0,862,395,126,26,-1,,0.13989715668481548,0.17525773195876287,,,988,421
75,75,4,1,12,1,1,0,862,395,126,26,-1,,0.13989715668481548,0.17525773195876287,,,988,421
76,76,5,1,12,1,1,1,862,395,44,26,67,(51),0.1336963097398669,0.17525773195876287,,,906,421
77,77,5,1,12,1,1,2,923,397,25,18,93,Int,0.1414851784633999,0.17439862542955326,,,948,415
78,78,5,1,12,1,1,3,955,397,33,18,65,Cl:,0.14692982456140352,0.17439862542955326,,,988,415
79,79,2,1,13,0,0,0,922,425,468,21,-1,,0.17483363581367212,0.1870704467353952,,,1390,446
80,80,3,1,13,1,0,0,922,425,468,21,-1,,0.17483363581367212,0.1870704467353952,,,1390,446
81,81,4,1,13,1,1,0,922,425,468,21,-1,,0.17483363581367212,0.1870704467353952,,,1390,446
82,82,5,1,13,1,1,1,922,428,57,18,43,FO4D,0.14375378100423472,0.1877147766323024,class_international,F04D,979,446
83,83,5,1,13,1,1,2,989,428,57,18,87,15100,0.15388687235329704,0.1877147766323024,class_international,15/00,1046,446
84,84,5,1,13,1,1,3,1051,425,67,16,69,(2006.01),0.16401996370235936,0.18599656357388317,,,1118,441
85,85,5,1,13,1,1,4,1193,428,57,18,91,F24D,0.18473986690865093,0.1877147766323024,,,1250,446
86,86,5,1,13,1,1,5,1260,428,57,18,78,19/10,0.19487295825771325,0.1877147766323024,,,1317,446
87,87,5,1,13,1,1,6,1323,425,67,16,68,(2006.07),0.20515728977616454,0.18599656357388317,,,1390,441
88,88,2,1,14,0,0,0,224,613,1243,4,-1,,0.1278735632183908,0.26417525773195877,,,1467,617
89,89,3,1,14,1,0,0,224,613,1243,4,-1,,0.1278735632183908,0.26417525773195877,,,1467,617
90,90,4,1,14,1,1,0,224,613,1243,4,-1,,0.1278735632183908,0.26417525773195877,,,1467,617
91,91,5,1,14,1,1,1,224,613,1243,4,95, ,0.1278735632183908,0.26417525773195877,,,1467,617
92,92,2,1,15,0,0,0,225,631,599,250,-1,,0.07932546884452511,0.3247422680412371,,,824,881
93,93,3,1,15,1,0,0,225,631,599,250,-1,,0.07932546884452511,0.3247422680412371,,,824,881
94,94,4,1,15,1,1,0,225,631,342,27,-1,,0.05989110707803993,0.2768470790378007,,,567,658
95,95,5,1,15,1,1,1,225,631,45,27,93,(84),0.037431941923774956,0.2768470790378007,,,270,658
96,96,5,1,15,1,1,2,286,633,100,19,93,Benannte,0.050816696914700546,0.2759879725085911,,,386,652
97,97,5,1,15,1,1,3,393,633,174,23,92,Vertragsstaaten:,0.07259528130671507,0.2768470790378007,,,567,656
98,98,4,1,15,1,2,0,285,666,537,18,-1,,0.08371143375680581,0.28994845360824745,,,822,684
99,99,5,1,15,1,2,1,285,666,31,18,94,AL,0.04544767090139141,0.28994845360824745,,,316,684
100,100,5,1,15,1,2,2,323,666,31,18,94,AT,0.05119479733817302,0.28994845360824745,,,354,684
101,101,5,1,15,1,2,3,363,666,30,18,95,BE,0.05716878402903811,0.28994845360824745,,,393,684
102,102,5,1,15,1,2,4,403,666,32,18,95,BG,0.0633696309739867,0.28994845360824745,,,435,684
103,103,5,1,15,1,2,5,445,666,31,18,95,CH,0.06964609800362977,0.28994845360824745,,,476,684
104,104,5,1,15,1,2,6,486,666,32,18,96,CY,0.07592256503327284,0.28994845360824745,,,518,684
105,105,5,1,15,1,2,7,526,666,30,18,96,CZ,0.08182093163944344,0.28994845360824745,,,556,684
106,106,5,1,15,1,2,8,565,666,30,18,96,DE,0.08771929824561403,0.28994845360824745,,,595,684
107,107,5,1,15,1,2,9,605,666,32,18,93,DK,0.09392014519056262,0.28994845360824745,,,637,684
108,108,5,1,15,1,2,10,646,666,29,18,93,EE,0.0998941318814277,0.28994845360824745,,,675,684
109,109,5,1,15,1,2,11,684,666,29,18,93,ES,0.10564125831820932,0.28994845360824745,,,713,684
110,110,5,1,15,1,2,12,723,666,99,18,86,FIFRGB,0.11683303085299455,0.28994845360824745,,,822,684
111,111,4,1,15,1,3,0,285,699,539,18,-1,,0.0838626739261948,0.30412371134020616,,,824,717
112,112,5,1,15,1,3,1,285,699,35,18,94,GR,0.04575015124016939,0.30412371134020616,,,320,717
113,113,5,1,15,1,3,2,328,699,32,18,94,HR,0.05202661826981246,0.30412371134020616,,,360,717
114,114,5,1,15,1,3,3,368,699,14,18,41,HU,0.05671506352087114,0.30412371134020616,,,382,717
115,115,5,1,15,1,3,4,385,699,43,18,41,IE,0.06147912885662432,0.30412371134020616,,,428,717
116,116,5,1,15,1,3,5,436,699,20,18,47,IS,0.06745311554748941,0.30412371134020616,,,456,717
117,117,5,1,15,1,3,6,464,699,20,18,47,IT,0.07168784029038112,0.30412371134020616,,,484,717
118,118,5,1,15,1,3,7,492,699,54,18,83,LILT,0.07849364791288566,0.30412371134020616,,,546,717
119,119,5,1,15,1,3,8,554,699,28,18,75,LU,0.08590441621294616,0.30412371134020616,,,582,717
120,120,5,1,15,1,3,9,591,699,28,18,75,LV,0.09150030248033877,0.30412371134020616,,,619,717
121,121,5,1,15,1,3,10,627,699,35,18,95,MC,0.09747428917120388,0.30412371134020616,,,662,717
122,122,5,1,15,1,3,11,670,699,35,18,94,MK,0.10397761645493044,0.30412371134020616,,,705,717
123,123,5,1,15,1,3,12,713,699,32,18,93,MT,0.11025408348457351,0.30412371134020616,,,745,717
124,124,5,1,15,1,3,13,753,699,29,18,20,NL,0.11607683000604961,0.30412371134020616,,,782,717
125,125,5,1,15,1,3,14,791,699,33,18,20,NO,0.1221264367816092,0.30412371134020616,,,824,717
126,126,4,1,15,1,4,0,286,732,336,18,-1,,0.06866303690260134,0.31829896907216493,,,622,750
127,127,5,1,15,1,4,1,286,732,28,18,95,PL,0.045372050816696916,0.31829896907216493,,,314,750
128,128,5,1,15,1,4,2,323,732,29,18,92,PT,0.05104355716878403,0.31829896907216493,,,352,750
129,129,5,1,15,1,4,3,360,732,58,18,92,RORS,0.058832425892317,0.31829896907216493,,,418,750
130,130,5,1,15,1,4,4,420,732,52,18,96,SE,0.06745311554748941,0.31829896907216493,,,472,750
131,131,5,1,15,1,4,5,480,732,20,18,91,SI,0.07410768300060495,0.31829896907216493,,,500,750
132,132,5,1,15,1,4,6,510,732,31,18,91,SK,0.0794767090139141,0.31829896907216493,,,541,750
133,133,5,1,15,1,4,7,550,732,72,18,91,SMTR,0.08862673926194797,0.31829896907216493,,,622,750
134,134,4,1,15,1,5,0,286,765,330,23,-1,,0.06820931639443437,0.3335481099656357,,,616,788
135,135,5,1,15,1,5,1,286,765,100,18,92,Benannte,0.050816696914700546,0.3324742268041237,,,386,783
136,136,5,1,15,1,5,2,395,765,221,23,91,Erstreckungsstaaten:,0.0764519056261343,0.3335481099656357,,,616,788
137,137,4,1,15,1,6,0,286,797,74,19,-1,,0.04885057471264368,0.34643470790378006,,,360,816
138,138,5,1,15,1,6,1,286,797,33,19,96,BA,0.04575015124016939,0.34643470790378006,,,319,816
139,139,5,1,15,1,6,2,327,797,33,19,96,ME,0.05195099818511797,0.34643470790378006,,,360,816
140,140,4,1,15,1,7,0,286,830,322,23,-1,,0.06760435571687841,0.36146907216494845,,,608,853
141,141,5,1,15,1,7,1,286,830,100,18,92,Benannte,0.050816696914700546,0.3603951890034364,,,386,848
142,142,5,1,15,1,7,2,393,830,215,23,92,Validierungsstaaten:,0.07569570477918935,0.36146907216494845,,,608,853
143,143,4,1,15,1,8,0,286,863,116,18,-1,,0.05202661826981246,0.3745704467353952,,,402,881
144,144,5,1,15,1,8,1,286,863,35,18,95,MA,0.04590139140955838,0.3745704467353952,,,321,881
145,145,5,1,15,1,8,2,330,863,34,18,94,MD,0.05248033877797943,0.3745704467353952,,,364,881
146,146,5,1,15,1,8,3,373,863,29,18,92,TN,0.05860556563823351,0.3745704467353952,,,402,881
147,147,2,1,16,0,0,0,225,927,491,26,-1,,0.07115849969751967,0.40378006872852235,,,716,953
148,148,3,1,16,1,0,0,225,927,491,26,-1,,0.07115849969751967,0.40378006872852235,,,716,953
149,149,4,1,16,1,1,0,225,927,491,26,-1,,0.07115849969751967,0.40378006872852235,,,716,953
150,150,5,1,16,1,1,1,225,927,45,26,92,(30),0.037431941923774956,0.40378006872852235,,,270,953
151,151,5,1,16,1,1,2,286,929,86,18,67,Prioritat:,0.04975801572897762,0.4029209621993127,,,372,947
152,152,5,1,16,1,1,3,383,929,118,18,94,23.02.2017,0.06684815486993345,0.4029209621993127,priority_date_eu,23.02.2017,501,947
153,153,5,1,16,1,1,4,520,929,30,18,94,DE,0.0809134906231095,0.4029209621993127,,,550,947
154,154,5,1,16,1,1,5,559,929,157,18,96,102017001722,0.09641560798548095,0.4029209621993127,,,716,947
155,155,2,1,17,0,0,0,225,992,301,58,-1,,0.05679068360556564,0.438573883161512,,,526,1050
156,156,3,1,17,1,0,0,225,992,301,58,-1,,0.05679068360556564,0.438573883161512,,,526,1050
157,157,4,1,17,1,1,0,225,992,275,26,-1,,0.05482456140350877,0.43170103092783507,,,500,1018
158,158,5,1,17,1,1,1,225,992,45,26,93,(71),0.037431941923774956,0.43170103092783507,,,270,1018
159,159,5,1,17,1,1,2,285,994,106,18,91,Anmelder:,0.051119177253478525,0.43084192439862545,,,391,1012
160,160,5,1,17,1,1,3,400,994,61,18,92,WILO,0.06510889292196008,0.43084192439862545,applicant_line_1,WILO,461,1012
161,161,5,1,17,1,1,4,470,994,30,18,96,SE,0.07335148215366001,0.43084192439862545,applicant_line_1,SE,500,1012
162,162,4,1,17,1,2,0,285,1027,241,23,-1,,0.06132788868723533,0.44609106529209624,,,526,1050
163,163,5,1,17,1,2,1,285,1027,65,18,96,44263,0.04801875378100424,0.44501718213058417,,,350,1045
164,164,5,1,17,1,2,2,359,1027,111,18,96,Dortmund,0.06268905021173624,0.44501718213058417,,,470,1045
165,165,5,1,17,1,2,3,479,1027,47,23,96,(DE),0.07599818511796733,0.44609106529209624,,,526,1050
166,166,2,1,18,0,0,0,845,614,2,468,-1,,0.1279491833030853,0.3642611683848797,,,847,1082
167,167,3,1,18,1,0,0,845,614,2,468,-1,,0.1279491833030853,0.3642611683848797,,,847,1082
168,168,4,1,18,1,1,0,845,614,2,468,-1,,0.1279491833030853,0.3642611683848797,,,847,1082
169,169,5,1,18,1,1,1,845,614,2,468,95, ,0.1279491833030853,0.3642611683848797,,,847,1082
170,170,2,1,19,0,0,0,862,631,315,222,-1,,0.154189352692075,0.31872852233676974,,,1177,853
171,171,3,1,19,1,0,0,862,631,315,222,-1,,0.154189352692075,0.31872852233676974,,,1177,853
172,172,4,1,19,1,1,0,862,631,147,27,-1,,0.1414851784633999,0.2768470790378007,,,1009,658
173,173,5,1,19,1,1,1,862,631,44,27,90,(72),0.1336963097398669,0.2768470790378007,,,906,658
174,174,5,1,19,1,1,2,923,633,86,19,89,Erfinder:,0.14609800362976408,0.2759879725085911,,,1009,652
175,175,4,1,19,1,2,0,898,666,192,22,-1,,0.15033272837265577,0.29080756013745707,,,1090,688
176,176,5,1,19,1,2,1,898,671,7,8,61,¬¢,0.13634301270417423,0.28994845360824745,,,905,679
177,177,5,1,19,1,2,2,923,666,58,22,96,"Huth,",0.14398064125831822,0.29080756013745707,inventor_line_1,"Huth,",981,688
178,178,5,1,19,1,2,3,990,666,100,18,96,Christian,0.1572897761645493,0.28994845360824745,inventor_line_1,Christian,1090,684
179,179,4,1,19,1,3,0,922,699,240,23,-1,,0.15759225650332728,0.30519759450171824,,,1162,722
180,180,5,1,19,1,3,1,922,699,64,18,96,44287,0.1442831215970962,0.30412371134020616,,,986,717
181,181,5,1,19,1,3,2,996,699,110,18,96,Dortmund,0.1589534180278282,0.30412371134020616,,,1106,717
182,182,5,1,19,1,3,3,1116,699,46,23,96,(DE),0.1722625529340593,0.30519759450171824,,,1162,722
183,183,4,1,19,1,4,0,898,732,201,23,-1,,0.15101330913490624,0.31937285223367695,,,1099,755
184,184,5,1,19,1,4,1,898,737,7,8,58,¬´,0.13634301270417423,0.31829896907216493,,,905,745
185,185,5,1,19,1,4,2,923,732,77,23,95,"Knapp,",0.1454174228675136,0.31937285223367695,,,1000,755
186,186,5,1,19,1,4,3,1009,732,90,18,95,Thomas,0.15940713853599517,0.31829896907216493,,,1099,750
187,187,4,1,19,1,5,0,922,765,255,23,-1,,0.1587265577737447,0.3335481099656357,,,1177,788
188,188,5,1,19,1,5,1,922,765,64,18,93,33803,0.1442831215970962,0.3324742268041237,,,986,783
189,189,5,1,19,1,5,2,995,765,126,23,92,Steinhagen,0.1600120992135511,0.3335481099656357,,,1121,788
190,190,5,1,19,1,5,3,1130,765,47,23,94,(DE),0.17445553539019965,0.3335481099656357,,,1177,788
191,191,4,1,19,1,6,0,898,797,220,23,-1,,0.15245009074410162,0.3472938144329897,,,1118,820
192,192,5,1,19,1,6,1,898,803,7,7,15,*,0.13634301270417423,0.34643470790378006,,,905,810
193,193,5,1,19,1,6,2,923,797,87,23,95,"Kettner,",0.14617362371445855,0.3472938144329897,,,1010,820
194,194,5,1,19,1,6,3,1018,797,100,19,96,Thorsten,0.16152450090744103,0.34643470790378006,,,1118,816
195,195,4,1,19,1,7,0,922,830,207,23,-1,,0.15509679370840895,0.36146907216494845,,,1129,853
196,196,5,1,19,1,7,1,922,830,62,18,93,45711,0.1441318814277072,0.3603951890034364,,,984,848
197,197,5,1,19,1,7,2,996,830,77,18,60,Datteln,0.15645795523290987,0.3603951890034364,,,1073,848
198,198,5,1,19,1,7,3,1082,830,47,23,96,(DE),0.16719600725952813,0.36146907216494845,,,1129,853
199,199,2,1,20,0,0,0,862,893,575,124,-1,,0.17385057471264367,0.4102233676975945,,,1437,1017
200,200,3,1,20,1,0,0,862,893,575,124,-1,,0.17385057471264367,0.4102233676975945,,,1437,1017
201,201,4,1,20,1,1,0,862,893,575,27,-1,,0.17385057471264367,0.3893900343642612,,,1437,920
202,202,5,1,20,1,1,1,862,893,44,27,93,(74),0.1336963097398669,0.3893900343642612,,,906,920
203,203,5,1,20,1,1,2,921,895,97,19,91,Vertreter:,0.14662734422262552,0.38853092783505155,,,1018,914
204,204,5,1,20,1,1,3,1028,895,98,19,92,Cohausz,0.1628856624319419,0.38853092783505155,representative_line_1_eu,Cohausz,1126,914
205,205,5,1,20,1,1,4,1135,895,78,23,90,Hannig,0.17755595886267392,0.3893900343642612,representative_line_1_eu,Hannig,1213,918
206,206,5,1,20,1,1,5,1223,895,117,19,93,Borkowski,0.1938142770719903,0.38853092783505155,representative_line_1_eu,Borkowski,1340,914
207,207,5,1,20,1,1,6,1348,895,89,23,45,Wikgott,0.21060193587416817,0.3893900343642612,representative_line_1_eu,Wi‚àö√ºgott,1437,918
208,208,4,1,20,1,2,0,923,929,382,18,-1,,0.16848154869933454,0.4029209621993127,,,1305,947
209,209,5,1,20,1,2,1,923,929,78,18,93,Patent-,0.1454930429522081,0.4029209621993127,,,1001,947
210,210,5,1,20,1,2,2,1010,929,41,18,93,und,0.1558529945553539,0.4029209621993127,,,1051,947
211,211,5,1,20,1,2,3,1061,929,244,18,91,Rechtsanwaltskanzlei,0.17891712038717483,0.4029209621993127,,,1305,947
212,212,4,1,20,1,3,0,922,961,272,19,-1,,0.1600120992135511,0.4168814432989691,,,1194,980
213,213,5,1,20,1,3,1,922,961,203,19,91,Schumannstrasse,0.15479431336963098,0.4168814432989691,,,1125,980
214,214,5,1,20,1,3,2,1134,961,60,19,96,97-99,0.17604355716878403,0.4168814432989691,,,1194,980
215,215,4,1,20,1,4,0,922,994,251,23,-1,,0.15842407743496673,0.4319158075601375,,,1173,1017
216,216,5,1,20,1,4,1,922,994,64,18,93,40237,0.1442831215970962,0.43084192439862545,,,986,1012
217,217,5,1,20,1,4,2,996,994,123,18,90,Diisseldorf,0.1599364791288566,0.43084192439862545,,,1119,1012
218,218,5,1,20,1,4,3,1126,994,47,23,96,(DE),0.17385057471264367,0.4319158075601375,,,1173,1017
219,219,2,1,21,0,0,0,224,1079,1243,4,-1,,0.1278735632183908,0.4643470790378007,,,1467,1083
220,220,3,1,21,1,0,0,224,1079,1243,4,-1,,0.1278735632183908,0.4643470790378007,,,1467,1083
221,221,4,1,21,1,1,0,224,1079,1243,4,-1,,0.1278735632183908,0.4643470790378007,,,1467,1083
222,222,5,1,21,1,1,1,224,1079,1243,4,95, ,0.1278735632183908,0.4643470790378007,,,1467,1083
223,223,2,1,22,0,0,0,225,1099,45,26,-1,,0.037431941923774956,0.47766323024054985,,,270,1125
224,224,3,1,22,1,0,0,225,1099,45,26,-1,,0.037431941923774956,0.47766323024054985,,,270,1125
225,225,4,1,22,1,1,0,225,1099,45,26,-1,,0.037431941923774956,0.47766323024054985,,,270,1125
226,226,5,1,22,1,1,1,225,1099,45,26,96,(54),0.037431941923774956,0.47766323024054985,,,270,1125
227,227,2,1,23,0,0,0,315,1099,1029,21,-1,,0.12545372050816697,0.47658934707903783,,,1344,1120
228,228,3,1,23,1,0,0,315,1099,1029,21,-1,,0.12545372050816697,0.47658934707903783,,,1344,1120
229,229,4,1,23,1,1,0,315,1099,1029,21,-1,,0.12545372050816697,0.47658934707903783,,,1344,1120
230,230,5,1,23,1,1,1,315,1099,163,20,90,VERFAHREN,0.05996672716273442,0.47637457044673537,title_line_1,VERFAHREN,478,1119
231,231,5,1,23,1,1,2,487,1099,54,21,93,ZUR,0.07773744706594071,0.47658934707903783,title_line_1,ZUR,541,1120
232,232,5,1,23,1,1,3,551,1099,318,21,91,BETRIEBSEINSTELLUNG,0.1073805202661827,0.47658934707903783,title_line_1,BETRIEBSEINSTELLUNG,869,1120
233,233,5,1,23,1,1,4,880,1099,77,21,93,EINES,0.13891409558378706,0.47658934707903783,title_line_1,EINES,957,1120
234,234,5,1,23,1,1,5,967,1099,266,21,92,PUMPENAGGREGATS,0.16636418632788869,0.47658934707903783,,,1233,1120
235,235,5,1,23,1,1,6,1234,1099,110,21,96,SOWIE,0.19494857834240775,0.47658934707903783,title_line_1,SOWIE,1344,1120
236,236,2,1,24,0,0,0,315,1127,1143,25,-1,,0.13407441016333937,0.4894759450171821,,,1458,1152
237,237,3,1,24,1,0,0,315,1127,1143,25,-1,,0.13407441016333937,0.4894759450171821,,,1458,1152
238,238,4,1,24,1,1,0,315,1127,1143,25,-1,,0.13407441016333937,0.4894759450171821,,,1458,1152
239,239,5,1,24,1,1,1,315,1131,152,21,92,ANORDNUNG,0.05913490623109498,0.49033505154639173,,,467,1152
240,240,5,1,24,1,1,2,471,1131,105,21,93,EINES,0.07917422867513611,0.49033505154639173,,,576,1152
241,241,5,1,24,1,1,3,586,1131,265,21,92,PUMPENAGGREGATS,0.10866606170598911,0.49033505154639173,title_line_1,PUMPENAGGREGATS,851,1152
242,242,5,1,24,1,1,4,852,1131,60,21,96,UND,0.13339382940108893,0.49033505154639173,,,912,1152
243,243,5,1,24,1,1,5,917,1132,104,20,95,EINER,0.14655172413793102,0.49054982817869414,,,1021,1152
244,244,5,1,24,1,1,6,1031,1131,170,21,95,ELEKTRONIK,0.16878402903811252,0.49033505154639173,,,1201,1152
245,245,5,1,24,1,1,7,1210,1132,53,20,93,ZUR,0.1870084694494858,0.49054982817869414,,,1263,1152
246,246,5,1,24,1,1,8,1271,1127,187,25,92,AUSFUHRUNG,0.20636721113127646,0.4894759450171821,,,1458,1152
247,247,2,1,25,0,0,0,316,1165,243,21,-1,,0.066167574107683,0.5049398625429553,,,559,1186
248,248,3,1,25,1,0,0,316,1165,243,21,-1,,0.066167574107683,0.5049398625429553,,,559,1186
249,249,4,1,25,1,1,0,316,1165,243,21,-1,,0.066167574107683,0.5049398625429553,,,559,1186
250,250,5,1,25,1,1,1,316,1165,52,21,93,DES,0.05172413793103448,0.5049398625429553,,,368,1186
251,251,5,1,25,1,1,2,377,1165,182,21,91,VERFAHRENS,0.07078039927404718,0.5049398625429553,,,559,1186
252,252,2,1,26,0,0,0,224,1239,584,943,-1,,0.0780399274047187,0.7347508591065293,,,808,2182
253,253,3,1,26,1,0,0,224,1239,584,943,-1,,0.0780399274047187,0.7347508591065293,,,808,2182
254,254,4,1,26,1,1,0,225,1239,582,26,-1,,0.0780399274047187,0.5378006872852233,,,807,1265
255,255,5,1,26,1,1,1,225,1239,45,26,93,(57),0.037431941923774956,0.5378006872852233,,,270,1265
256,256,5,1,26,1,1,2,316,1241,33,18,57,Die,0.05028735632183908,0.5369415807560137,,,349,1259
257,257,5,1,26,1,1,3,356,1241,99,23,92,Erfindung,0.06132788868723533,0.5380154639175257,,,455,1264
258,258,5,1,26,1,1,4,462,1241,65,18,90,betrifft,0.07478826376285541,0.5369415807560137,,,527,1259
259,259,5,1,26,1,1,5,532,1241,29,18,94,ein,0.08265275257108289,0.5369415807560137,,,561,1259
260,260,5,1,26,1,1,6,566,1241,103,18,94,Verfahren,0.09339080459770115,0.5369415807560137,,,669,1259
261,261,5,1,26,1,1,7,675,1246,33,13,92,zur,0.10458257713248639,0.5380154639175257,,,708,1259
262,262,5,1,26,1,1,8,714,1241,93,18,92,Betriebs-,0.11501814882032668,0.5369415807560137,,,807,1259
263,263,4,1,26,1,2,0,225,1274,582,23,-1,,0.0780399274047187,0.5521907216494846,,,807,1297
264,264,5,1,26,1,2,1,225,1274,112,23,91,einstellung,0.04249848759830611,0.5521907216494846,,,337,1297
265,265,5,1,26,1,2,2,346,1274,56,18,96,eines,0.056563823351482155,0.5511168384879725,,,402,1292
266,266,5,1,26,1,2,3,411,1274,15,18,96,in,0.0632940108892922,0.5511168384879725,,,426,1292
267,267,5,1,26,1,2,4,435,1274,64,18,93,seiner,0.0706291591046582,0.5511168384879725,,,499,1292
268,268,5,1,26,1,2,5,508,1274,87,23,92,Leistung,0.08340895341802783,0.5521907216494846,,,595,1297
269,269,5,1,26,1,2,6,605,1274,111,23,91,regelbaren,0.0998941318814277,0.5521907216494846,,,716,1297
270,270,5,1,26,1,2,7,726,1274,81,23,92,Pumpe-,0.11592558983666061,0.5521907216494846,,,807,1297
271,271,4,1,26,1,3,0,226,1306,581,23,-1,,0.07811554748941318,0.5659364261168385,,,807,1329
272,272,5,1,26,1,3,1,226,1307,117,22,92,naggregats,0.04302782819116757,0.5661512027491409,,,343,1329
273,273,5,1,26,1,3,2,351,1306,27,23,91,(1),0.055127041742286755,0.5659364261168385,,,378,1329
274,274,5,1,26,1,3,3,387,1306,16,19,91,in,0.059739866908650935,0.5650773195876289,,,403,1325
275,275,5,1,26,1,3,4,411,1306,52,19,93,einer,0.06609195402298851,0.5650773195876289,,,463,1325
276,276,5,1,26,1,3,5,472,1306,144,23,91,hydraulischen,0.0822746521476104,0.5659364261168385,,,616,1329
277,277,5,1,26,1,3,6,624,1306,74,23,92,Anlage,0.0999697519661222,0.5659364261168385,,,698,1329
278,278,5,1,26,1,3,7,705,1306,56,19,93,eines,0.11085904416212947,0.5650773195876289,,,761,1325
279,279,5,1,26,1,3,8,769,1306,38,19,91,Ge-,0.1191772534785239,0.5650773195876289,,,807,1325
280,280,4,1,26,1,4,0,226,1339,582,23,-1,,0.07819116757410768,0.5801116838487973,,,808,1362
281,281,5,1,26,1,4,1,226,1339,76,18,91,baudes,0.039927404718693285,0.5790378006872853,,,302,1357
282,282,5,1,26,1,4,2,313,1339,30,18,96,mit,0.049606775559588624,0.5790378006872853,,,343,1357
283,283,5,1,26,1,4,3,352,1339,53,18,96,einer,0.057244404113732605,0.5790378006872853,,,405,1357
284,284,5,1,26,1,4,4,414,1339,71,18,96,Anzahl,0.06798245614035088,0.5790378006872853,,,485,1357
285,285,5,1,26,1,4,5,496,1344,24,13,96,an,0.07683000604960677,0.5801116838487973,,,520,1357
286,286,5,1,26,1,4,6,531,1344,43,13,90,vom,0.08356019358741681,0.5801116838487973,,,574,1357
287,287,5,1,26,1,4,7,586,1339,181,23,90,Pumpenaggregat,0.10231397459165155,0.5801116838487973,,,767,1362
288,288,5,1,26,1,4,8,778,1339,30,18,97,mit,0.11993345432546884,0.5790378006872853,,,808,1357
289,289,4,1,26,1,5,0,224,1372,583,23,-1,,0.0779643073200242,0.594286941580756,,,807,1395
290,290,5,1,26,1,5,1,224,1372,85,19,92,Warme-,0.04030550514216576,0.5934278350515464,,,309,1391
291,291,5,1,26,1,5,2,325,1372,48,19,93,oder,0.05278281911675741,0.5934278350515464,,,373,1391
292,292,5,1,26,1,5,3,390,1372,127,23,88,Kihlleistung,0.06858741681790684,0.594286941580756,,,517,1395
293,293,5,1,26,1,5,4,535,1373,111,22,91,versorgten,0.08930732002419843,0.5945017182130584,,,646,1395
294,294,5,1,26,1,5,5,664,1372,143,19,92,Verbrauchern,0.11123714458560194,0.5934278350515464,,,807,1391
295,295,4,1,26,1,6,0,225,1405,582,27,-1,,0.0780399274047187,0.6093213058419243,,,807,1432
296,296,5,1,26,1,6,1,225,1405,57,18,93,durch,0.03833938294010889,0.6073883161512027,,,282,1423
297,297,5,1,26,1,6,2,292,1405,89,23,93,Vorgabe,0.05089231699939504,0.6084621993127147,,,381,1428
298,298,5,1,26,1,6,3,391,1405,55,18,93,eines,0.0632940108892922,0.6073883161512027,,,446,1423
299,299,5,1,26,1,6,4,455,1405,146,23,92,Vorgabewerts,0.07985480943738657,0.6084621993127147,,,601,1428
300,300,5,1,26,1,6,5,611,1405,39,27,38,(Ny,0.09535692679975802,0.6093213058419243,,,650,1432
301,301,5,1,26,1,6,6,660,1405,31,27,84,Nz,0.10216273442226255,0.6093213058419243,,,691,1432
302,302,5,1,26,1,6,7,701,1405,30,27,78,Ng,0.10828796128251664,0.6093213058419243,,,731,1432
303,303,5,1,26,1,6,8,742,1405,20,25,92,Fy,0.11373260738052027,0.6088917525773195,,,762,1430
304,304,5,1,26,1,6,9,767,1405,40,27,90,"Fo,",0.11902601330913491,0.6093213058419243,,,807,1432
305,305,4,1,26,1,7,0,226,1438,581,25,-1,,0.07811554748941318,0.6230670103092784,,,807,1463
306,306,5,1,26,1,7,1,226,1438,30,25,74,Fs),0.03644888082274652,0.6230670103092784,,,256,1463
307,307,5,1,26,1,7,2,265,1438,53,18,93,einer,0.0440865093768905,0.6215635738831615,,,318,1456
308,308,5,1,26,1,7,3,328,1438,137,23,46,Einstellgr√©Re,0.05996672716273442,0.6226374570446735,,,465,1461
309,309,5,1,26,1,7,4,475,1438,40,23,96,"(Nv,",0.07486388384754991,0.6226374570446735,,,515,1461
310,310,5,1,26,1,7,5,527,1438,33,25,70,"Np,",0.08219903206291591,0.6230670103092784,,,560,1463
311,311,5,1,26,1,7,6,572,1438,25,22,92,F).,0.08839987900786449,0.6224226804123711,,,597,1460
312,312,5,1,26,1,7,7,609,1438,32,18,96,Bei,0.09452510586811858,0.6215635738831615,,,641,1456
313,313,5,1,26,1,7,8,651,1438,74,18,96,diesem,0.10405323653962492,0.6215635738831615,,,725,1456
314,314,5,1,26,1,7,9,737,1438,22,18,92,ist,0.11312764670296431,0.6215635738831615,,,759,1456
315,315,5,1,26,1,7,10,767,1442,40,14,92,vor-,0.11902601330913491,0.6224226804123711,,,807,1456
316,316,4,1,26,1,8,0,225,1470,582,25,-1,,0.0780399274047187,0.6368127147766323,,,807,1495
317,317,5,1,26,1,8,1,225,1470,89,23,88,"gesehen,",0.04075922565033273,0.6363831615120275,,,314,1493
318,318,5,1,26,1,8,2,318,1470,61,22,95,dass,0.05270719903206292,0.636168384879725,,,379,1492
319,319,5,1,26,1,8,3,387,1470,31,19,93,die,0.060874168179068364,0.6355240549828178,,,418,1489
320,320,5,1,26,1,8,4,427,1470,137,23,20,Einstellgr√©Re,0.0749395039322444,0.6363831615120275,,,564,1493
321,321,5,1,26,1,8,5,573,1470,40,23,96,"(Nv,",0.0896854204476709,0.6363831615120275,,,613,1493
322,322,5,1,26,1,8,6,624,1470,34,25,54,"Np,",0.0969449485783424,0.6368127147766323,,,658,1495
323,323,5,1,26,1,8,7,668,1470,20,23,91,F),0.10254083484573502,0.6363831615120275,,,688,1493
324,324,5,1,26,1,8,8,697,1470,30,19,96,die,0.10768300060496068,0.6355240549828178,,,727,1489
325,325,5,1,26,1,8,9,735,1470,72,19,96,Anzahl,0.11660617059891107,0.6355240549828178,,,807,1489
326,326,4,1,26,1,9,0,225,1503,582,26,-1,,0.0780399274047187,0.6512027491408935,,,807,1529
327,327,5,1,26,1,9,1,225,1503,43,23,89,(Nv),0.03728070175438596,0.6505584192439863,,,268,1526
328,328,5,1,26,1,9,2,275,1503,34,18,92,der,0.044162129461584994,0.6494845360824743,,,309,1521
329,329,5,1,26,1,9,3,314,1503,132,18,92,Verbraucher,0.05747126436781609,0.6494845360824743,,,446,1521
330,330,5,1,26,1,9,4,452,1503,47,18,96,oder,0.07191470054446461,0.6494845360824743,,,499,1521
331,331,5,1,26,1,9,5,505,1503,43,18,96,eine,0.07962794918330308,0.6494845360824743,,,548,1521
332,332,5,1,26,1,9,6,554,1503,66,18,96,Anzahl,0.08877797943133696,0.6494845360824743,,,620,1521
333,333,5,1,26,1,9,7,624,1503,54,26,89,(Np),0.0984573502722323,0.6512027491408935,,,678,1529
334,334,5,1,26,1,9,8,685,1503,53,18,93,einer,0.10760738052026618,0.6494845360824743,,,738,1521
335,335,5,1,26,1,9,9,744,1503,63,18,92,hierzu,0.11728675136116153,0.6494845360824743,,,807,1521
336,336,4,1,26,1,10,0,226,1536,581,23,-1,,0.07811554748941318,0.664733676975945,,,807,1559
337,337,5,1,26,1,10,1,226,1536,209,23,91,korrespondierenden,0.0499848759830611,0.664733676975945,,,435,1559
338,338,5,1,26,1,10,2,445,1536,103,18,61,zahlbaren,0.0750907441016334,0.663659793814433,,,548,1554
339,339,5,1,26,1,10,3,559,1536,76,21,85,"Einheit,",0.09029038112522686,0.6643041237113402,,,635,1557
340,340,5,1,26,1,10,4,646,1536,46,18,96,oder,0.10117967332123412,0.663659793814433,,,692,1554
341,341,5,1,26,1,10,5,701,1536,30,18,95,die,0.10828796128251664,0.663659793814433,,,731,1554
342,342,5,1,26,1,10,6,741,1540,23,14,92,zu,0.11380822746521477,0.6645189003436426,,,764,1554
343,343,5,1,26,1,10,7,775,1536,32,18,92,be-,0.11963097398669087,0.663659793814433,,,807,1554
344,344,4,1,26,1,11,0,226,1569,580,23,-1,,0.0780399274047187,0.6789089347079038,,,806,1592
345,345,5,1,26,1,11,1,226,1569,94,18,92,heizende,0.04128856624319419,0.6778350515463918,,,320,1587
346,346,5,1,26,1,11,2,330,1569,47,18,93,oder,0.05346339987900786,0.6778350515463918,,,377,1587
347,347,5,1,26,1,11,3,388,1569,94,18,26,kithlende,0.06578947368421052,0.6778350515463918,,,482,1587
348,348,5,1,26,1,11,4,494,1569,68,18,89,Flache,0.07985480943738657,0.6778350515463918,,,562,1587
349,349,5,1,26,1,11,5,573,1569,28,23,90,(F),0.08877797943133696,0.6789089347079038,,,601,1592
350,350,5,1,26,1,11,6,612,1569,37,18,93,des,0.09535692679975802,0.6778350515463918,,,649,1587
351,351,5,1,26,1,11,7,660,1569,96,18,79,Gebaudes,0.10707803992740472,0.6778350515463918,,,756,1587
352,352,5,1,26,1,11,8,757,1569,49,21,96,"ist,",0.11819419237749547,0.678479381443299,,,806,1590
353,353,4,1,26,1,12,0,224,1602,584,27,-1,,0.0780399274047187,0.6939432989690721,,,808,1629
354,354,5,1,26,1,12,1,224,1602,62,18,91,wobei,0.03856624319419238,0.6920103092783505,,,286,1620
355,355,5,1,26,1,12,2,294,1606,37,14,96,aus,0.04726255293405929,0.6928694158075601,,,331,1620
356,356,5,1,26,1,12,3,339,1602,44,18,93,dem,0.05459770114942529,0.6920103092783505,,,383,1620
357,357,5,1,26,1,12,4,392,1602,135,23,92,Vorgabewert,0.06949485783424078,0.6930841924398625,,,527,1625
358,358,5,1,26,1,12,5,535,1602,31,25,26,"(N,",0.08325771324863884,0.6935137457044673,,,566,1627
359,359,5,1,26,1,12,6,571,1602,37,27,42,Nz,0.08915607985480943,0.6939432989690721,,,608,1629
360,360,5,1,26,1,12,7,610,1602,38,27,61,Ng,0.09513006654567453,0.6939432989690721,,,648,1629
361,361,5,1,26,1,12,8,650,1602,32,27,87,Fy,0.10072595281306715,0.6939432989690721,,,682,1629
362,362,5,1,26,1,12,9,687,1602,39,27,71,"Fo,",0.10685117967332124,0.6939432989690721,,,726,1629
363,363,5,1,26,1,12,10,735,1602,30,25,69,Fs),0.11343012704174228,0.6935137457044673,,,765,1627
364,364,5,1,26,1,12,11,774,1602,34,18,96,der,0.11963097398669087,0.6920103092783505,,,808,1620
365,365,4,1,26,1,13,0,226,1634,581,25,-1,,0.07811554748941318,0.7072594501718213,,,807,1659
366,366,5,1,26,1,13,1,226,1634,137,23,36,Einstellgr√©Be,0.04454022988505747,0.7068298969072165,,,363,1657
367,367,5,1,26,1,13,2,371,1634,41,25,96,"(Ny,",0.05921052631578947,0.7072594501718213,,,412,1659
368,368,5,1,26,1,13,3,422,1634,34,25,63,"Nr,",0.06639443436176648,0.7072594501718213,,,456,1659
369,369,5,1,26,1,13,4,466,1634,19,23,93,F),0.07191470054446461,0.7068298969072165,,,485,1657
370,370,5,1,26,1,13,5,493,1639,37,14,96,von,0.07735934664246824,0.7070446735395189,,,530,1653
371,371,5,1,26,1,13,6,539,1634,52,19,96,einer,0.08545069570477919,0.7059707903780069,,,591,1653
372,372,5,1,26,1,13,7,598,1634,44,19,92,dem,0.09376890502117362,0.7059707903780069,,,642,1653
373,373,5,1,26,1,13,8,652,1634,155,23,92,Pumpenaggre-,0.110329703569268,0.7068298969072165,,,807,1657
374,374,4,1,26,1,14,0,225,1667,582,25,-1,,0.0780399274047187,0.7214347079037801,,,807,1692
375,375,5,1,26,1,14,1,225,1668,33,22,96,gat,0.03652450090744102,0.7212199312714777,,,258,1690
376,376,5,1,26,1,14,2,264,1667,26,23,93,(1),0.04189352692075015,0.7210051546391752,,,290,1690
377,377,5,1,26,1,14,3,297,1667,144,23,92,zugeordneten,0.055807622504537205,0.7210051546391752,,,441,1690
378,378,5,1,26,1,14,4,449,1667,102,18,95,Elektronik,0.07562008469449485,0.7199312714776632,,,551,1685
379,379,5,1,26,1,14,5,558,1667,27,23,95,(4),0.08643375680580763,0.7210051546391752,,,585,1690
380,380,5,1,26,1,14,6,592,1667,29,18,91,ein,0.09172716273442226,0.7199312714776632,,,621,1685
381,381,5,1,26,1,14,7,629,1667,100,18,91,Kennwert,0.10269207501512402,0.7199312714776632,,,729,1685
382,382,5,1,26,1,14,8,735,1667,72,25,14,(Hyenn),0.11660617059891107,0.7214347079037801,,,807,1692
383,383,4,1,26,1,15,0,224,1700,583,23,-1,,0.0779643073200242,0.7351804123711341,,,807,1723
384,384,5,1,26,1,15,1,224,1700,28,18,57,fiir,0.035995160314579555,0.7341065292096219,,,252,1718
385,385,5,1,26,1,15,2,259,1700,30,18,93,die,0.041439806412583186,0.7341065292096219,,,289,1718
386,386,5,1,26,1,15,3,299,1700,120,18,33,Forderhdhe,0.05429522081064731,0.7341065292096219,,,419,1718
387,387,5,1,26,1,15,4,428,1700,31,23,92,(H),0.06707501512401694,0.7351804123711341,,,459,1723
388,388,5,1,26,1,15,5,469,1700,44,18,91,und/,0.07425892316999395,0.7341065292096219,,,513,1718
389,389,5,1,26,1,15,6,521,1700,46,18,96,oder,0.0822746521476104,0.7341065292096219,,,567,1718
390,390,5,1,26,1,15,7,575,1700,29,18,91,ein,0.08915607985480943,0.7341065292096219,,,604,1718
391,391,5,1,26,1,15,8,614,1700,99,18,91,Kennwert,0.10034785238959468,0.7341065292096219,,,713,1718
392,392,5,1,26,1,15,9,721,1700,86,23,92,(Qnenn),0.11554748941318814,0.7351804123711341,,,807,1723
393,393,4,1,26,1,16,0,224,1732,583,23,-1,,0.0779643073200242,0.748926116838488,,,807,1755
394,394,5,1,26,1,16,1,224,1732,28,19,78,fiir,0.035995160314579555,0.7480670103092784,,,252,1751
395,395,5,1,26,1,16,2,258,1732,38,19,93,den,0.04189352692075015,0.7480670103092784,,,296,1751
396,396,5,1,26,1,16,3,306,1732,126,19,82,F√©rderstrom,0.055807622504537205,0.7480670103092784,,,432,1751
397,397,5,1,26,1,16,4,441,1732,32,23,93,(Q),0.0691167574107683,0.748926116838488,,,473,1755
398,398,5,1,26,1,16,5,481,1732,37,19,92,des,0.07554446460980037,0.7480670103092784,,,518,1751
399,399,5,1,26,1,16,6,527,1732,181,23,90,Pumpenaggregats,0.09339080459770115,0.748926116838488,,,708,1755
400,400,5,1,26,1,16,7,709,1732,45,23,93,(1),0.11063218390804598,0.748926116838488,,,754,1755
401,401,5,1,26,1,16,8,762,1732,45,19,93,fest-,0.11864791288566243,0.7480670103092784,,,807,1751
402,402,4,1,26,1,17,0,225,1766,582,23,-1,,0.0780399274047187,0.7635309278350515,,,807,1789
403,403,5,1,26,1,17,1,225,1766,64,23,92,gelegt,0.038868723532970356,0.7635309278350515,,,289,1789
404,404,5,1,26,1,17,2,295,1766,37,18,96,und,0.04741379310344827,0.7624570446735395,,,332,1784
405,405,5,1,26,1,17,3,339,1766,37,18,93,das,0.054068360556563826,0.7624570446735395,,,376,1784
406,406,5,1,26,1,17,4,383,1766,174,23,92,Pumpenaggregat,0.07108287961282517,0.7635309278350515,,,557,1789
407,407,5,1,26,1,17,5,559,1766,38,23,96,(1),0.08741681790683606,0.7635309278350515,,,597,1789
408,408,5,1,26,1,17,6,605,1766,15,18,93,in,0.0926346037507562,0.7624570446735395,,,620,1784
409,409,5,1,26,1,17,7,627,1766,138,23,91,Abhangigkeit,0.10526315789473684,0.7635309278350515,,,765,1789
410,410,5,1,26,1,17,8,770,1766,37,18,96,des,0.11925287356321838,0.7624570446735395,,,807,1784
411,411,4,1,26,1,18,0,226,1799,581,25,-1,,0.07811554748941318,0.7781357388316151,,,807,1824
412,412,5,1,26,1,18,1,226,1799,110,18,92,Kennwerts,0.04249848759830611,0.7766323024054983,,,336,1817
413,413,5,1,26,1,18,2,342,1799,33,25,58,(Hy,0.05421960072595281,0.7781357388316151,,,375,1824
414,414,5,1,26,1,18,3,377,1813,29,11,54,enp),0.05921052631578947,0.7811426116838488,,,406,1824
415,415,5,1,26,1,18,4,408,1799,39,23,35,fir,0.06465517241379311,0.7777061855670103,,,447,1822
416,416,5,1,26,1,18,5,451,1799,30,18,92,die,0.07047791893526921,0.7766323024054983,,,481,1817
417,417,5,1,26,1,18,6,488,1799,121,18,7,Forderh6he,0.08295523290986086,0.7766323024054983,,,609,1817
418,418,5,1,26,1,18,7,614,1799,31,23,91,(H),0.09520568663036903,0.7777061855670103,,,645,1822
419,419,5,1,26,1,18,8,651,1799,47,18,94,oder,0.10201149425287356,0.7766323024054983,,,698,1817
420,420,5,1,26,1,18,9,702,1799,38,18,93,des,0.10904416212946158,0.7766323024054983,,,740,1817
421,421,5,1,26,1,18,10,746,1799,61,18,92,Kenn-,0.11743799153055051,0.7766323024054983,,,807,1817
422,422,4,1,26,1,19,0,224,1831,583,23,-1,,0.0779643073200242,0.7914518900343642,,,807,1854
423,423,5,1,26,1,19,1,224,1832,56,18,93,werts,0.038112522686025406,0.790807560137457,,,280,1850
424,424,5,1,26,1,19,2,289,1831,77,23,92,(Qnenn),0.04953115547489413,0.7914518900343642,,,366,1854
425,425,5,1,26,1,19,3,368,1831,42,23,78,fiir,0.058832425892317,0.7914518900343642,,,410,1854
426,426,5,1,26,1,19,4,417,1831,38,19,93,den,0.06594071385359952,0.7905927835051546,,,455,1850
427,427,5,1,26,1,19,5,466,1831,126,19,88,F√©rderstrom,0.08000604960677556,0.7905927835051546,,,592,1850
428,428,5,1,26,1,19,6,602,1831,32,23,91,(Q),0.09346642468239565,0.7914518900343642,,,634,1854
429,429,5,1,26,1,19,7,642,1831,47,19,96,oder,0.10065033272837265,0.7905927835051546,,,689,1850
430,430,5,1,26,1,19,8,697,1831,64,19,93,dieser,0.11025408348457351,0.7905927835051546,,,761,1850
431,431,5,1,26,1,19,9,770,1831,37,19,91,bei-,0.11925287356321838,0.7905927835051546,,,807,1850
432,432,4,1,26,1,20,0,225,1864,582,25,-1,,0.0780399274047187,0.8060567010309279,,,807,1889
433,433,5,1,26,1,20,1,225,1864,38,18,93,den,0.03690260133091349,0.804553264604811,,,263,1882
434,434,5,1,26,1,20,2,275,1864,112,18,92,Kennwerte,0.050060496067755596,0.804553264604811,,,387,1882
435,435,5,1,26,1,20,3,399,1864,83,23,92,"(Qnenn,",0.06662129461584997,0.805627147766323,,,482,1887
436,436,5,1,26,1,20,4,495,1864,64,25,0,Henn),0.07970356926799758,0.8060567010309279,,,559,1889
437,437,5,1,26,1,20,5,571,1865,125,22,90,angesteuert,0.09581064730792499,0.8058419243986255,,,696,1887
438,438,5,1,26,1,20,6,705,1864,49,18,96,wird.,0.110329703569268,0.804553264604811,,,754,1882
439,439,5,1,26,1,20,7,767,1864,40,18,97,Des,0.11902601330913491,0.804553264604811,,,807,1882
440,440,4,1,26,1,21,0,224,1897,583,23,-1,,0.0779643073200242,0.8198024054982818,,,807,1920
441,441,5,1,26,1,21,1,224,1897,81,18,92,Weiteren,0.04000302480338778,0.8187285223367697,,,305,1915
442,442,5,1,26,1,21,2,308,1897,83,18,91,betrifft,0.052858439201451904,0.8187285223367697,,,391,1915
443,443,5,1,26,1,21,3,396,1897,31,18,93,die,0.06223532970356927,0.8187285223367697,,,427,1915
444,444,5,1,26,1,21,4,434,1897,99,23,92,Erfindung,0.07312462189957653,0.8198024054982818,,,533,1920
445,445,5,1,26,1,21,5,540,1897,43,18,93,eine,0.08492135511191773,0.8187285223367697,,,583,1915
446,446,5,1,26,1,21,6,589,1897,116,23,90,Anordnung,0.09785238959467635,0.8198024054982818,,,705,1920
447,447,5,1,26,1,21,7,712,1897,24,23,96,"(1,",0.10949788263762855,0.8198024054982818,,,736,1920
448,448,5,1,26,1,21,8,744,1897,19,23,96,4),0.11395946763460375,0.8198024054982818,,,763,1920
449,449,5,1,26,1,21,9,771,1901,36,14,96,aus,0.11932849364791288,0.8195876288659794,,,807,1915
450,450,4,1,26,1,22,0,225,1929,582,23,-1,,0.0780399274047187,0.8335481099656358,,,807,1952
451,451,5,1,26,1,22,1,225,1929,44,19,91,dem,0.03735632183908046,0.8326890034364262,,,269,1948
452,452,5,1,26,1,22,2,278,1929,174,23,91,Pumpenaggregat,0.05520266182698125,0.8335481099656358,,,452,1952
453,453,5,1,26,1,22,3,454,1929,45,23,93,"(1),",0.0720659407138536,0.8335481099656358,,,499,1952
454,454,5,1,26,1,22,4,509,1929,141,19,92,insbesondere,0.08764367816091954,0.8326890034364262,,,650,1948
455,455,5,1,26,1,22,5,656,1929,63,19,93,einem,0.10397761645493044,0.8326890034364262,,,719,1948
456,456,5,1,26,1,22,6,728,1929,79,19,90,Kreisel-,0.11607683000604961,0.8326890034364262,,,807,1948
457,457,4,1,26,1,23,0,226,1963,581,23,-1,,0.07811554748941318,0.8481529209621993,,,807,1986
458,458,5,1,26,1,23,1,226,1963,183,23,90,"pumpenaggregat,",0.04801875378100424,0.8481529209621993,,,409,1986
459,459,5,1,26,1,23,2,420,1963,37,18,96,und,0.066318814277072,0.8470790378006873,,,457,1981
460,460,5,1,26,1,23,3,467,1963,52,18,96,einer,0.07456140350877193,0.8470790378006873,,,519,1981
461,461,5,1,26,1,23,4,528,1963,103,18,96,Elektronik,0.08764367816091954,0.8470790378006873,,,631,1981
462,462,5,1,26,1,23,5,640,1963,33,23,96,"(4),",0.09928917120387175,0.8481529209621993,,,673,1986
463,463,5,1,26,1,23,6,684,1963,29,18,96,mit,0.10564125831820932,0.8470790378006873,,,713,1981
464,464,5,1,26,1,23,7,721,1963,35,18,96,der,0.11169086509376891,0.8470790378006873,,,756,1981
465,465,5,1,26,1,23,8,764,1963,43,18,96,eine,0.11879915305505143,0.8470790378006873,,,807,1981
466,466,4,1,26,1,24,0,225,1995,582,23,-1,,0.0780399274047187,0.8618986254295533,,,807,2018
467,467,5,1,26,1,24,1,225,1995,200,23,92,Betriebseinstellung,0.04915305505142166,0.8618986254295533,,,425,2018
468,468,5,1,26,1,24,2,441,1995,37,19,93,des,0.06949485783424078,0.8610395189003437,,,478,2014
469,469,5,1,26,1,24,3,496,1995,193,23,91,Pumpenaggregats,0.0896098003629764,0.8618986254295533,,,689,2018
470,470,5,1,26,1,24,4,705,1995,27,23,95,(1),0.10866606170598911,0.8618986254295533,,,732,2018
471,471,5,1,26,1,24,5,749,1995,58,19,96,durch,0.117664851784634,0.8610395189003437,,,807,2014
472,472,4,1,26,1,25,0,224,2028,584,28,-1,,0.0780399274047187,0.877147766323024,,,808,2056
473,473,5,1,26,1,25,1,224,2028,76,23,93,Vorgabe,0.039624924379915306,0.876073883161512,,,300,2051
474,474,5,1,26,1,25,2,302,2028,73,18,93,eines,0.05119479733817302,0.875,,,375,2046
475,475,5,1,26,1,25,3,380,2028,146,23,80,Vorgabewerts,0.06851179673321234,0.876073883161512,,,526,2051
476,476,5,1,26,1,25,4,532,2028,39,27,60,"(N,",0.08340895341802783,0.8769329896907216,,,571,2055
477,477,5,1,26,1,25,5,578,2028,30,27,74,Nz,0.0896854204476709,0.8769329896907216,,,608,2055
478,478,5,1,26,1,25,6,614,2028,26,25,74,N3,0.09482758620689655,0.8765034364261168,,,640,2053
479,479,5,1,26,1,25,7,642,2028,36,28,27,Fy,0.0998185117967332,0.877147766323024,,,678,2056
480,480,5,1,26,1,25,8,686,2028,22,25,63,F2,0.10541439806412584,0.8765034364261168,,,708,2053
481,481,5,1,26,1,25,9,711,2028,38,27,20,F3),0.1104053236539625,0.8769329896907216,,,749,2055
482,482,5,1,26,1,25,10,755,2028,53,18,95,einer,0.11819419237749547,0.875,,,808,2046
483,483,4,1,26,1,26,0,226,2061,582,25,-1,,0.07819116757410768,0.8906786941580757,,,808,2086
484,484,5,1,26,1,26,1,226,2061,137,23,41,EinstellgroBe,0.04454022988505747,0.8902491408934707,,,363,2084
485,485,5,1,26,1,26,2,370,2061,41,25,90,"(Ny,",0.059059286146400485,0.8906786941580757,,,411,2086
486,486,5,1,26,1,26,3,420,2061,33,25,71,"Ne,",0.06601633393829401,0.8906786941580757,,,453,2086
487,487,5,1,26,1,26,4,462,2061,20,23,92,F),0.07138535995160314,0.8902491408934707,,,482,2084
488,488,5,1,26,1,26,5,489,2061,101,18,92,zumindest,0.08159407138535996,0.8891752577319587,,,590,2079
489,489,5,1,26,1,26,6,591,2061,103,18,93,mittelbar,0.09717180883242589,0.8891752577319587,,,694,2079
490,490,5,1,26,1,26,7,700,2061,108,18,92,einstellbar,0.11403508771929824,0.8891752577319587,,,808,2079
491,491,4,1,26,1,27,0,226,2093,581,26,-1,,0.07811554748941318,0.904639175257732,,,807,2119
492,492,5,1,26,1,27,1,226,2093,26,22,93,"ist,",0.03614640048396854,0.9037800687285223,,,252,2115
493,493,5,1,26,1,27,2,262,2093,61,19,92,wobei,0.044237749546279494,0.9031357388316151,,,323,2112
494,494,5,1,26,1,27,3,332,2093,31,19,93,die,0.052555958862673925,0.9031357388316151,,,363,2112
495,495,5,1,26,1,27,4,373,2093,136,23,70,EinstellgroRe,0.06669691470054447,0.9039948453608248,,,509,2116
496,496,5,1,26,1,27,5,519,2093,41,26,85,"(Ny,",0.08159407138535996,0.904639175257732,,,560,2119
497,497,5,1,26,1,27,6,570,2093,34,26,70,"Np,",0.08877797943133696,0.904639175257732,,,604,2119
498,498,5,1,26,1,27,7,615,2093,19,23,92,F),0.09444948578342408,0.9039948453608248,,,634,2116
499,499,5,1,26,1,27,8,644,2093,30,19,96,die,0.09966727162734422,0.9031357388316151,,,674,2112
500,500,5,1,26,1,27,9,682,2093,72,19,95,Anzahl,0.10859044162129462,0.9031357388316151,,,754,2112
501,501,5,1,26,1,27,10,764,2093,43,26,85,(Ny),0.11879915305505143,0.904639175257732,,,807,2119
502,502,4,1,26,1,28,0,225,2126,582,26,-1,,0.0780399274047187,0.9188144329896907,,,807,2152
503,503,5,1,26,1,28,1,225,2126,34,18,92,der,0.03660012099213551,0.9170962199312714,,,259,2144
504,504,5,1,26,1,28,2,264,2126,123,18,92,Verbraucher,0.04922867513611615,0.9170962199312714,,,387,2144
505,505,5,1,26,1,28,3,389,2126,60,18,96,oder,0.0633696309739867,0.9170962199312714,,,449,2144
506,506,5,1,26,1,28,4,456,2126,43,18,96,eine,0.0722171808832426,0.9170962199312714,,,499,2144
507,507,5,1,26,1,28,5,506,2126,66,18,95,Anzahl,0.08151845130066546,0.9170962199312714,,,572,2144
508,508,5,1,26,1,28,6,575,2126,55,26,90,(Np),0.0911222020568663,0.9188144329896907,,,630,2152
509,509,5,1,26,1,28,7,638,2126,52,18,93,einer,0.10042347247428918,0.9170962199312714,,,690,2144
510,510,5,1,26,1,28,8,698,2126,61,18,91,hierzu,0.11017846339987901,0.9170962199312714,,,759,2144
511,511,5,1,26,1,28,9,769,2126,38,18,92,kor-,0.1191772534785239,0.9170962199312714,,,807,2144
512,512,4,1,26,1,29,0,225,2159,582,23,-1,,0.0780399274047187,0.9323453608247423,,,807,2182
513,513,5,1,26,1,29,1,225,2159,177,23,91,respondierenden,0.04741379310344827,0.9323453608247423,,,402,2182
514,514,5,1,26,1,29,2,412,2159,103,19,78,zahlbaren,0.07009981851179674,0.9314862542955327,,,515,2178
515,515,5,1,26,1,29,3,526,2159,76,22,90,"Einheit,",0.0852994555353902,0.9321305841924399,,,602,2181
516,516,5,1,26,1,29,4,613,2159,47,19,96,oder,0.09626436781609195,0.9314862542955327,,,660,2178
517,517,5,1,26,1,29,5,668,2159,31,19,95,die,0.10337265577737446,0.9314862542955327,,,699,2178
518,518,5,1,26,1,29,6,709,2164,23,14,93,zu,0.1089685420447671,0.9325601374570447,,,732,2178
519,519,5,1,26,1,29,7,743,2159,64,19,92,behei-,0.11721113127646703,0.9314862542955327,,,807,2178
520,520,2,1,27,0,0,0,884,1241,582,84,-1,,0.17770719903206292,0.5511168384879725,,,1466,1325
521,521,3,1,27,1,0,0,884,1241,582,84,-1,,0.17770719903206292,0.5511168384879725,,,1466,1325
522,522,4,1,27,1,1,0,884,1241,581,23,-1,,0.17763157894736842,0.5380154639175257,,,1465,1264
523,523,5,1,27,1,1,1,884,1241,64,18,92,zende,0.1385359951603146,0.5369415807560137,,,948,1259
524,524,5,1,27,1,1,2,955,1241,39,18,93,oder,0.14738354506957047,0.5369415807560137,,,994,1259
525,525,5,1,27,1,1,3,996,1241,109,18,68,kiihlende,0.1588777979431337,0.5369415807560137,,,1105,1259
526,526,5,1,27,1,1,4,1115,1241,68,18,91,Flache,0.17377495462794917,0.5369415807560137,,,1183,1259
527,527,5,1,27,1,1,5,1192,1241,28,23,91,(F),0.1823956442831216,0.5380154639175257,,,1220,1264
528,528,5,1,27,1,1,6,1228,1241,38,18,93,des,0.18859649122807018,0.5369415807560137,,,1266,1259
529,529,5,1,27,1,1,7,1274,1241,96,18,85,Gebaudes,0.1999395039322444,0.5369415807560137,,,1370,1259
530,530,5,1,27,1,1,8,1372,1241,47,21,96,"ist,",0.21105565638233514,0.5375859106529209,,,1419,1262
531,531,5,1,27,1,1,9,1429,1241,36,18,96,und,0.21884452510586813,0.5369415807560137,,,1465,1259
532,532,4,1,27,1,2,0,884,1274,582,23,-1,,0.17770719903206292,0.5521907216494846,,,1466,1297
533,533,5,1,27,1,2,1,884,1274,30,18,92,die,0.13596491228070176,0.5511168384879725,,,914,1292
534,534,5,1,27,1,2,2,925,1274,115,23,92,Anordnung,0.1485934664246824,0.5521907216494846,,,1040,1297
535,535,5,1,27,1,2,3,1052,1278,33,14,93,zur,0.1616001209921355,0.5519759450171822,,,1085,1292
536,536,5,1,27,1,2,4,1094,1274,121,23,33,Ausflhrung,0.17460677555958862,0.5521907216494846,,,1215,1297
537,537,5,1,27,1,2,5,1226,1274,38,18,93,des,0.1882940108892922,0.5511168384879725,,,1264,1292
538,538,5,1,27,1,2,6,1275,1274,115,18,91,Verfahrens,0.2015275257108288,0.5511168384879725,,,1390,1292
539,539,5,1,27,1,2,7,1401,1274,65,23,91,einge-,0.21680278281911675,0.5521907216494846,,,1466,1297
540,540,4,1,27,1,3,0,885,1306,98,19,-1,,0.1412583182093164,0.5650773195876289,,,983,1325
541,541,5,1,27,1,3,1,885,1306,56,19,81,richtet,0.13808227465214762,0.5650773195876289,,,941,1325
542,542,5,1,27,1,3,2,942,1306,41,19,96,ist.,0.1455686630369026,0.5650773195876289,,,983,1325
543,543,2,1,28,0,0,0,910,1413,490,384,-1,,0.17468239564428312,0.6894329896907216,,,1400,1797
544,544,3,1,28,1,0,0,910,1413,490,384,-1,,0.17468239564428312,0.6894329896907216,,,1400,1797
545,545,4,1,28,1,1,0,910,1413,490,384,-1,,0.17468239564428312,0.6894329896907216,,,1400,1797
546,546,5,1,28,1,1,1,910,1413,490,384,95,   ,0.17468239564428312,0.6894329896907216,,,1400,1797
547,547,2,1,29,0,0,0,959,1797,345,81,-1,,0.17112825166364187,0.7893041237113402,,,1304,1878
548,548,3,1,29,1,0,0,959,1797,345,81,-1,,0.17112825166364187,0.7893041237113402,,,1304,1878
549,549,4,1,29,1,1,0,959,1797,345,45,-1,,0.17112825166364187,0.7815721649484536,,,1304,1842
550,550,5,1,29,1,1,1,959,1800,20,25,92,R,0.14655172413793102,0.7785652920962199,,,979,1825
551,551,5,1,29,1,1,2,1078,1811,53,26,0,Quenn,0.16704476709013913,0.7835051546391752,,,1131,1837
552,552,5,1,29,1,1,3,1138,1797,45,43,6,(Ni),0.17551421657592256,0.7811426116838488,,,1183,1840
553,553,5,1,29,1,1,4,1202,1797,54,43,50,Gen,0.18587416817906835,0.7811426116838488,,,1256,1840
554,554,5,1,29,1,1,5,1262,1816,42,26,63,(N),0.1940411373260738,0.7856529209621993,,,1304,1842
555,555,4,1,29,1,2,0,1136,1851,101,27,-1,,0.1794464609800363,0.8009020618556701,,,1237,1878
556,556,5,1,29,1,2,1,1136,1851,53,26,0,Qrenn,0.17581669691470053,0.8006872852233677,,,1189,1877
557,557,5,1,29,1,2,2,1195,1852,42,26,58,(Na),0.1839080459770115,0.8011168384879725,,,1237,1878
558,558,2,1,30,0,0,0,716,2270,259,16,-1,,0.1278735632183908,0.9785223367697594,,,975,2286
559,559,3,1,30,1,0,0,716,2270,259,16,-1,,0.1278735632183908,0.9785223367697594,,,975,2286
560,560,4,1,30,1,1,0,716,2270,259,16,-1,,0.1278735632183908,0.9785223367697594,,,975,2286
561,561,5,1,30,1,1,1,716,2270,49,12,96,Printed,0.11199334543254688,0.9776632302405498,,,765,2282
562,562,5,1,30,1,1,2,771,2270,15,16,96,by,0.1177404718693285,0.9785223367697594,,,786,2286
563,563,5,1,30,1,1,3,792,2270,45,14,96,"Jouve,",0.12318511796733213,0.9780927835051546,,,837,2284
564,564,5,1,30,1,1,4,843,2270,41,12,96,75001,0.13059588626739263,0.9776632302405498,,,884,2282
565,565,5,1,30,1,1,5,893,2270,46,12,96,PARIS,0.1385359951603146,0.9776632302405498,,,939,2282
566,566,5,1,30,1,1,6,945,2270,30,16,95,(FR),0.14519056261343014,0.9785223367697594,,,975,2286
