,Unnamed: 0,level,page_num,block_num,par_num,line_num,word_num,left,top,width,height,conf,text,x,y,label,target,right,bottom
0,0,1,1,0,0,0,0,0,0,1653,2328,-1,,0.125,0.5,,,1653,2328
1,1,2,1,1,0,0,0,144,1905,31,328,-1,,0.02412280701754386,0.8887457044673539,,,175,2233
2,2,3,1,1,1,0,0,144,1905,31,328,-1,,0.02412280701754386,0.8887457044673539,,,175,2233
3,3,4,1,1,1,1,0,144,1905,31,328,-1,,0.02412280701754386,0.8887457044673539,,,175,2233
4,4,5,1,1,1,1,1,144,2179,30,54,95,EP,0.024047186932849365,0.947594501718213,,,174,2233
5,5,5,1,1,1,1,2,144,2142,31,21,95,3,0.02412280701754386,0.9246134020618557,,,175,2163
6,6,5,1,1,1,1,3,144,2054,31,72,95,384,0.02412280701754386,0.897766323024055,,,175,2126
7,7,5,1,1,1,1,4,144,1968,31,71,91,746,0.02412280701754386,0.8606099656357389,,,175,2039
8,8,5,1,1,1,1,5,144,1905,30,50,89,A1,0.024047186932849365,0.8290378006872853,,,174,1955
9,9,2,1,2,0,0,0,429,153,88,28,-1,,0.07153660012099214,0.07173539518900343,,,517,181
10,10,3,1,2,1,0,0,429,153,88,28,-1,,0.07153660012099214,0.07173539518900343,,,517,181
11,11,4,1,2,1,1,0,429,153,88,16,-1,,0.07153660012099214,0.06915807560137457,,,517,169
12,12,5,1,2,1,1,1,429,153,88,16,84,Europaisches,0.07153660012099214,0.06915807560137457,,,517,169
13,13,4,1,2,1,2,0,429,170,71,11,-1,,0.07025105868118572,0.07538659793814433,,,500,181
14,14,5,1,2,1,2,1,429,170,71,11,96,Patentamt,0.07025105868118572,0.07538659793814433,,,500,181
15,15,2,1,3,0,0,0,429,196,63,15,-1,,0.06964609800362977,0.08741408934707903,,,492,211
16,16,3,1,3,1,0,0,429,196,63,15,-1,,0.06964609800362977,0.08741408934707903,,,492,211
17,17,4,1,3,1,1,0,429,196,63,15,-1,,0.06964609800362977,0.08741408934707903,,,492,211
18,18,5,1,3,1,1,1,429,196,63,15,95,European,0.06964609800362977,0.08741408934707903,,,492,211
19,19,2,1,4,0,0,0,429,212,89,12,-1,,0.07161222020568662,0.0936426116838488,,,518,224
20,20,3,1,4,1,0,0,429,212,89,12,-1,,0.07161222020568662,0.0936426116838488,,,518,224
21,21,4,1,4,1,1,0,429,212,89,12,-1,,0.07161222020568662,0.0936426116838488,,,518,224
22,22,5,1,4,1,1,1,429,213,43,11,97,Patent,0.06813369630973987,0.0938573883161512,,,472,224
23,23,5,1,4,1,1,2,478,212,40,12,96,Office,0.07531760435571688,0.0936426116838488,,,518,224
24,24,2,1,5,0,0,0,429,239,109,28,-1,,0.07312462189957653,0.10867697594501718,,,538,267
25,25,3,1,5,1,0,0,429,239,109,28,-1,,0.07312462189957653,0.10867697594501718,,,538,267
26,26,4,1,5,1,1,0,429,239,109,15,-1,,0.07312462189957653,0.10588487972508591,,,538,254
27,27,5,1,5,1,1,1,429,239,40,12,93,Office,0.06790683605565638,0.1052405498281787,,,469,251
28,28,5,1,5,1,1,2,474,239,64,15,93,europ√©en,0.0765275257108288,0.10588487972508591,,,538,254
29,29,4,1,5,1,2,0,429,255,77,12,-1,,0.0707047791893527,0.11211340206185567,,,506,267
30,30,5,1,5,1,2,1,429,255,22,12,95,des,0.06654567453115548,0.11211340206185567,,,451,267
31,31,5,1,5,1,2,2,457,255,49,12,82,brevets,0.07282214156079855,0.11211340206185567,,,506,267
32,32,2,1,6,0,0,0,281,136,274,150,-1,,0.06321839080459771,0.09063573883161512,,,555,286
33,33,3,1,6,1,0,0,281,136,274,150,-1,,0.06321839080459771,0.09063573883161512,,,555,286
34,34,4,1,6,1,1,0,281,136,274,150,-1,,0.06321839080459771,0.09063573883161512,,,555,286
35,35,5,1,6,1,1,1,281,136,274,150,95, ,0.06321839080459771,0.09063573883161512,,,555,286
36,36,2,1,7,0,0,0,225,324,45,26,-1,,0.037431941923774956,0.14475945017182132,,,270,350
37,37,3,1,7,1,0,0,225,324,45,26,-1,,0.037431941923774956,0.14475945017182132,,,270,350
38,38,4,1,7,1,1,0,225,324,45,26,-1,,0.037431941923774956,0.14475945017182132,,,270,350
39,39,5,1,7,1,1,1,225,324,45,26,96,(12),0.037431941923774956,0.14475945017182132,,,270,350
40,40,2,1,8,0,0,0,225,395,412,53,-1,,0.06518451300665457,0.18105670103092783,,,637,448
41,41,3,1,8,1,0,0,225,395,412,53,-1,,0.06518451300665457,0.18105670103092783,,,637,448
42,42,4,1,8,1,1,0,225,395,282,26,-1,,0.05535390199637023,0.17525773195876287,,,507,421
43,43,5,1,8,1,1,1,225,395,45,26,92,(43),0.037431941923774956,0.17525773195876287,,,270,421
44,44,5,1,8,1,1,2,285,397,222,23,90,Verdffentlichungstag:,0.05989110707803993,0.17547250859106528,,,507,420
45,45,4,1,8,1,2,0,287,430,350,18,-1,,0.06987295825771325,0.18857388316151202,,,637,448
46,46,5,1,8,1,2,1,287,430,116,18,91,10.10.2018,0.052177858439201454,0.18857388316151202,publication_date,10.10.2018,403,448
47,47,5,1,8,1,2,2,426,430,121,18,91,Patentblatt,0.0735783424077435,0.18857388316151202,,,547,448
48,48,5,1,8,1,2,3,555,430,82,18,96,2018/41,0.09013914095583787,0.18857388316151202,,,637,448
49,49,2,1,9,0,0,0,225,493,379,26,-1,,0.06268905021173624,0.21735395189003437,,,604,519
50,50,3,1,9,1,0,0,225,493,379,26,-1,,0.06268905021173624,0.21735395189003437,,,604,519
51,51,4,1,9,1,1,0,225,493,379,26,-1,,0.06268905021173624,0.21735395189003437,,,604,519
52,52,5,1,9,1,1,1,225,493,45,26,92,(21),0.037431941923774956,0.21735395189003437,,,270,519
53,53,5,1,9,1,1,2,285,495,186,18,91,Anmeldenummer:,0.05716878402903811,0.21649484536082475,,,471,513
54,54,5,1,9,1,1,3,481,495,123,18,92,18165627.3,0.08204779189352691,0.21649484536082475,application_number,18165627.3,604,513
55,55,2,1,10,0,0,0,225,559,319,26,-1,,0.05815184513006655,0.24570446735395188,,,544,585
56,56,3,1,10,1,0,0,225,559,319,26,-1,,0.05815184513006655,0.24570446735395188,,,544,585
57,57,4,1,10,1,1,0,225,559,319,26,-1,,0.05815184513006655,0.24570446735395188,,,544,585
58,58,5,1,10,1,1,1,225,559,45,26,93,(22),0.037431941923774956,0.24570446735395188,,,270,585
59,59,5,1,10,1,1,2,285,561,131,23,92,Anmeldetag:,0.0530096793708409,0.24591924398625428,,,416,584
60,60,5,1,10,1,1,3,426,561,118,18,96,04.04.2018,0.07335148215366001,0.24484536082474226,filing_date,04.04.2018,544,579
61,61,2,1,11,0,0,0,1002,245,458,38,-1,,0.18617664851784635,0.1134020618556701,,,1460,283
62,62,3,1,11,1,0,0,1002,245,458,38,-1,,0.18617664851784635,0.1134020618556701,,,1460,283
63,63,4,1,11,1,1,0,1002,245,458,38,-1,,0.18617664851784635,0.1134020618556701,,,1460,283
64,64,5,1,11,1,1,1,1002,256,44,27,74,(11),0.15486993345432548,0.11576460481099657,,,1046,283
65,65,5,1,11,1,1,2,1146,245,52,32,95,EP,0.17725347852389595,0.11211340206185567,number,EP,1198,277
66,66,5,1,11,1,1,3,1214,245,20,32,95,3,0.1851179673321234,0.11211340206185567,number,3,1234,277
67,67,5,1,11,1,1,4,1249,245,68,32,95,384,0.1940411373260738,0.11211340206185567,number,384,1317,277
68,68,5,1,11,1,1,5,1332,245,68,32,92,746,0.20659407138535996,0.11211340206185567,number,746,1400,277
69,69,5,1,11,1,1,6,1413,245,47,32,85,A1,0.21725650332728372,0.11211340206185567,number,A1,1460,277
70,70,2,1,12,0,0,0,559,314,573,31,-1,,0.1278735632183908,0.14153780068728522,,,1132,345
71,71,3,1,12,1,0,0,559,314,573,31,-1,,0.1278735632183908,0.14153780068728522,,,1132,345
72,72,4,1,12,1,1,0,559,314,573,31,-1,,0.1278735632183908,0.14153780068728522,,,1132,345
73,73,5,1,12,1,1,1,559,314,230,31,92,EUROPAISCHE,0.10193587416817906,0.14153780068728522,,,789,345
74,74,5,1,12,1,1,2,802,319,330,26,91,PATENTANMELDUNG,0.14624924379915305,0.14261168384879724,,,1132,345
75,75,2,1,13,0,0,0,862,395,530,81,-1,,0.1704476709013914,0.1870704467353952,,,1392,476
76,76,3,1,13,1,0,0,862,395,530,81,-1,,0.1704476709013914,0.1870704467353952,,,1392,476
77,77,4,1,13,1,1,0,862,395,126,26,-1,,0.13989715668481548,0.17525773195876287,,,988,421
78,78,5,1,13,1,1,1,862,395,44,26,93,(51),0.1336963097398669,0.17525773195876287,,,906,421
79,79,5,1,13,1,1,2,923,397,25,18,93,Int,0.1414851784633999,0.17439862542955326,,,948,415
80,80,5,1,13,1,1,3,955,397,33,18,78,Cl:,0.14692982456140352,0.17439862542955326,,,988,415
81,81,4,1,13,1,2,0,921,425,471,21,-1,,0.17490925589836662,0.1870704467353952,,,1392,446
82,82,5,1,13,1,2,1,921,428,61,18,86,A01B,0.14390502117362372,0.1877147766323024,class_international,A01B,982,446
83,83,5,1,13,1,2,2,991,428,58,18,83,63/14,0.1542649727767695,0.1877147766323024,class_international,63/14,1049,446
84,84,5,1,13,1,2,3,1054,425,67,16,64,(2008.01),0.16447368421052633,0.18599656357388317,,,1121,441
85,85,5,1,13,1,2,4,1193,428,60,18,86,B62D,0.18496672716273443,0.1877147766323024,,,1253,446
86,86,5,1,13,1,2,5,1260,428,60,18,89,49106,0.19509981851179672,0.1877147766323024,,,1320,446
87,87,5,1,13,1,2,6,1325,425,67,16,79,(2006.01),0.20545977011494254,0.18599656357388317,,,1392,441
88,88,4,1,13,1,3,0,921,455,470,21,-1,,0.17483363581367212,0.19995704467353953,,,1391,476
89,89,5,1,13,1,3,1,921,458,61,18,87,A01B,0.14390502117362372,0.20060137457044674,,,982,476
90,90,5,1,13,1,3,2,991,458,58,18,88,76/00,0.1542649727767695,0.20060137457044674,,,1049,476
91,91,5,1,13,1,3,3,1054,455,67,16,67,(2006.94),0.16447368421052633,0.19888316151202748,,,1121,471
92,92,5,1,13,1,3,4,1193,458,59,18,16,BEC,0.18489110707803993,0.20060137457044674,,,1252,476
93,93,5,1,13,1,3,5,1260,458,59,18,96,23/00,0.19502419842710225,0.20060137457044674,,,1319,476
94,94,5,1,13,1,3,6,1324,455,67,16,75,(2006.01),0.20530852994555354,0.19888316151202748,,,1391,471
95,95,2,1,14,0,0,0,224,612,1243,6,-1,,0.1278735632183908,0.26417525773195877,,,1467,618
96,96,3,1,14,1,0,0,224,612,1243,6,-1,,0.1278735632183908,0.26417525773195877,,,1467,618
97,97,4,1,14,1,1,0,224,612,1243,6,-1,,0.1278735632183908,0.26417525773195877,,,1467,618
98,98,5,1,14,1,1,1,224,612,1243,6,95, ,0.1278735632183908,0.26417525773195877,,,1467,618
99,99,2,1,15,0,0,0,225,631,599,250,-1,,0.07932546884452511,0.3247422680412371,,,824,881
100,100,3,1,15,1,0,0,225,631,599,250,-1,,0.07932546884452511,0.3247422680412371,,,824,881
101,101,4,1,15,1,1,0,225,631,342,27,-1,,0.05989110707803993,0.2768470790378007,,,567,658
102,102,5,1,15,1,1,1,225,631,45,27,93,(84),0.037431941923774956,0.2768470790378007,,,270,658
103,103,5,1,15,1,1,2,286,633,100,19,93,Benannte,0.050816696914700546,0.2759879725085911,,,386,652
104,104,5,1,15,1,1,3,393,633,174,23,92,Vertragsstaaten:,0.07259528130671507,0.2768470790378007,,,567,656
105,105,4,1,15,1,2,0,285,666,537,18,-1,,0.08371143375680581,0.28994845360824745,,,822,684
106,106,5,1,15,1,2,1,285,666,31,18,94,AL,0.04544767090139141,0.28994845360824745,,,316,684
107,107,5,1,15,1,2,2,323,666,31,18,94,AT,0.05119479733817302,0.28994845360824745,,,354,684
108,108,5,1,15,1,2,3,363,666,30,18,95,BE,0.05716878402903811,0.28994845360824745,,,393,684
109,109,5,1,15,1,2,4,403,666,32,18,95,BG,0.0633696309739867,0.28994845360824745,,,435,684
110,110,5,1,15,1,2,5,445,666,31,18,95,CH,0.06964609800362977,0.28994845360824745,,,476,684
111,111,5,1,15,1,2,6,486,666,32,18,96,CY,0.07592256503327284,0.28994845360824745,,,518,684
112,112,5,1,15,1,2,7,526,666,30,18,96,CZ,0.08182093163944344,0.28994845360824745,,,556,684
113,113,5,1,15,1,2,8,565,666,30,18,96,DE,0.08771929824561403,0.28994845360824745,,,595,684
114,114,5,1,15,1,2,9,605,666,32,18,93,DK,0.09392014519056262,0.28994845360824745,,,637,684
115,115,5,1,15,1,2,10,646,666,29,18,93,EE,0.0998941318814277,0.28994845360824745,,,675,684
116,116,5,1,15,1,2,11,684,666,29,18,93,ES,0.10564125831820932,0.28994845360824745,,,713,684
117,117,5,1,15,1,2,12,723,666,99,18,86,FIFRGB,0.11683303085299455,0.28994845360824745,,,822,684
118,118,4,1,15,1,3,0,285,699,539,18,-1,,0.0838626739261948,0.30412371134020616,,,824,717
119,119,5,1,15,1,3,1,285,699,35,18,94,GR,0.04575015124016939,0.30412371134020616,,,320,717
120,120,5,1,15,1,3,2,328,699,32,18,94,HR,0.05202661826981246,0.30412371134020616,,,360,717
121,121,5,1,15,1,3,3,368,699,14,18,41,HU,0.05671506352087114,0.30412371134020616,,,382,717
122,122,5,1,15,1,3,4,385,699,43,18,41,IE,0.06147912885662432,0.30412371134020616,,,428,717
123,123,5,1,15,1,3,5,436,699,20,18,47,IS,0.06745311554748941,0.30412371134020616,,,456,717
124,124,5,1,15,1,3,6,464,699,20,18,47,IT,0.07168784029038112,0.30412371134020616,,,484,717
125,125,5,1,15,1,3,7,492,699,54,18,83,LILT,0.07849364791288566,0.30412371134020616,,,546,717
126,126,5,1,15,1,3,8,554,699,28,18,75,LU,0.08590441621294616,0.30412371134020616,,,582,717
127,127,5,1,15,1,3,9,591,699,28,18,75,LV,0.09150030248033877,0.30412371134020616,,,619,717
128,128,5,1,15,1,3,10,627,699,35,18,95,MC,0.09747428917120388,0.30412371134020616,,,662,717
129,129,5,1,15,1,3,11,670,699,35,18,94,MK,0.10397761645493044,0.30412371134020616,,,705,717
130,130,5,1,15,1,3,12,713,699,32,18,93,MT,0.11025408348457351,0.30412371134020616,,,745,717
131,131,5,1,15,1,3,13,753,699,29,18,20,NL,0.11607683000604961,0.30412371134020616,,,782,717
132,132,5,1,15,1,3,14,791,699,33,18,20,NO,0.1221264367816092,0.30412371134020616,,,824,717
133,133,4,1,15,1,4,0,286,732,336,18,-1,,0.06866303690260134,0.31829896907216493,,,622,750
134,134,5,1,15,1,4,1,286,732,28,18,95,PL,0.045372050816696916,0.31829896907216493,,,314,750
135,135,5,1,15,1,4,2,323,732,29,18,92,PT,0.05104355716878403,0.31829896907216493,,,352,750
136,136,5,1,15,1,4,3,360,732,58,18,92,RORS,0.058832425892317,0.31829896907216493,,,418,750
137,137,5,1,15,1,4,4,420,732,52,18,96,SE,0.06745311554748941,0.31829896907216493,,,472,750
138,138,5,1,15,1,4,5,480,732,20,18,91,SI,0.07410768300060495,0.31829896907216493,,,500,750
139,139,5,1,15,1,4,6,510,732,31,18,91,SK,0.0794767090139141,0.31829896907216493,,,541,750
140,140,5,1,15,1,4,7,550,732,72,18,91,SMTR,0.08862673926194797,0.31829896907216493,,,622,750
141,141,4,1,15,1,5,0,286,765,330,23,-1,,0.06820931639443437,0.3335481099656357,,,616,788
142,142,5,1,15,1,5,1,286,765,100,18,92,Benannte,0.050816696914700546,0.3324742268041237,,,386,783
143,143,5,1,15,1,5,2,395,765,221,23,91,Erstreckungsstaaten:,0.0764519056261343,0.3335481099656357,,,616,788
144,144,4,1,15,1,6,0,286,797,74,19,-1,,0.04885057471264368,0.34643470790378006,,,360,816
145,145,5,1,15,1,6,1,286,797,33,19,96,BA,0.04575015124016939,0.34643470790378006,,,319,816
146,146,5,1,15,1,6,2,327,797,33,19,96,ME,0.05195099818511797,0.34643470790378006,,,360,816
147,147,4,1,15,1,7,0,286,830,322,23,-1,,0.06760435571687841,0.36146907216494845,,,608,853
148,148,5,1,15,1,7,1,286,830,100,18,92,Benannte,0.050816696914700546,0.3603951890034364,,,386,848
149,149,5,1,15,1,7,2,393,830,215,23,92,Validierungsstaaten:,0.07569570477918935,0.36146907216494845,,,608,853
150,150,4,1,15,1,8,0,286,863,157,18,-1,,0.055127041742286755,0.3745704467353952,,,443,881
151,151,5,1,15,1,8,1,286,863,31,18,95,KH,0.0455989110707804,0.3745704467353952,,,317,881
152,152,5,1,15,1,8,2,327,863,35,18,96,MA,0.052102238354506954,0.3745704467353952,,,362,881
153,153,5,1,15,1,8,3,371,863,34,18,95,MD,0.05868118572292801,0.3745704467353952,,,405,881
154,154,5,1,15,1,8,4,413,863,30,18,95,TN,0.0647307924984876,0.3745704467353952,,,443,881
155,155,2,1,16,0,0,0,225,927,491,26,-1,,0.07115849969751967,0.40378006872852235,,,716,953
156,156,3,1,16,1,0,0,225,927,491,26,-1,,0.07115849969751967,0.40378006872852235,,,716,953
157,157,4,1,16,1,1,0,225,927,491,26,-1,,0.07115849969751967,0.40378006872852235,,,716,953
158,158,5,1,16,1,1,1,225,927,45,26,91,(30),0.037431941923774956,0.40378006872852235,,,270,953
159,159,5,1,16,1,1,2,286,929,86,18,67,Prioritat:,0.04975801572897762,0.4029209621993127,,,372,947
160,160,5,1,16,1,1,3,383,929,118,18,94,05.04.2017,0.06684815486993345,0.4029209621993127,priority_date_eu,05.04.2017,501,947
161,161,5,1,16,1,1,4,520,929,30,18,94,DE,0.0809134906231095,0.4029209621993127,,,550,947
162,162,5,1,16,1,1,5,559,929,157,18,96,102017205827,0.09641560798548095,0.4029209621993127,,,716,947
163,163,2,1,17,0,0,0,225,992,380,58,-1,,0.06276467029643074,0.438573883161512,,,605,1050
164,164,3,1,17,1,0,0,225,992,380,58,-1,,0.06276467029643074,0.438573883161512,,,605,1050
165,165,4,1,17,1,1,0,225,992,380,26,-1,,0.06276467029643074,0.43170103092783507,,,605,1018
166,166,5,1,17,1,1,1,225,992,45,26,93,(71),0.037431941923774956,0.43170103092783507,,,270,1018
167,167,5,1,17,1,1,2,285,994,106,18,91,Anmelder:,0.051119177253478525,0.43084192439862545,,,391,1012
168,168,5,1,17,1,1,3,402,994,63,18,93,Deere,0.06556261343012704,0.43084192439862545,applicant_line_1,Deere,465,1012
169,169,5,1,17,1,1,4,474,994,15,18,93,&,0.07282214156079855,0.43084192439862545,applicant_line_1,&,489,1012
170,170,5,1,17,1,1,5,498,994,107,23,95,Company,0.08340895341802783,0.4319158075601375,applicant_line_1,Company,605,1017
171,171,4,1,17,1,2,0,286,1027,236,23,-1,,0.06110102843315184,0.44609106529209624,,,522,1050
172,172,5,1,17,1,2,1,286,1027,79,21,95,"Moline,",0.04922867513611615,0.44566151202749144,,,365,1048
173,173,5,1,17,1,2,2,375,1027,18,18,95,IL,0.05807622504537205,0.44501718213058417,,,393,1045
174,174,5,1,17,1,2,3,403,1027,64,18,95,61265,0.06578947368421052,0.44501718213058417,,,467,1045
175,175,5,1,17,1,2,4,475,1027,47,23,96,(US),0.07539322444041137,0.44609106529209624,,,522,1050
176,176,2,1,18,0,0,0,862,631,304,157,-1,,0.15335753176043557,0.30476804123711343,,,1166,788
177,177,3,1,18,1,0,0,862,631,304,157,-1,,0.15335753176043557,0.30476804123711343,,,1166,788
178,178,4,1,18,1,1,0,862,631,147,27,-1,,0.1414851784633999,0.2768470790378007,,,1009,658
179,179,5,1,18,1,1,1,862,631,44,27,90,(72),0.1336963097398669,0.2768470790378007,,,906,658
180,180,5,1,18,1,1,2,923,633,86,19,89,Erfinder:,0.14609800362976408,0.2759879725085911,,,1009,652
181,181,4,1,18,1,2,0,898,666,189,22,-1,,0.1501058681185723,0.29080756013745707,,,1087,688
182,182,5,1,18,1,2,1,898,671,7,8,61,*,0.13634301270417423,0.28994845360824745,,,905,679
183,183,5,1,18,1,2,2,922,666,78,22,96,"Schott,",0.1453418027828191,0.29080756013745707,inventor_line_1,"Schott,",1000,688
184,184,5,1,18,1,2,3,1010,666,77,18,96,Florian,0.15857531760435573,0.28994845360824745,inventor_line_1,Florian,1087,684
185,185,4,1,18,1,3,0,922,699,244,23,-1,,0.15789473684210525,0.30519759450171824,,,1166,722
186,186,5,1,18,1,3,1,922,699,64,18,96,68163,0.1442831215970962,0.30412371134020616,,,986,717
187,187,5,1,18,1,3,2,996,699,115,18,96,Mannheim,0.15933151845130067,0.30412371134020616,,,1111,717
188,188,5,1,18,1,3,3,1120,699,46,23,95,(DE),0.17286751361161526,0.30519759450171824,,,1166,722
189,189,4,1,18,1,4,0,898,732,224,22,-1,,0.15275257108287962,0.31915807560137455,,,1122,754
190,190,5,1,18,1,4,1,898,737,7,8,50,¬¢,0.13634301270417423,0.31829896907216493,,,905,745
191,191,5,1,18,1,4,2,923,732,113,22,91,"Reinmuth,",0.14813974591651544,0.31915807560137455,,,1036,754
192,192,5,1,18,1,4,3,1046,732,76,18,96,Florian,0.16394434361766486,0.31829896907216493,,,1122,750
193,193,4,1,18,1,5,0,922,765,244,23,-1,,0.15789473684210525,0.3335481099656357,,,1166,788
194,194,5,1,18,1,5,1,922,765,64,18,95,68163,0.1442831215970962,0.3324742268041237,,,986,783
195,195,5,1,18,1,5,2,996,765,115,18,95,Mannheim,0.15933151845130067,0.3324742268041237,,,1111,783
196,196,5,1,18,1,5,3,1120,765,46,23,95,(DE),0.17286751361161526,0.3335481099656357,,,1166,788
197,197,2,1,19,0,0,0,862,828,520,156,-1,,0.16969147005444646,0.38917525773195877,,,1382,984
198,198,3,1,19,1,0,0,862,828,520,156,-1,,0.16969147005444646,0.38917525773195877,,,1382,984
199,199,4,1,19,1,1,0,862,828,520,26,-1,,0.16969147005444646,0.36125429553264604,,,1382,854
200,200,5,1,19,1,1,1,862,828,44,26,93,(74),0.1336963097398669,0.36125429553264604,,,906,854
201,201,5,1,19,1,1,2,921,830,97,18,91,Vertreter:,0.14662734422262552,0.3603951890034364,,,1018,848
202,202,5,1,19,1,1,3,1029,830,123,22,91,"Dehnhardt,",0.16492740471869327,0.36125429553264604,representative_line_1_eu,"Dehnhardt,",1152,852
203,203,5,1,19,1,1,4,1161,830,77,18,96,Florian,0.18141258318209316,0.3603951890034364,representative_line_1_eu,Florian,1238,848
204,204,5,1,19,1,1,5,1247,830,135,23,96,Christopher,0.19880520266182697,0.36146907216494845,representative_line_1_eu,Christopher,1382,853
205,205,4,1,19,1,2,0,922,863,317,18,-1,,0.16341500302480338,0.3745704467353952,,,1239,881
206,206,5,1,19,1,2,1,922,863,54,18,96,John,0.14352692075015125,0.3745704467353952,,,976,881
207,207,5,1,19,1,2,2,986,863,64,18,96,Deere,0.15396249243799154,0.3745704467353952,,,1050,881
208,208,5,1,19,1,2,3,1058,863,69,18,93,GmbH,0.16522988505747127,0.3745704467353952,,,1127,881
209,209,5,1,19,1,2,4,1137,863,16,18,91,&,0.17316999395039323,0.3745704467353952,,,1153,881
210,210,5,1,19,1,2,5,1161,863,36,18,96,Co.,0.17831215970961886,0.3745704467353952,,,1197,881
211,211,5,1,19,1,2,6,1207,863,32,18,96,KG,0.18496672716273443,0.3745704467353952,,,1239,881
212,212,4,1,19,1,3,0,922,895,413,23,-1,,0.1706745311554749,0.3893900343642612,,,1335,918
213,213,5,1,19,1,3,1,922,895,66,19,96,Global,0.1444343617664852,0.38853092783505155,,,988,914
214,214,5,1,19,1,3,2,991,895,134,19,96,Intellectual,0.1600120992135511,0.38853092783505155,,,1125,914
215,215,5,1,19,1,3,3,1135,895,96,23,96,Property,0.17891712038717483,0.3893900343642612,,,1231,918
216,216,5,1,19,1,3,4,1239,895,96,19,96,Services,0.19464609800362975,0.38853092783505155,,,1335,914
217,217,4,1,19,1,4,0,922,929,245,18,-1,,0.15797035692679975,0.4029209621993127,,,1167,947
218,218,5,1,19,1,4,1,922,929,212,18,67,John-Deere-Strake,0.15547489413188142,0.4029209621993127,,,1134,947
219,219,5,1,19,1,4,2,1142,929,25,18,96,70,0.17460677555958862,0.4029209621993127,,,1167,947
220,220,4,1,19,1,5,0,922,961,244,23,-1,,0.15789473684210525,0.4177405498281787,,,1166,984
221,221,5,1,19,1,5,1,922,961,64,19,96,68163,0.1442831215970962,0.4168814432989691,,,986,980
222,222,5,1,19,1,5,2,996,961,115,19,96,Mannheim,0.15933151845130067,0.4168814432989691,,,1111,980
223,223,5,1,19,1,5,3,1120,961,46,23,96,(DE),0.17286751361161526,0.4177405498281787,,,1166,984
224,224,2,1,20,0,0,0,844,614,4,468,-1,,0.1279491833030853,0.3642611683848797,,,848,1082
225,225,3,1,20,1,0,0,844,614,4,468,-1,,0.1279491833030853,0.3642611683848797,,,848,1082
226,226,4,1,20,1,1,0,844,614,4,468,-1,,0.1279491833030853,0.3642611683848797,,,848,1082
227,227,5,1,20,1,1,1,844,614,4,468,95, ,0.1279491833030853,0.3642611683848797,,,848,1082
228,228,2,1,21,0,0,0,224,1078,1243,6,-1,,0.1278735632183908,0.4643470790378007,,,1467,1084
229,229,3,1,21,1,0,0,224,1078,1243,6,-1,,0.1278735632183908,0.4643470790378007,,,1467,1084
230,230,4,1,21,1,1,0,224,1078,1243,6,-1,,0.1278735632183908,0.4643470790378007,,,1467,1084
231,231,5,1,21,1,1,1,224,1078,1243,6,95, ,0.1278735632183908,0.4643470790378007,,,1467,1084
232,232,2,1,22,0,0,0,225,1099,592,53,-1,,0.07879612825166364,0.4834621993127148,,,817,1152
233,233,3,1,22,1,0,0,225,1099,592,53,-1,,0.07879612825166364,0.4834621993127148,,,817,1152
234,234,4,1,22,1,1,0,225,1099,45,26,-1,,0.037431941923774956,0.47766323024054985,,,270,1125
235,235,5,1,22,1,1,1,225,1099,45,26,95,(54),0.037431941923774956,0.47766323024054985,,,270,1125
236,236,4,1,22,1,2,0,316,1131,501,21,-1,,0.08567755595886267,0.49033505154639173,,,817,1152
237,237,5,1,22,1,2,1,316,1131,345,21,92,LANDWIRTSCHAFTLICHEN,0.07388082274652148,0.49033505154639173,,,661,1152
238,238,5,1,22,1,2,2,670,1131,147,21,91,TRAKTORS,0.11244706594071385,0.49033505154639173,,,817,1152
239,239,2,1,23,0,0,0,224,1206,584,222,-1,,0.0780399274047187,0.5657216494845361,,,808,1428
240,240,3,1,23,1,0,0,224,1206,584,222,-1,,0.0780399274047187,0.5657216494845361,,,808,1428
241,241,4,1,23,1,1,0,225,1206,582,27,-1,,0.0780399274047187,0.523840206185567,,,807,1233
242,242,5,1,23,1,1,1,225,1206,45,27,94,(57),0.037431941923774956,0.523840206185567,,,270,1233
243,243,5,1,23,1,1,2,315,1208,103,19,53,Verfahren,0.05542952208106473,0.5229810996563574,,,418,1227
244,244,5,1,23,1,1,3,434,1213,32,14,93,zur,0.06805807622504537,0.5240549828178694,,,466,1227
245,245,5,1,23,1,1,4,482,1208,142,23,91,Bereitstellung,0.08363581367211131,0.523840206185567,,,624,1231
246,246,5,1,23,1,1,5,640,1208,55,19,92,eines,0.10095281306715063,0.5229810996563574,,,695,1227
247,247,5,1,23,1,1,6,711,1208,96,19,90,Ballastie-,0.1147912885662432,0.5229810996563574,,,807,1227
248,248,4,1,23,1,2,0,225,1241,582,23,-1,,0.0780399274047187,0.5380154639175257,,,807,1264
249,249,5,1,23,1,2,1,225,1241,159,23,91,rungsvorschlags,0.046052631578947366,0.5380154639175257,,,384,1264
250,250,5,1,23,1,2,2,387,1241,72,18,93,eines,0.06397459165154265,0.5369415807560137,,,459,1259
251,251,5,1,23,1,2,3,466,1241,205,18,92,landwirtschaftlichen,0.08598003629764066,0.5369415807560137,,,671,1259
252,252,5,1,23,1,2,4,678,1241,86,18,93,"Traktors,",0.10904416212946158,0.5369415807560137,,,764,1259
253,253,5,1,23,1,2,5,767,1241,40,22,96,bei,0.11902601330913491,0.5378006872852233,,,807,1263
254,254,4,1,23,1,3,0,225,1274,582,23,-1,,0.0780399274047187,0.5521907216494846,,,807,1297
255,255,5,1,23,1,3,1,225,1274,25,18,95,dem,0.035919540229885055,0.5511168384879725,,,250,1292
256,256,5,1,23,1,3,2,253,1274,52,18,62,fur,0.04219600725952813,0.5511168384879725,,,305,1292
257,257,5,1,23,1,3,3,311,1274,45,23,90,jede,0.05043859649122807,0.5521907216494846,,,356,1297
258,258,5,1,23,1,3,4,364,1274,34,18,93,der,0.057622504537205084,0.5511168384879725,,,398,1292
259,259,5,1,23,1,3,5,405,1274,78,18,92,Achsen,0.06715063520871144,0.5511168384879725,,,483,1292
260,260,5,1,23,1,3,6,492,1274,37,18,93,des,0.07720810647307925,0.5511168384879725,,,529,1292
261,261,5,1,23,1,3,7,539,1274,205,18,91,landwirtschaftlichen,0.0970205686630369,0.5511168384879725,,,744,1292
262,262,5,1,23,1,3,8,753,1274,54,18,90,Trak-,0.11796733212341198,0.5511168384879725,,,807,1292
263,263,4,1,23,1,4,0,225,1306,582,23,-1,,0.0780399274047187,0.5659364261168385,,,807,1329
264,264,5,1,23,1,4,1,225,1307,38,18,97,tors,0.03690260133091349,0.5652920962199313,,,263,1325
265,265,5,1,23,1,4,2,273,1306,44,19,96,eine,0.044615849969751965,0.5650773195876289,,,317,1325
266,266,5,1,23,1,4,3,326,1306,28,19,66,fur,0.0514216575922565,0.5650773195876289,,,354,1325
267,267,5,1,23,1,4,4,363,1306,30,19,93,ein,0.05716878402903811,0.5650773195876289,,,393,1325
268,268,5,1,23,1,4,5,404,1306,144,23,78,ausgewahltes,0.07199032062915911,0.5659364261168385,,,548,1329
269,269,5,1,23,1,4,6,558,1306,123,23,79,Anbaugerat,0.09369328493647913,0.5659364261168385,,,681,1329
270,270,5,1,23,1,4,7,691,1306,116,23,92,spezifische,0.1132788868723533,0.5659364261168385,,,807,1329
271,271,4,1,23,1,5,0,225,1339,583,23,-1,,0.07811554748941318,0.5801116838487973,,,808,1362
272,272,5,1,23,1,5,1,225,1339,158,23,82,Sollzugleistung,0.04597701149425287,0.5801116838487973,,,383,1362
273,273,5,1,23,1,5,2,396,1339,104,18,91,berechnet,0.0677555958862674,0.5790378006872853,,,500,1357
274,274,5,1,23,1,5,3,510,1339,49,21,93,"wird,",0.080837870538415,0.5796821305841925,,,559,1360
275,275,5,1,23,1,5,4,570,1339,61,18,91,wobei,0.09081972171808833,0.5790378006872853,,,631,1357
276,276,5,1,23,1,5,5,644,1339,15,18,93,in,0.0985329703569268,0.5790378006872853,,,659,1357
277,277,5,1,23,1,5,6,670,1339,138,23,91,Abhangigkeit,0.1117664851784634,0.5801116838487973,,,808,1362
278,278,4,1,23,1,6,0,225,1372,582,23,-1,,0.0780399274047187,0.594286941580756,,,807,1395
279,279,5,1,23,1,6,1,225,1372,34,19,93,der,0.03660012099213551,0.5934278350515464,,,259,1391
280,280,5,1,23,1,6,2,265,1372,117,19,90,berechneten,0.048926194797338174,0.5934278350515464,,,382,1391
281,281,5,1,23,1,6,3,385,1372,175,23,92,Sollzugleistung,0.07146098003629764,0.594286941580756,,,560,1395
282,282,5,1,23,1,6,4,567,1372,30,19,95,ein,0.08802177858439202,0.5934278350515464,,,597,1391
283,283,5,1,23,1,6,5,604,1377,24,14,96,an,0.09316394434361766,0.5945017182130584,,,628,1391
284,284,5,1,23,1,6,6,635,1372,34,19,93,der,0.09860859044162129,0.5934278350515464,,,669,1391
285,285,5,1,23,1,6,7,675,1372,132,19,92,betreffenden,0.11206896551724138,0.5934278350515464,,,807,1391
286,286,4,1,23,1,7,0,224,1405,583,23,-1,,0.0779643073200242,0.6084621993127147,,,807,1428
287,287,5,1,23,1,7,1,224,1405,65,18,92,Achse,0.03879310344827586,0.6073883161512027,,,289,1423
288,288,5,1,23,1,7,2,300,1405,156,18,92,einzuhaltender,0.05716878402903811,0.6073883161512027,,,456,1423
289,289,5,1,23,1,7,3,466,1405,83,18,93,Sollwert,0.07675438596491228,0.6073883161512027,,,549,1423
290,290,5,1,23,1,7,4,558,1405,28,18,91,fiir,0.08650937689050212,0.6073883161512027,,,586,1423
291,291,5,1,23,1,7,5,595,1405,43,18,93,eine,0.09323956442831216,0.6073883161512027,,,638,1423
292,292,5,1,23,1,7,6,648,1405,90,18,91,Achslast,0.10480943738656988,0.6073883161512027,,,738,1423
293,293,5,1,23,1,7,7,748,1405,59,23,92,abge-,0.1175892316999395,0.6084621993127147,,,807,1428
294,294,2,1,24,0,0,0,789,1490,23,17,-1,,0.12106775559588627,0.6436855670103093,,,812,1507
295,295,3,1,24,1,0,0,789,1490,23,17,-1,,0.12106775559588627,0.6436855670103093,,,812,1507
296,296,4,1,24,1,1,0,789,1490,23,17,-1,,0.12106775559588627,0.6436855670103093,,,812,1507
297,297,5,1,24,1,1,1,789,1490,23,17,96,22,0.12106775559588627,0.6436855670103093,,,812,1507
298,298,2,1,25,0,0,0,315,1099,1088,21,-1,,0.12991530550514216,0.47658934707903783,,,1403,1120
299,299,3,1,25,1,0,0,315,1099,1088,21,-1,,0.12991530550514216,0.47658934707903783,,,1403,1120
300,300,4,1,25,1,1,0,315,1099,1088,21,-1,,0.12991530550514216,0.47658934707903783,,,1403,1120
301,301,5,1,25,1,1,1,315,1099,163,20,91,VERFAHREN,0.05996672716273442,0.47637457044673537,title_line_1,VERFAHREN,478,1119
302,302,5,1,25,1,1,2,487,1099,54,21,93,ZUR,0.07773744706594071,0.47658934707903783,title_line_1,ZUR,541,1120
303,303,5,1,25,1,1,3,551,1099,236,21,90,BEREITSTELLUNG,0.10117967332123412,0.47658934707903783,title_line_1,BEREITSTELLUNG,787,1120
304,304,5,1,25,1,1,4,799,1099,77,21,93,EINES,0.1266636418632789,0.47658934707903783,title_line_1,EINES,876,1120
305,305,5,1,25,1,1,5,886,1099,411,21,91,BALLASTIERUNGSVORSCHLAGS,0.16507864488808227,0.47658934707903783,title_line_1,BALLASTIERUNGSVORSCHLAGS,1297,1120
306,306,5,1,25,1,1,6,1300,1099,103,21,96,EINES,0.2044010889292196,0.47658934707903783,title_line_1,EINES,1403,1120
307,307,2,1,26,0,0,0,883,1208,584,183,-1,,0.17770719903206292,0.5582044673539519,,,1467,1391
308,308,3,1,26,1,0,0,883,1208,584,183,-1,,0.17770719903206292,0.5582044673539519,,,1467,1391
309,309,4,1,26,1,1,0,885,1208,582,19,-1,,0.17785843920145192,0.5229810996563574,,,1467,1227
310,310,5,1,26,1,1,1,885,1208,49,19,92,leitet,0.13755293405928615,0.5229810996563574,,,934,1227
311,311,5,1,26,1,1,2,943,1208,37,19,96,und,0.1454174228675136,0.5229810996563574,,,980,1227
312,312,5,1,26,1,1,3,992,1208,30,19,96,mit,0.15229885057471265,0.5229810996563574,,,1022,1227
313,313,5,1,26,1,1,4,1030,1208,63,19,96,einem,0.16054143980641258,0.5229810996563574,,,1093,1227
314,314,5,1,26,1,1,5,1103,1208,28,19,78,fur,0.16893526920750151,0.5229810996563574,,,1131,1227
315,315,5,1,26,1,1,6,1139,1208,30,19,93,die,0.17453115547489415,0.5229810996563574,,,1169,1227
316,316,5,1,26,1,1,7,1179,1208,90,19,91,Achslast,0.1851179673321234,0.5229810996563574,,,1269,1227
317,317,5,1,26,1,1,8,1278,1208,109,19,92,ermittelten,0.2015275257108288,0.5229810996563574,,,1387,1227
318,318,5,1,26,1,1,9,1399,1208,68,19,90,Istwert,0.21672716273442227,0.5229810996563574,,,1467,1227
319,319,4,1,26,1,2,0,884,1241,582,23,-1,,0.17770719903206292,0.5380154639175257,,,1466,1264
320,320,5,1,26,1,2,1,884,1241,106,23,91,verglichen,0.14171203871748336,0.5380154639175257,,,990,1264
321,321,5,1,26,1,2,2,999,1241,48,22,93,"wird,",0.15471869328493648,0.5378006872852233,,,1047,1263
322,322,5,1,26,1,2,3,1056,1241,61,18,92,wobei,0.16432244404113733,0.5369415807560137,,,1117,1259
323,323,5,1,26,1,2,4,1125,1241,117,23,91,ausgehend,0.17899274047186933,0.5380154639175257,,,1242,1264
324,324,5,1,26,1,2,5,1250,1246,36,13,96,von,0.19177253478523895,0.5380154639175257,,,1286,1259
325,325,5,1,26,1,2,6,1295,1241,44,18,93,dem,0.19918330308529947,0.5369415807560137,,,1339,1259
326,326,5,1,26,1,2,7,1348,1241,118,23,92,Vergleichs-,0.21279491833030853,0.5380154639175257,,,1466,1264
327,327,4,1,26,1,3,0,884,1274,582,23,-1,,0.17770719903206292,0.5521907216494846,,,1466,1297
328,328,5,1,26,1,3,1,884,1274,90,23,92,ergebnis,0.14050211736237145,0.5521907216494846,,,974,1297
329,329,5,1,26,1,3,2,981,1274,44,18,96,eine,0.15169388989715668,0.5511168384879725,,,1025,1292
330,330,5,1,26,1,3,3,1031,1278,33,14,93,zur,0.15842407743496673,0.5519759450171822,,,1064,1292
331,331,5,1,26,1,3,4,1072,1274,109,23,93,Einhaltung,0.1703720508166969,0.5521907216494846,,,1181,1297
332,332,5,1,26,1,3,5,1188,1274,38,18,93,des,0.18254688445251058,0.5511168384879725,,,1226,1292
333,333,5,1,26,1,3,6,1233,1274,95,18,92,Sollwerts,0.19366303690260134,0.5511168384879725,,,1328,1292
334,334,5,1,26,1,3,7,1335,1274,131,18,92,erforderliche,0.2118118572292801,0.5511168384879725,,,1466,1292
335,335,4,1,26,1,4,0,884,1306,582,23,-1,,0.17770719903206292,0.5659364261168385,,,1466,1329
336,336,5,1,26,1,4,1,884,1306,110,19,92,achsweise,0.14201451905626133,0.5650773195876289,,,994,1325
337,337,5,1,26,1,4,2,1002,1306,136,23,91,Ballastierung,0.161826981246219,0.5659364261168385,,,1138,1329
338,338,5,1,26,1,4,3,1147,1306,104,19,91,berechnet,0.18133696309739866,0.5650773195876289,,,1251,1325
339,339,5,1,26,1,4,4,1259,1311,23,14,96,und,0.19215063520871142,0.5661512027491409,,,1282,1325
340,340,5,1,26,1,4,5,1285,1306,36,19,96,in,0.1970659407138536,0.5650773195876289,,,1321,1325
341,341,5,1,26,1,4,6,1329,1306,75,19,96,Gestalt,0.20666969147005446,0.5650773195876289,,,1404,1325
342,342,5,1,26,1,4,7,1411,1306,55,19,96,eines,0.21755898366606172,0.5650773195876289,,,1466,1325
343,343,4,1,26,1,5,0,884,1339,581,23,-1,,0.17763157894736842,0.5801116838487973,,,1465,1362
344,344,5,1,26,1,5,1,884,1339,129,23,60,zugeh√©rigen,0.14345130066545675,0.5801116838487973,,,1013,1362
345,345,5,1,26,1,5,2,1044,1339,263,23,72,Ballastierungsvorschlags,0.17778281911675742,0.5801116838487973,,,1307,1362
346,346,5,1,26,1,5,3,1336,1339,129,23,90,ausgegeben,0.2118118572292801,0.5801116838487973,,,1465,1362
347,347,4,1,26,1,6,0,883,1372,49,19,-1,,0.13725045372050818,0.5934278350515464,,,932,1391
348,348,5,1,26,1,6,1,883,1372,49,19,95,wird.,0.13725045372050818,0.5934278350515464,,,932,1391
349,349,2,1,27,0,0,0,848,1478,421,39,-1,,0.1600877192982456,0.6432560137457045,,,1269,1517
350,350,3,1,27,1,0,0,848,1478,421,39,-1,,0.1600877192982456,0.6432560137457045,,,1269,1517
351,351,4,1,27,1,1,0,848,1478,421,39,-1,,0.1600877192982456,0.6432560137457045,,,1269,1517
352,352,5,1,27,1,1,1,848,1490,21,17,90,12,0.12983968542044766,0.6436855670103093,,,869,1507
353,353,5,1,27,1,1,2,0,0,1653,2328,0,Jf,0.125,0.5,,,1653,2328
354,354,5,1,27,1,1,3,1174,1478,95,39,52,~10,0.18473986690865093,0.6432560137457045,,,1269,1517
355,355,2,1,28,0,0,0,1108,1527,23,16,-1,,0.169313369630974,0.6593642611683849,,,1131,1543
356,356,3,1,28,1,0,0,1108,1527,23,16,-1,,0.169313369630974,0.6593642611683849,,,1131,1543
357,357,4,1,28,1,1,0,1108,1527,23,16,-1,,0.169313369630974,0.6593642611683849,,,1131,1543
358,358,5,1,28,1,1,1,1108,1527,23,16,92,44,0.169313369630974,0.6593642611683849,,,1131,1543
359,359,2,1,29,0,0,0,641,1588,328,2,-1,,0.12174833635813673,0.6825601374570447,,,969,1590
360,360,3,1,29,1,0,0,641,1588,328,2,-1,,0.12174833635813673,0.6825601374570447,,,969,1590
361,361,4,1,29,1,1,0,641,1588,328,2,-1,,0.12174833635813673,0.6825601374570447,,,969,1590
362,362,5,1,29,1,1,1,641,1588,328,2,95, ,0.12174833635813673,0.6825601374570447,,,969,1590
363,363,2,1,30,0,0,0,399,1586,972,61,-1,,0.1338475499092559,0.694372852233677,,,1371,1647
364,364,3,1,30,1,0,0,399,1586,972,61,-1,,0.1338475499092559,0.694372852233677,,,1371,1647
365,365,4,1,30,1,1,0,399,1586,972,61,-1,,0.1338475499092559,0.694372852233677,,,1371,1647
366,366,5,1,30,1,1,1,399,1586,972,61,95,  ,0.1338475499092559,0.694372852233677,,,1371,1647
367,367,2,1,31,0,0,0,1071,1544,221,69,-1,,0.17869026013309136,0.6780498281786942,,,1292,1613
368,368,3,1,31,1,0,0,1071,1544,221,69,-1,,0.17869026013309136,0.6780498281786942,,,1292,1613
369,369,4,1,31,1,1,0,1071,1544,221,69,-1,,0.17869026013309136,0.6780498281786942,,,1292,1613
370,370,5,1,31,1,1,1,1071,1544,221,69,17,‚Äúes,0.17869026013309136,0.6780498281786942,,,1292,1613
371,371,2,1,32,0,0,0,819,1658,40,2,-1,,0.12689050211736236,0.7126288659793815,,,859,1660
372,372,3,1,32,1,0,0,819,1658,40,2,-1,,0.12689050211736236,0.7126288659793815,,,859,1660
373,373,4,1,32,1,1,0,819,1658,40,2,-1,,0.12689050211736236,0.7126288659793815,,,859,1660
374,374,5,1,32,1,1,1,819,1658,40,2,95, ,0.12689050211736236,0.7126288659793815,,,859,1660
375,375,2,1,33,0,0,0,737,1714,133,3,-1,,0.12152147610405324,0.7368986254295533,,,870,1717
376,376,3,1,33,1,0,0,737,1714,133,3,-1,,0.12152147610405324,0.7368986254295533,,,870,1717
377,377,4,1,33,1,1,0,737,1714,133,3,-1,,0.12152147610405324,0.7368986254295533,,,870,1717
378,378,5,1,33,1,1,1,737,1714,133,3,95, ,0.12152147610405324,0.7368986254295533,,,870,1717
379,379,2,1,34,0,0,0,743,1739,2,38,-1,,0.11252268602540835,0.7551546391752577,,,745,1777
380,380,3,1,34,1,0,0,743,1739,2,38,-1,,0.11252268602540835,0.7551546391752577,,,745,1777
381,381,4,1,34,1,1,0,743,1739,2,38,-1,,0.11252268602540835,0.7551546391752577,,,745,1777
382,382,5,1,34,1,1,1,743,1739,2,38,95, ,0.11252268602540835,0.7551546391752577,,,745,1777
383,383,2,1,35,0,0,0,501,1765,161,6,-1,,0.08794615849969752,0.7594501718213058,,,662,1771
384,384,3,1,35,1,0,0,501,1765,161,6,-1,,0.08794615849969752,0.7594501718213058,,,662,1771
385,385,4,1,35,1,1,0,501,1765,161,6,-1,,0.08794615849969752,0.7594501718213058,,,662,1771
386,386,5,1,35,1,1,1,501,1765,161,6,95, ,0.08794615849969752,0.7594501718213058,,,662,1771
387,387,2,1,36,0,0,0,505,1782,2,89,-1,,0.0765275257108288,0.7845790378006873,,,507,1871
388,388,3,1,36,1,0,0,505,1782,2,89,-1,,0.0765275257108288,0.7845790378006873,,,507,1871
389,389,4,1,36,1,1,0,505,1782,2,89,-1,,0.0765275257108288,0.7845790378006873,,,507,1871
390,390,5,1,36,1,1,1,505,1782,2,89,95, ,0.0765275257108288,0.7845790378006873,,,507,1871
391,391,2,1,37,0,0,0,641,1768,3,120,-1,,0.09717180883242589,0.7852233676975945,,,644,1888
392,392,3,1,37,1,0,0,641,1768,3,120,-1,,0.09717180883242589,0.7852233676975945,,,644,1888
393,393,4,1,37,1,1,0,641,1768,3,120,-1,,0.09717180883242589,0.7852233676975945,,,644,1888
394,394,5,1,37,1,1,1,641,1768,3,120,95, ,0.09717180883242589,0.7852233676975945,,,644,1888
395,395,2,1,38,0,0,0,638,1885,28,2,-1,,0.09860859044162129,0.8101374570446735,,,666,1887
396,396,3,1,38,1,0,0,638,1885,28,2,-1,,0.09860859044162129,0.8101374570446735,,,666,1887
397,397,4,1,38,1,1,0,638,1885,28,2,-1,,0.09860859044162129,0.8101374570446735,,,666,1887
398,398,5,1,38,1,1,1,638,1885,28,2,95, ,0.09860859044162129,0.8101374570446735,,,666,1887
399,399,2,1,39,0,0,0,645,1927,148,2,-1,,0.10874168179068361,0.8281786941580757,,,793,1929
400,400,3,1,39,1,0,0,645,1927,148,2,-1,,0.10874168179068361,0.8281786941580757,,,793,1929
401,401,4,1,39,1,1,0,645,1927,148,2,-1,,0.10874168179068361,0.8281786941580757,,,793,1929
402,402,5,1,39,1,1,1,645,1927,148,2,95, ,0.10874168179068361,0.8281786941580757,,,793,1929
403,403,2,1,40,0,0,0,673,1977,70,2,-1,,0.10707803992740472,0.8496563573883161,,,743,1979
404,404,3,1,40,1,0,0,673,1977,70,2,-1,,0.10707803992740472,0.8496563573883161,,,743,1979
405,405,4,1,40,1,1,0,673,1977,70,2,-1,,0.10707803992740472,0.8496563573883161,,,743,1979
406,406,5,1,40,1,1,1,673,1977,70,2,95, ,0.10707803992740472,0.8496563573883161,,,743,1979
407,407,2,1,41,0,0,0,673,1983,70,1,-1,,0.10707803992740472,0.8520189003436426,,,743,1984
408,408,3,1,41,1,0,0,673,1983,70,1,-1,,0.10707803992740472,0.8520189003436426,,,743,1984
409,409,4,1,41,1,1,0,673,1983,70,1,-1,,0.10707803992740472,0.8520189003436426,,,743,1984
410,410,5,1,41,1,1,1,673,1983,70,1,95, ,0.10707803992740472,0.8520189003436426,,,743,1984
411,411,2,1,42,0,0,0,317,1936,1,94,-1,,0.04801875378100424,0.8518041237113402,,,318,2030
412,412,3,1,42,1,0,0,317,1936,1,94,-1,,0.04801875378100424,0.8518041237113402,,,318,2030
413,413,4,1,42,1,1,0,317,1936,1,94,-1,,0.04801875378100424,0.8518041237113402,,,318,2030
414,414,5,1,42,1,1,1,317,1936,1,94,95, ,0.04801875378100424,0.8518041237113402,,,318,2030
415,415,2,1,43,0,0,0,665,1588,17,454,-1,,0.10186025408348458,0.779639175257732,,,682,2042
416,416,3,1,43,1,0,0,665,1588,17,454,-1,,0.10186025408348458,0.779639175257732,,,682,2042
417,417,4,1,43,1,1,0,665,1588,17,454,-1,,0.10186025408348458,0.779639175257732,,,682,2042
418,418,5,1,43,1,1,1,665,1588,17,454,95, ,0.10186025408348458,0.779639175257732,,,682,2042
419,419,2,1,44,0,0,0,668,1606,33,442,-1,,0.10352389594676346,0.7847938144329897,,,701,2048
420,420,3,1,44,1,0,0,668,1606,33,442,-1,,0.10352389594676346,0.7847938144329897,,,701,2048
421,421,4,1,44,1,1,0,668,1606,33,442,-1,,0.10352389594676346,0.7847938144329897,,,701,2048
422,422,5,1,44,1,1,1,668,1606,33,442,95, ,0.10352389594676346,0.7847938144329897,,,701,2048
423,423,2,1,45,0,0,0,635,1753,9,279,-1,,0.09671808832425892,0.8129295532646048,,,644,2032
424,424,3,1,45,1,0,0,635,1753,9,279,-1,,0.09671808832425892,0.8129295532646048,,,644,2032
425,425,4,1,45,1,1,0,635,1753,9,279,-1,,0.09671808832425892,0.8129295532646048,,,644,2032
426,426,5,1,45,1,1,1,635,1753,9,279,95, ,0.09671808832425892,0.8129295532646048,,,644,2032
427,427,2,1,46,0,0,0,739,1939,8,93,-1,,0.11237144585601935,0.8528780068728522,,,747,2032
428,428,3,1,46,1,0,0,739,1939,8,93,-1,,0.11237144585601935,0.8528780068728522,,,747,2032
429,429,4,1,46,1,1,0,739,1939,8,93,-1,,0.11237144585601935,0.8528780068728522,,,747,2032
430,430,5,1,46,1,1,1,739,1939,8,93,95, ,0.11237144585601935,0.8528780068728522,,,747,2032
431,431,2,1,47,0,0,0,843,1596,2,163,-1,,0.12764670296430733,0.7205756013745704,,,845,1759
432,432,3,1,47,1,0,0,843,1596,2,163,-1,,0.12764670296430733,0.7205756013745704,,,845,1759
433,433,4,1,47,1,1,0,843,1596,2,163,-1,,0.12764670296430733,0.7205756013745704,,,845,1759
434,434,5,1,47,1,1,1,843,1596,2,163,95, ,0.12764670296430733,0.7205756013745704,,,845,1759
435,435,2,1,48,0,0,0,834,1597,1,173,-1,,0.12620992135511191,0.7231529209621993,,,835,1770
436,436,3,1,48,1,0,0,834,1597,1,173,-1,,0.12620992135511191,0.7231529209621993,,,835,1770
437,437,4,1,48,1,1,0,834,1597,1,173,-1,,0.12620992135511191,0.7231529209621993,,,835,1770
438,438,5,1,48,1,1,1,834,1597,1,173,95, ,0.12620992135511191,0.7231529209621993,,,835,1770
439,439,2,1,49,0,0,0,947,1588,1,163,-1,,0.14330006049606775,0.717139175257732,,,948,1751
440,440,3,1,49,1,0,0,947,1588,1,163,-1,,0.14330006049606775,0.717139175257732,,,948,1751
441,441,4,1,49,1,1,0,947,1588,1,163,-1,,0.14330006049606775,0.717139175257732,,,948,1751
442,442,5,1,49,1,1,1,947,1588,1,163,95, ,0.14330006049606775,0.717139175257732,,,948,1751
443,443,2,1,50,0,0,0,868,1702,2,32,-1,,0.13142770719903207,0.7379725085910653,,,870,1734
444,444,3,1,50,1,0,0,868,1702,2,32,-1,,0.13142770719903207,0.7379725085910653,,,870,1734
445,445,4,1,50,1,1,0,868,1702,2,32,-1,,0.13142770719903207,0.7379725085910653,,,870,1734
446,446,5,1,50,1,1,1,868,1702,2,32,95, ,0.13142770719903207,0.7379725085910653,,,870,1734
447,447,2,1,51,0,0,0,1265,1911,2,34,-1,,0.19147005444646098,0.8281786941580757,,,1267,1945
448,448,3,1,51,1,0,0,1265,1911,2,34,-1,,0.19147005444646098,0.8281786941580757,,,1267,1945
449,449,4,1,51,1,1,0,1265,1911,2,34,-1,,0.19147005444646098,0.8281786941580757,,,1267,1945
450,450,5,1,51,1,1,1,1265,1911,2,34,95, ,0.19147005444646098,0.8281786941580757,,,1267,1945
451,451,2,1,52,0,0,0,1369,1977,22,17,-1,,0.20871143375680581,0.8528780068728522,,,1391,1994
452,452,3,1,52,1,0,0,1369,1977,22,17,-1,,0.20871143375680581,0.8528780068728522,,,1391,1994
453,453,4,1,52,1,1,0,1369,1977,22,17,-1,,0.20871143375680581,0.8528780068728522,,,1391,1994
454,454,5,1,52,1,1,1,1369,1977,22,17,96,36,0.20871143375680581,0.8528780068728522,,,1391,1994
455,455,2,1,53,0,0,0,327,2142,1006,6,-1,,0.12552934059286147,0.9213917525773195,,,1333,2148
456,456,3,1,53,1,0,0,327,2142,1006,6,-1,,0.12552934059286147,0.9213917525773195,,,1333,2148
457,457,4,1,53,1,1,0,327,2142,1006,6,-1,,0.12552934059286147,0.9213917525773195,,,1333,2148
458,458,5,1,53,1,1,1,327,2142,1006,6,95, ,0.12552934059286147,0.9213917525773195,,,1333,2148
459,459,2,1,54,0,0,0,295,1647,1076,549,-1,,0.12598306110102844,0.8253865979381443,,,1371,2196
460,460,3,1,54,1,0,0,295,1647,1076,549,-1,,0.12598306110102844,0.8253865979381443,,,1371,2196
461,461,4,1,54,1,1,0,295,1647,1076,549,-1,,0.12598306110102844,0.8253865979381443,,,1371,2196
462,462,5,1,54,1,1,1,295,1647,1076,549,95, ,0.12598306110102844,0.8253865979381443,,,1371,2196
463,463,2,1,55,0,0,0,716,2270,259,16,-1,,0.1278735632183908,0.9785223367697594,,,975,2286
464,464,3,1,55,1,0,0,716,2270,259,16,-1,,0.1278735632183908,0.9785223367697594,,,975,2286
465,465,4,1,55,1,1,0,716,2270,259,16,-1,,0.1278735632183908,0.9785223367697594,,,975,2286
466,466,5,1,55,1,1,1,716,2270,49,12,96,Printed,0.11199334543254688,0.9776632302405498,,,765,2282
467,467,5,1,55,1,1,2,771,2270,15,16,96,by,0.1177404718693285,0.9785223367697594,,,786,2286
468,468,5,1,55,1,1,3,792,2270,45,14,96,"Jouve,",0.12318511796733213,0.9780927835051546,,,837,2284
469,469,5,1,55,1,1,4,843,2270,41,12,96,75001,0.13059588626739263,0.9776632302405498,,,884,2282
470,470,5,1,55,1,1,5,893,2270,46,12,96,PARIS,0.1385359951603146,0.9776632302405498,,,939,2282
471,471,5,1,55,1,1,6,945,2270,30,16,95,(FR),0.14519056261343014,0.9785223367697594,,,975,2286
