,Unnamed: 0,level,page_num,block_num,par_num,line_num,word_num,left,top,width,height,conf,text,x,y,label,target,right,bottom
0,0,1,1,0,0,0,0,0,0,1653,2328,-1,,0.125,0.5,,,1653,2328
1,1,2,1,1,0,0,0,144,1905,31,328,-1,,0.02412280701754386,0.8887457044673539,,,175,2233
2,2,3,1,1,1,0,0,144,1905,31,328,-1,,0.02412280701754386,0.8887457044673539,,,175,2233
3,3,4,1,1,1,1,0,144,1905,31,328,-1,,0.02412280701754386,0.8887457044673539,,,175,2233
4,4,5,1,1,1,1,1,144,2179,30,54,95,EP,0.024047186932849365,0.947594501718213,,,174,2233
5,5,5,1,1,1,1,2,144,2142,31,21,95,3,0.02412280701754386,0.9246134020618557,,,175,2163
6,6,5,1,1,1,1,3,144,2061,31,65,95,401,0.02412280701754386,0.8992697594501718,,,175,2126
7,7,5,1,1,1,1,4,144,1967,31,72,92,054,0.02412280701754386,0.8603951890034365,,,175,2039
8,8,5,1,1,1,1,5,144,1905,30,50,90,A1,0.024047186932849365,0.8290378006872853,,,174,1955
9,9,2,1,2,0,0,0,429,153,88,28,-1,,0.07153660012099214,0.07173539518900343,,,517,181
10,10,3,1,2,1,0,0,429,153,88,28,-1,,0.07153660012099214,0.07173539518900343,,,517,181
11,11,4,1,2,1,1,0,429,153,88,16,-1,,0.07153660012099214,0.06915807560137457,,,517,169
12,12,5,1,2,1,1,1,429,153,88,16,84,Europaisches,0.07153660012099214,0.06915807560137457,,,517,169
13,13,4,1,2,1,2,0,429,170,71,11,-1,,0.07025105868118572,0.07538659793814433,,,500,181
14,14,5,1,2,1,2,1,429,170,71,11,96,Patentamt,0.07025105868118572,0.07538659793814433,,,500,181
15,15,2,1,3,0,0,0,429,196,89,28,-1,,0.07161222020568662,0.09020618556701031,,,518,224
16,16,3,1,3,1,0,0,429,196,89,28,-1,,0.07161222020568662,0.09020618556701031,,,518,224
17,17,4,1,3,1,1,0,429,196,63,15,-1,,0.06964609800362977,0.08741408934707903,,,492,211
18,18,5,1,3,1,1,1,429,196,63,15,95,European,0.06964609800362977,0.08741408934707903,,,492,211
19,19,4,1,3,1,2,0,429,212,89,12,-1,,0.07161222020568662,0.0936426116838488,,,518,224
20,20,5,1,3,1,2,1,429,213,43,11,96,Patent,0.06813369630973987,0.0938573883161512,,,472,224
21,21,5,1,3,1,2,2,478,212,40,12,90,Office,0.07531760435571688,0.0936426116838488,,,518,224
22,22,2,1,4,0,0,0,429,239,109,28,-1,,0.07312462189957653,0.10867697594501718,,,538,267
23,23,3,1,4,1,0,0,429,239,109,28,-1,,0.07312462189957653,0.10867697594501718,,,538,267
24,24,4,1,4,1,1,0,429,239,109,15,-1,,0.07312462189957653,0.10588487972508591,,,538,254
25,25,5,1,4,1,1,1,429,239,40,12,93,Office,0.06790683605565638,0.1052405498281787,,,469,251
26,26,5,1,4,1,1,2,474,239,64,15,93,europ√©en,0.0765275257108288,0.10588487972508591,,,538,254
27,27,4,1,4,1,2,0,429,255,77,12,-1,,0.0707047791893527,0.11211340206185567,,,506,267
28,28,5,1,4,1,2,1,429,255,22,12,95,des,0.06654567453115548,0.11211340206185567,,,451,267
29,29,5,1,4,1,2,2,457,255,49,12,82,brevets,0.07282214156079855,0.11211340206185567,,,506,267
30,30,2,1,5,0,0,0,281,136,274,150,-1,,0.06321839080459771,0.09063573883161512,,,555,286
31,31,3,1,5,1,0,0,281,136,274,150,-1,,0.06321839080459771,0.09063573883161512,,,555,286
32,32,4,1,5,1,1,0,281,136,274,150,-1,,0.06321839080459771,0.09063573883161512,,,555,286
33,33,5,1,5,1,1,1,281,136,274,150,95, ,0.06321839080459771,0.09063573883161512,,,555,286
34,34,2,1,6,0,0,0,225,324,45,26,-1,,0.037431941923774956,0.14475945017182132,,,270,350
35,35,3,1,6,1,0,0,225,324,45,26,-1,,0.037431941923774956,0.14475945017182132,,,270,350
36,36,4,1,6,1,1,0,225,324,45,26,-1,,0.037431941923774956,0.14475945017182132,,,270,350
37,37,5,1,6,1,1,1,225,324,45,26,96,(12),0.037431941923774956,0.14475945017182132,,,270,350
38,38,2,1,7,0,0,0,225,395,378,53,-1,,0.06261343012704174,0.18105670103092783,,,603,448
39,39,3,1,7,1,0,0,225,395,378,53,-1,,0.06261343012704174,0.18105670103092783,,,603,448
40,40,4,1,7,1,1,0,225,395,262,26,-1,,0.05384150030248034,0.17525773195876287,,,487,421
41,41,5,1,7,1,1,1,225,395,45,26,95,(43),0.037431941923774956,0.17525773195876287,,,270,421
42,42,5,1,7,1,1,2,286,397,48,18,95,Date,0.04688445251058681,0.17439862542955326,,,334,415
43,43,5,1,7,1,1,3,342,397,20,18,96,of,0.05323653962492438,0.17439862542955326,,,362,415
44,44,5,1,7,1,1,4,370,397,117,23,96,publication:,0.0648064125831821,0.17547250859106528,,,487,420
45,45,4,1,7,1,2,0,287,430,316,18,-1,,0.06730187537810042,0.18857388316151202,,,603,448
46,46,5,1,7,1,2,1,287,430,116,18,95,14.11.2018,0.052177858439201454,0.18857388316151202,publication_date,14.11.2018,403,448
47,47,5,1,7,1,2,2,426,430,84,18,95,Bulletin,0.07078039927404718,0.18857388316151202,,,510,448
48,48,5,1,7,1,2,3,519,430,84,18,96,2018/46,0.08484573502722323,0.18857388316151202,,,603,448
49,49,2,1,8,0,0,0,225,493,400,26,-1,,0.06427707199032062,0.21735395189003437,,,625,519
50,50,3,1,8,1,0,0,225,493,400,26,-1,,0.06427707199032062,0.21735395189003437,,,625,519
51,51,4,1,8,1,1,0,225,493,400,26,-1,,0.06427707199032062,0.21735395189003437,,,625,519
52,52,5,1,8,1,1,1,225,493,45,26,95,(21),0.037431941923774956,0.21735395189003437,,,270,519
53,53,5,1,8,1,1,2,285,495,115,23,96,Application,0.051799758015728975,0.21756872852233677,,,400,518
54,54,5,1,8,1,1,3,410,495,83,18,93,number:,0.06828493647912885,0.21649484536082475,,,493,513
55,55,5,1,8,1,1,4,505,495,120,18,92,18179220.1,0.08545069570477919,0.21649484536082475,application_number,18179220.1,625,513
56,56,2,1,9,0,0,0,225,559,325,26,-1,,0.05860556563823351,0.24570446735395188,,,550,585
57,57,3,1,9,1,0,0,225,559,325,26,-1,,0.05860556563823351,0.24570446735395188,,,550,585
58,58,4,1,9,1,1,0,225,559,325,26,-1,,0.05860556563823351,0.24570446735395188,,,550,585
59,59,5,1,9,1,1,1,225,559,45,26,96,(22),0.037431941923774956,0.24570446735395188,,,270,585
60,60,5,1,9,1,1,2,286,561,48,18,96,Date,0.04688445251058681,0.24484536082474226,,,334,579
61,61,5,1,9,1,1,3,342,566,12,13,96,of,0.05263157894736842,0.24591924398625428,,,354,579
62,62,5,1,9,1,1,4,355,561,67,23,95,filing:,0.058756805807622506,0.24591924398625428,,,422,584
63,63,5,1,9,1,1,5,432,561,118,18,95,02.11.2016,0.07425892316999395,0.24484536082474226,filing_date,02.11.2016,550,579
64,64,2,1,10,0,0,0,1002,245,458,38,-1,,0.18617664851784635,0.1134020618556701,,,1460,283
65,65,3,1,10,1,0,0,1002,245,458,38,-1,,0.18617664851784635,0.1134020618556701,,,1460,283
66,66,4,1,10,1,1,0,1002,245,458,38,-1,,0.18617664851784635,0.1134020618556701,,,1460,283
67,67,5,1,10,1,1,1,1002,256,44,27,74,(11),0.15486993345432548,0.11576460481099657,,,1046,283
68,68,5,1,10,1,1,2,1146,245,52,32,95,EP,0.17725347852389595,0.11211340206185567,number,EP,1198,277
69,69,5,1,10,1,1,3,1214,245,20,32,96,3,0.1851179673321234,0.11211340206185567,number,3,1234,277
70,70,5,1,10,1,1,4,1248,245,64,32,95,401,0.19358741681790684,0.11211340206185567,number,401,1312,277
71,71,5,1,10,1,1,5,1332,245,68,32,88,054,0.20659407138535996,0.11211340206185567,number,054,1400,277
72,72,5,1,10,1,1,6,1413,245,47,32,88,A1,0.21725650332728372,0.11211340206185567,number,A1,1460,277
73,73,2,1,11,0,0,0,577,319,537,26,-1,,0.1278735632183908,0.14261168384879724,,,1114,345
74,74,3,1,11,1,0,0,577,319,537,26,-1,,0.1278735632183908,0.14261168384879724,,,1114,345
75,75,4,1,11,1,1,0,577,319,537,26,-1,,0.1278735632183908,0.14261168384879724,,,1114,345
76,76,5,1,11,1,1,1,577,319,156,26,95,EUROPEAN,0.09906231094978826,0.14261168384879724,,,733,345
77,77,5,1,11,1,1,2,735,320,135,24,95,PATENT,0.12137023593466424,0.14261168384879724,,,870,344
78,78,5,1,11,1,1,3,873,319,241,26,96,APPLICATION,0.1502571082879613,0.14261168384879724,,,1114,345
79,79,2,1,12,0,0,0,862,395,531,142,-1,,0.1705232909860859,0.20017182130584193,,,1393,537
80,80,3,1,12,1,0,0,862,395,531,142,-1,,0.1705232909860859,0.20017182130584193,,,1393,537
81,81,4,1,12,1,1,0,862,395,126,26,-1,,0.13989715668481548,0.17525773195876287,,,988,421
82,82,5,1,12,1,1,1,862,395,44,26,93,(51),0.1336963097398669,0.17525773195876287,,,906,421
83,83,5,1,12,1,1,2,923,397,25,18,93,Int,0.1414851784633999,0.17439862542955326,,,948,415
84,84,5,1,12,1,1,3,955,397,33,18,78,Cl:,0.14692982456140352,0.17439862542955326,,,988,415
85,85,4,1,12,1,2,0,922,425,458,23,-1,,0.17407743496672717,0.1875,,,1380,448
86,86,5,1,12,1,2,1,922,428,62,18,91,B23K,0.1441318814277072,0.1877147766323024,class_international,B23K,984,446
87,87,5,1,12,1,2,2,990,428,59,18,91,37102,0.154189352692075,0.1877147766323024,class_international,37/02,1049,446
88,88,5,1,12,1,2,3,1054,425,67,16,73,(2006.01),0.16447368421052633,0.18599656357388317,,,1121,441
89,89,5,1,12,1,2,4,1193,428,61,20,92,B23Q,0.1850423472474289,0.18814432989690721,,,1254,448
90,90,5,1,12,1,2,5,1264,428,43,18,94,1101,0.19441923774954628,0.1877147766323024,,,1307,446
91,91,5,1,12,1,2,6,1313,425,67,16,75,(2006.01),0.20364488808227466,0.18599656357388317,,,1380,441
92,92,4,1,12,1,3,0,922,455,471,21,-1,,0.1750604960677556,0.19995704467353953,,,1393,476
93,93,5,1,12,1,3,1,922,458,61,18,91,B23K,0.1440562613430127,0.20060137457044674,,,983,476
94,94,5,1,12,1,3,2,990,458,59,18,62,26/03,0.154189352692075,0.20060137457044674,,,1049,476
95,95,5,1,12,1,3,3,1054,455,67,16,74,(2096.01),0.16447368421052633,0.19888316151202748,,,1121,471
96,96,5,1,12,1,3,4,1194,458,61,18,75,GO5B,0.1851935874168179,0.20060137457044674,,,1255,476
97,97,5,1,12,1,3,5,1264,458,57,18,76,19142,0.1954779189352692,0.20060137457044674,,,1321,476
98,98,5,1,12,1,3,6,1327,455,66,16,87,(2006.01),0.205686630369026,0.19888316151202748,,,1393,471
99,99,4,1,12,1,4,0,923,486,469,21,-1,,0.1750604960677556,0.21327319587628865,,,1392,507
100,100,5,1,12,1,4,1,923,488,60,19,83,GO5B,0.1441318814277072,0.21370274914089346,,,983,507
101,101,5,1,12,1,4,2,993,488,57,19,71,191401,0.15449183303085298,0.21370274914089346,,,1050,507
102,102,5,1,12,1,4,3,1053,486,82,21,74,(2006.01),0.16545674531155474,0.21327319587628865,,,1135,507
103,103,5,1,12,1,4,4,1193,488,61,19,90,B23K,0.1850423472474289,0.21370274914089346,,,1254,507
104,104,5,1,12,1,4,5,1263,488,57,19,77,10100,0.19532667876588022,0.21370274914089346,,,1320,507
105,105,5,1,12,1,4,6,1325,486,67,15,78,(2096.07),0.20545977011494254,0.21198453608247422,,,1392,501
106,106,4,1,12,1,5,0,922,516,470,21,-1,,0.1749848759830611,0.226159793814433,,,1392,537
107,107,5,1,12,1,5,1,922,519,62,18,92,B23K,0.1441318814277072,0.2268041237113402,,,984,537
108,108,5,1,12,1,5,2,991,519,45,18,83,7110,0.15328191167574107,0.2268041237113402,,,1036,537
109,109,5,1,12,1,5,3,1041,516,67,16,89,(2006.91),0.16250756200846944,0.22508591065292097,,,1108,532
110,110,5,1,12,1,5,4,1193,519,62,18,92,B23K,0.1851179673321234,0.2268041237113402,,,1255,537
111,111,5,1,12,1,5,5,1261,519,59,18,94,26/14,0.19517543859649122,0.2268041237113402,,,1320,537
112,112,5,1,12,1,5,6,1325,516,67,16,90,(2014.01),0.20545977011494254,0.22508591065292097,,,1392,532
113,113,2,1,13,0,0,0,224,613,1243,4,-1,,0.1278735632183908,0.26417525773195877,,,1467,617
114,114,3,1,13,1,0,0,224,613,1243,4,-1,,0.1278735632183908,0.26417525773195877,,,1467,617
115,115,4,1,13,1,1,0,224,613,1243,4,-1,,0.1278735632183908,0.26417525773195877,,,1467,617
116,116,5,1,13,1,1,1,224,613,1243,4,95, ,0.1278735632183908,0.26417525773195877,,,1467,617
117,117,2,1,14,0,0,0,225,631,599,119,-1,,0.07932546884452511,0.296606529209622,,,824,750
118,118,3,1,14,1,0,0,225,631,599,119,-1,,0.07932546884452511,0.296606529209622,,,824,750
119,119,4,1,14,1,1,0,225,631,388,27,-1,,0.0633696309739867,0.2768470790378007,,,613,658
120,120,5,1,14,1,1,1,225,631,45,27,96,(84),0.037431941923774956,0.2768470790378007,,,270,658
121,121,5,1,14,1,1,2,286,633,118,23,96,Designated,0.052177858439201454,0.2768470790378007,,,404,656
122,122,5,1,14,1,1,3,413,633,119,23,96,Contracting,0.07146098003629764,0.2768470790378007,,,532,656
123,123,5,1,14,1,1,4,542,633,71,19,96,States:,0.08734119782214156,0.2759879725085911,,,613,652
124,124,4,1,14,1,2,0,285,666,537,18,-1,,0.08371143375680581,0.28994845360824745,,,822,684
125,125,5,1,14,1,2,1,285,666,31,18,94,AL,0.04544767090139141,0.28994845360824745,,,316,684
126,126,5,1,14,1,2,2,323,666,31,18,94,AT,0.05119479733817302,0.28994845360824745,,,354,684
127,127,5,1,14,1,2,3,363,666,30,18,96,BE,0.05716878402903811,0.28994845360824745,,,393,684
128,128,5,1,14,1,2,4,403,666,32,18,96,BG,0.0633696309739867,0.28994845360824745,,,435,684
129,129,5,1,14,1,2,5,445,666,31,18,96,CH,0.06964609800362977,0.28994845360824745,,,476,684
130,130,5,1,14,1,2,6,486,666,32,18,95,CY,0.07592256503327284,0.28994845360824745,,,518,684
131,131,5,1,14,1,2,7,526,666,30,18,93,CZ,0.08182093163944344,0.28994845360824745,,,556,684
132,132,5,1,14,1,2,8,565,666,30,18,93,DE,0.08771929824561403,0.28994845360824745,,,595,684
133,133,5,1,14,1,2,9,605,666,32,18,95,DK,0.09392014519056262,0.28994845360824745,,,637,684
134,134,5,1,14,1,2,10,646,666,29,18,95,EE,0.0998941318814277,0.28994845360824745,,,675,684
135,135,5,1,14,1,2,11,684,666,29,18,93,ES,0.10564125831820932,0.28994845360824745,,,713,684
136,136,5,1,14,1,2,12,723,666,57,18,90,FIFR,0.11365698729582577,0.28994845360824745,,,780,684
137,137,5,1,14,1,2,13,788,666,34,18,95,GB,0.12174833635813673,0.28994845360824745,,,822,684
138,138,4,1,14,1,3,0,285,699,539,18,-1,,0.0838626739261948,0.30412371134020616,,,824,717
139,139,5,1,14,1,3,1,285,699,297,18,83,GRHRHUIEISITLILTLU,0.06556261343012704,0.30412371134020616,,,582,717
140,140,5,1,14,1,3,2,591,699,28,18,85,LV,0.09150030248033877,0.30412371134020616,,,619,717
141,141,5,1,14,1,3,3,627,699,35,18,85,MC,0.09747428917120388,0.30412371134020616,,,662,717
142,142,5,1,14,1,3,4,670,699,35,18,94,MK,0.10397761645493044,0.30412371134020616,,,705,717
143,143,5,1,14,1,3,5,713,699,32,18,91,MT,0.11025408348457351,0.30412371134020616,,,745,717
144,144,5,1,14,1,3,6,753,699,29,18,49,NL,0.11607683000604961,0.30412371134020616,,,782,717
145,145,5,1,14,1,3,7,791,699,33,18,49,NO,0.1221264367816092,0.30412371134020616,,,824,717
146,146,4,1,14,1,4,0,286,732,336,18,-1,,0.06866303690260134,0.31829896907216493,,,622,750
147,147,5,1,14,1,4,1,286,732,28,18,93,PL,0.045372050816696916,0.31829896907216493,,,314,750
148,148,5,1,14,1,4,2,323,732,29,18,92,PT,0.05104355716878403,0.31829896907216493,,,352,750
149,149,5,1,14,1,4,3,360,732,58,18,92,RORS,0.058832425892317,0.31829896907216493,,,418,750
150,150,5,1,14,1,4,4,420,732,52,18,92,SE,0.06745311554748941,0.31829896907216493,,,472,750
151,151,5,1,14,1,4,5,480,732,20,18,95,SI,0.07410768300060495,0.31829896907216493,,,500,750
152,152,5,1,14,1,4,6,510,732,31,18,93,SK,0.0794767090139141,0.31829896907216493,,,541,750
153,153,5,1,14,1,4,7,550,732,72,18,90,SMTR,0.08862673926194797,0.31829896907216493,,,622,750
154,154,2,1,15,0,0,0,225,795,513,27,-1,,0.07282214156079855,0.3472938144329897,,,738,822
155,155,3,1,15,1,0,0,225,795,513,27,-1,,0.07282214156079855,0.3472938144329897,,,738,822
156,156,4,1,15,1,1,0,225,795,513,27,-1,,0.07282214156079855,0.3472938144329897,,,738,822
157,157,5,1,15,1,1,1,225,795,45,27,96,(30),0.037431941923774956,0.3472938144329897,,,270,822
158,158,5,1,15,1,1,2,286,797,77,23,96,Priority:,0.04907743496672716,0.3472938144329897,,,363,820
159,159,5,1,15,1,1,3,383,797,118,19,94,09.11.2015,0.06684815486993345,0.34643470790378006,priority_date_eu,09.11.2015,501,816
160,160,5,1,15,1,1,4,520,797,30,19,94,US,0.0809134906231095,0.34643470790378006,,,550,816
161,161,5,1,15,1,1,5,559,797,157,19,91,201562252895,0.09641560798548095,0.34643470790378006,,,716,816
162,162,5,1,15,1,1,6,725,797,13,19,91,P,0.11063218390804598,0.34643470790378006,,,738,816
163,163,2,1,16,0,0,0,225,861,596,86,-1,,0.07909860859044163,0.38831615120274915,,,821,947
164,164,3,1,16,1,0,0,225,861,596,86,-1,,0.07909860859044163,0.38831615120274915,,,821,947
165,165,4,1,16,1,1,0,225,861,596,26,-1,,0.07909860859044163,0.3754295532646048,,,821,887
166,166,5,1,16,1,1,1,225,861,45,26,96,(62),0.037431941923774956,0.3754295532646048,,,270,887
167,167,5,1,16,1,1,2,286,863,107,18,96,Document,0.05134603750756201,0.3745704467353952,,,393,881
168,168,5,1,16,1,1,3,402,863,105,23,96,number(s),0.06873865698729582,0.3756443298969072,,,507,886
169,169,5,1,16,1,1,4,516,863,20,18,96,of,0.07955232909860858,0.3745704467353952,,,536,881
170,170,5,1,16,1,1,5,542,863,32,18,96,the,0.08439201451905626,0.3745704467353952,,,574,881
171,171,5,1,16,1,1,6,583,863,65,18,96,earlier,0.09308832425892317,0.3745704467353952,,,648,881
172,172,5,1,16,1,1,7,655,863,140,23,94,application(s),0.10964912280701754,0.3756443298969072,,,795,886
173,173,5,1,16,1,1,8,805,863,16,18,96,in,0.12295825771324864,0.3745704467353952,,,821,881
174,174,4,1,16,1,2,0,286,895,308,19,-1,,0.06654567453115548,0.38853092783505155,,,594,914
175,175,5,1,16,1,2,1,286,895,109,19,96,accordance,0.051497277676950996,0.38853092783505155,,,395,914
176,176,5,1,16,1,2,2,395,895,60,19,96,with,0.06427707199032062,0.38853092783505155,,,455,914
177,177,5,1,16,1,2,3,464,895,35,19,96,Art.,0.07282214156079855,0.38853092783505155,,,499,914
178,178,5,1,16,1,2,4,508,895,25,19,96,76,0.07872050816696914,0.38853092783505155,,,533,914
179,179,5,1,16,1,2,5,542,895,52,19,96,EPC:,0.08590441621294616,0.38853092783505155,,,594,914
180,180,4,1,16,1,3,0,286,929,250,18,-1,,0.06215970961887477,0.4029209621993127,,,536,947
181,181,5,1,16,1,3,1,286,929,121,18,81,16020430.1,0.05240471869328494,0.4029209621993127,,,407,947
182,182,5,1,16,1,3,2,417,929,7,18,81,/,0.06359649122807018,0.4029209621993127,,,424,947
183,183,5,1,16,1,3,3,432,929,11,18,94,3,0.066167574107683,0.4029209621993127,,,443,947
184,184,5,1,16,1,3,4,452,929,37,18,94,165,0.07115849969751967,0.4029209621993127,,,489,947
185,185,5,1,16,1,3,5,498,929,38,18,96,324,0.07819116757410768,0.4029209621993127,,,536,947
186,186,2,1,17,0,0,0,225,992,531,90,-1,,0.07418330308529945,0.44544673539518903,,,756,1082
187,187,3,1,17,1,0,0,225,992,531,90,-1,,0.07418330308529945,0.44544673539518903,,,756,1082
188,188,4,1,17,1,1,0,225,992,531,26,-1,,0.07418330308529945,0.43170103092783507,,,756,1018
189,189,5,1,17,1,1,1,225,992,45,26,96,(71),0.037431941923774956,0.43170103092783507,,,270,1018
190,190,5,1,17,1,1,2,285,994,103,23,93,Applicant:,0.05089231699939504,0.4319158075601375,,,388,1017
191,191,5,1,17,1,1,3,397,994,174,18,91,PEDDINGHAUS,0.07320024198427103,0.43084192439862545,applicant_line_1,PEDDINGHAUS,571,1012
192,192,5,1,17,1,1,4,580,994,176,18,96,CORPORATION,0.10102843315184513,0.43084192439862545,applicant_line_1,CORPORATION,756,1012
193,193,4,1,17,1,2,0,286,1027,91,23,-1,,0.05013611615245009,0.44609106529209624,,,377,1050
194,194,5,1,17,1,2,1,286,1027,91,23,96,"Bradley,",0.05013611615245009,0.44609106529209624,,,377,1050
195,195,4,1,17,1,3,0,286,1059,202,23,-1,,0.05852994555353902,0.45983676975945015,,,488,1082
196,196,5,1,17,1,3,1,286,1059,73,19,69,Illinois,0.04877495462794918,0.45897766323024053,,,359,1078
197,197,5,1,17,1,3,2,368,1059,64,19,96,60915,0.060496067755595885,0.45897766323024053,,,432,1078
198,198,5,1,17,1,3,3,441,1059,47,23,96,(US),0.07025105868118572,0.45983676975945015,,,488,1082
199,199,2,1,18,0,0,0,225,1123,319,91,-1,,0.05815184513006655,0.5019329896907216,,,544,1214
200,200,3,1,18,1,0,0,225,1123,319,91,-1,,0.05815184513006655,0.5019329896907216,,,544,1214
201,201,4,1,18,1,1,0,225,1123,163,27,-1,,0.046355111917725345,0.4881872852233677,,,388,1150
202,202,5,1,18,1,1,1,225,1123,45,27,93,(72),0.037431941923774956,0.4881872852233677,,,270,1150
203,203,5,1,18,1,1,2,287,1125,101,19,93,Inventors:,0.05104355716878403,0.48732817869415807,,,388,1144
204,204,4,1,18,1,2,0,262,1158,206,22,-1,,0.05520266182698125,0.502147766323024,,,468,1180
205,205,5,1,18,1,2,1,262,1163,7,8,21,¬¢,0.04015426497277677,0.5012886597938144,,,269,1171
206,206,5,1,18,1,2,2,285,1158,101,22,96,"Williams,",0.05074107683000605,0.502147766323024,inventor_line_1,"Williams,",386,1180
207,207,5,1,18,1,2,3,395,1158,73,18,96,James,0.06526013309134907,0.5012886597938144,inventor_line_1,James,468,1176
208,208,4,1,18,1,3,0,286,1191,258,23,-1,,0.06276467029643074,0.5165378006872853,,,544,1214
209,209,5,1,18,1,3,1,286,1191,96,18,96,"Manteno,",0.05051421657592257,0.5154639175257731,,,382,1209
210,210,5,1,18,1,3,2,384,1191,32,22,96,IL,0.060496067755595885,0.5163230240549829,,,416,1213
211,211,5,1,18,1,3,3,425,1191,64,18,96,60950,0.0691167574107683,0.5154639175257731,,,489,1209
212,212,5,1,18,1,3,4,498,1191,46,23,96,(US),0.07879612825166364,0.5165378006872853,,,544,1214
213,213,2,1,19,0,0,0,844,614,4,632,-1,,0.1279491833030853,0.39948453608247425,,,848,1246
214,214,3,1,19,1,0,0,844,614,4,632,-1,,0.1279491833030853,0.39948453608247425,,,848,1246
215,215,4,1,19,1,1,0,844,614,4,632,-1,,0.1279491833030853,0.39948453608247425,,,848,1246
216,216,5,1,19,1,1,1,844,614,4,632,95, ,0.1279491833030853,0.39948453608247425,,,848,1246
217,217,2,1,20,0,0,0,898,633,323,122,-1,,0.1602389594676346,0.2981099656357388,,,1221,755
218,218,3,1,20,1,0,0,898,633,323,122,-1,,0.1602389594676346,0.2981099656357388,,,1221,755
219,219,4,1,20,1,1,0,898,633,259,23,-1,,0.15539927404718692,0.2768470790378007,,,1157,656
220,220,5,1,20,1,1,1,898,639,7,7,44,*,0.13634301270417423,0.2759879725085911,,,905,646
221,221,5,1,20,1,1,2,923,633,114,23,87,"Brzezniak,",0.1482153660012099,0.2768470790378007,,,1037,656
222,222,5,1,20,1,1,3,1047,633,71,19,96,Edward,0.16371748336358136,0.2759879725085911,,,1118,652
223,223,5,1,20,1,1,4,1119,633,38,19,95,J.,0.1721113127646703,0.2759879725085911,,,1157,652
224,224,4,1,20,1,2,0,923,666,298,23,-1,,0.16212946158499697,0.29102233676975947,,,1221,689
225,225,5,1,20,1,2,1,923,666,135,18,92,"Boubonnais,",0.14980338777979432,0.28994845360824745,,,1058,684
226,226,5,1,20,1,2,2,1061,666,31,22,96,IL,0.16281004234724744,0.29080756013745707,,,1092,688
227,227,5,1,20,1,2,3,1101,666,65,18,96,60914,0.17143073200241984,0.28994845360824745,,,1166,684
228,228,5,1,20,1,2,4,1174,666,47,23,96,(US),0.1811101028433152,0.29102233676975947,,,1221,689
229,229,4,1,20,1,3,0,898,699,194,21,-1,,0.15048396854204477,0.30476804123711343,,,1092,720
230,230,5,1,20,1,3,1,898,704,7,8,37,¬¢,0.13634301270417423,0.30412371134020616,,,905,712
231,231,5,1,20,1,3,2,923,699,76,21,96,"Eckert,",0.1453418027828191,0.30476804123711343,,,999,720
232,232,5,1,20,1,3,3,1009,699,58,18,96,Peter,0.1569872958257713,0.30412371134020616,,,1067,717
233,233,5,1,20,1,3,4,1074,699,18,18,95,J.,0.16379310344827586,0.30412371134020616,,,1092,717
234,234,4,1,20,1,4,0,923,732,271,23,-1,,0.1600877192982456,0.31937285223367695,,,1194,755
235,235,5,1,20,1,4,1,923,732,109,18,96,"Kankakee,",0.14783726557773744,0.31829896907216493,,,1032,750
236,236,5,1,20,1,4,2,1034,732,32,22,96,IL,0.1588021778584392,0.31915807560137455,,,1066,754
237,237,5,1,20,1,4,3,1075,732,61,18,96,60901,0.16719600725952813,0.31829896907216493,,,1136,750
238,238,5,1,20,1,4,4,1147,732,47,23,96,(US),0.17702661826981247,0.31937285223367695,,,1194,755
239,239,2,1,21,0,0,0,862,795,535,157,-1,,0.17082577132486387,0.3752147766323024,,,1397,952
240,240,3,1,21,1,0,0,862,795,535,157,-1,,0.17082577132486387,0.3752147766323024,,,1397,952
241,241,4,1,21,1,1,0,862,795,535,27,-1,,0.17082577132486387,0.3472938144329897,,,1397,822
242,242,5,1,21,1,1,1,862,795,44,27,96,(74),0.1336963097398669,0.3472938144329897,,,906,822
243,243,5,1,21,1,1,2,923,797,163,23,96,Representative:,0.15192075015124018,0.3472938144329897,,,1086,820
244,244,5,1,21,1,1,3,1096,797,65,23,68,Konig,0.1706745311554749,0.3472938144329897,representative_line_1_eu,Kanig,1161,820
245,245,5,1,21,1,1,4,1170,797,80,23,93,Szynka,0.18300060496067755,0.3472938144329897,representative_line_1_eu,Szynka,1250,820
246,246,5,1,21,1,1,5,1258,797,90,19,92,Tilmann,0.1970659407138536,0.34643470790378006,representative_line_1_eu,Tilmann,1348,816
247,247,5,1,21,1,1,6,1356,802,41,14,96,von,0.20818209316394434,0.3475085910652921,representative_line_1_eu,von,1397,816
248,248,4,1,21,1,2,0,923,830,95,18,-1,,0.14677858439201452,0.3603951890034364,,,1018,848
249,249,5,1,21,1,2,1,923,830,95,18,92,Renesse,0.14677858439201452,0.3603951890034364,,,1018,848
250,250,4,1,21,1,3,0,923,863,378,18,-1,,0.16817906836055657,0.3745704467353952,,,1301,881
251,251,5,1,21,1,3,1,923,863,158,18,57,Patentanwalte,0.1515426497277677,0.3745704467353952,,,1081,881
252,252,5,1,21,1,3,2,1090,863,152,18,91,Partnerschaft,0.176346037507562,0.3745704467353952,,,1242,881
253,253,5,1,21,1,3,3,1250,863,51,18,91,mbB,0.1929068360556564,0.3745704467353952,,,1301,881
254,254,4,1,21,1,4,0,923,895,252,23,-1,,0.15865093768905023,0.3893900343642612,,,1175,918
255,255,5,1,21,1,4,1,923,895,141,23,88,Machtlfinger,0.1502571082879613,0.3893900343642612,,,1064,918
256,256,5,1,21,1,4,2,1071,895,84,19,96,Strasse,0.16833030852994554,0.38853092783505155,,,1155,914
257,257,5,1,21,1,4,3,1163,895,12,19,96,9,0.17679975801572897,0.38853092783505155,,,1175,914
258,258,4,1,21,1,5,0,922,929,231,23,-1,,0.15691167574107684,0.40399484536082475,,,1153,952
259,259,5,1,21,1,5,1,922,929,64,18,93,81379,0.1442831215970962,0.4029209621993127,,,986,947
260,260,5,1,21,1,5,2,996,929,101,18,49,Miinchen,0.15827283726557773,0.4029209621993127,,,1097,947
261,261,5,1,21,1,5,3,1107,929,46,23,96,(DE),0.17090139140955837,0.40399484536082475,,,1153,952
262,262,2,1,22,0,0,0,862,994,99,18,-1,,0.13785541439806412,0.43084192439862545,,,961,1012
263,263,3,1,22,1,0,0,862,994,99,18,-1,,0.13785541439806412,0.43084192439862545,,,961,1012
264,264,4,1,22,1,1,0,862,994,99,18,-1,,0.13785541439806412,0.43084192439862545,,,961,1012
265,265,5,1,22,1,1,1,862,994,99,18,95,Remarks:,0.13785541439806412,0.43084192439862545,,,961,1012
266,266,2,1,23,0,0,0,922,1027,522,83,-1,,0.17891712038717483,0.45897766323024053,,,1444,1110
267,267,3,1,23,1,0,0,922,1027,522,83,-1,,0.17891712038717483,0.45897766323024053,,,1444,1110
268,268,4,1,23,1,1,0,922,1027,477,23,-1,,0.17551421657592256,0.44609106529209624,,,1399,1050
269,269,5,1,23,1,1,1,922,1027,43,18,96,This,0.1426950998185118,0.44501718213058417,,,965,1045
270,270,5,1,23,1,1,2,974,1027,111,23,96,application,0.15570175438596492,0.44609106529209624,,,1085,1050
271,271,5,1,23,1,1,3,1093,1031,42,14,96,was,0.16848154869933454,0.44587628865979384,,,1135,1045
272,272,5,1,23,1,1,4,1142,1027,43,18,96,filed,0.17596793708408953,0.44501718213058417,,,1185,1045
273,273,5,1,23,1,1,5,1193,1031,25,14,96,on,0.1823200241984271,0.44587628865979384,,,1218,1045
274,274,5,1,23,1,1,6,1226,1027,121,18,96,22-06-2018,0.19457047791893528,0.44501718213058417,,,1347,1045
275,275,5,1,23,1,1,7,1355,1031,24,14,94,as,0.20674531155474893,0.44587628865979384,,,1379,1045
276,276,5,1,23,1,1,8,1388,1031,11,14,94,a,0.21075317604355717,0.44587628865979384,,,1399,1045
277,277,4,1,23,1,2,0,922,1059,522,23,-1,,0.17891712038717483,0.45983676975945015,,,1444,1082
278,278,5,1,23,1,2,1,922,1059,96,19,96,divisional,0.14670296430732002,0.45897766323024053,,,1018,1078
279,279,5,1,23,1,2,2,1027,1059,111,23,96,application,0.16371748336358136,0.45983676975945015,,,1138,1082
280,280,5,1,23,1,2,3,1147,1060,19,18,96,to,0.17490925589836662,0.45919243986254293,,,1166,1078
281,281,5,1,23,1,2,4,1174,1059,31,19,96,the,0.17990018148820328,0.45897766323024053,,,1205,1078
282,282,5,1,23,1,2,5,1214,1059,112,23,96,application,0.19207501512401695,0.45983676975945015,,,1326,1082
283,283,5,1,23,1,2,6,1336,1059,108,19,96,mentioned,0.2102238354506957,0.45897766323024053,,,1444,1078
284,284,4,1,23,1,3,0,923,1092,209,18,-1,,0.15539927404718692,0.4729381443298969,,,1132,1110
285,285,5,1,23,1,3,1,923,1092,59,18,93,under,0.1440562613430127,0.4729381443298969,,,982,1110
286,286,5,1,23,1,3,2,991,1092,45,18,92,INID,0.15328191167574107,0.4729381443298969,,,1036,1110
287,287,5,1,23,1,3,3,1044,1092,50,18,96,code,0.16167574107683,0.4729381443298969,,,1094,1110
288,288,5,1,23,1,3,4,1103,1092,29,18,96,62.,0.16901088929219601,0.4729381443298969,,,1132,1110
289,289,2,1,24,0,0,0,224,1243,1243,4,-1,,0.1278735632183908,0.5347938144329897,,,1467,1247
290,290,3,1,24,1,0,0,224,1243,1243,4,-1,,0.1278735632183908,0.5347938144329897,,,1467,1247
291,291,4,1,24,1,1,0,224,1243,1243,4,-1,,0.1278735632183908,0.5347938144329897,,,1467,1247
292,292,5,1,24,1,1,1,224,1243,1243,4,95, ,0.1278735632183908,0.5347938144329897,,,1467,1247
293,293,2,1,25,0,0,0,225,1263,45,26,-1,,0.037431941923774956,0.5481099656357389,,,270,1289
294,294,3,1,25,1,0,0,225,1263,45,26,-1,,0.037431941923774956,0.5481099656357389,,,270,1289
295,295,4,1,25,1,1,0,225,1263,45,26,-1,,0.037431941923774956,0.5481099656357389,,,270,1289
296,296,5,1,25,1,1,1,225,1263,45,26,96,(54),0.037431941923774956,0.5481099656357389,,,270,1289
297,297,2,1,26,0,0,0,225,1337,582,288,-1,,0.0780399274047187,0.636168384879725,,,807,1625
298,298,3,1,26,1,0,0,225,1337,582,288,-1,,0.0780399274047187,0.636168384879725,,,807,1625
299,299,4,1,26,1,1,0,225,1337,582,26,-1,,0.0780399274047187,0.5798969072164949,,,807,1363
300,300,5,1,26,1,1,1,225,1337,45,26,93,(57),0.037431941923774956,0.5798969072164949,,,270,1363
301,301,5,1,26,1,1,2,0,0,1653,2328,46,|,0.125,0.5,,,1653,2328
302,302,5,1,26,1,1,3,315,1339,15,18,64,A,0.04877495462794918,0.5790378006872853,,,330,1357
303,303,5,1,26,1,1,4,341,1340,73,22,64,system,0.05709316394434362,0.5803264604810997,,,414,1362
304,304,5,1,26,1,1,5,427,1339,40,23,96,(40),0.06760435571687841,0.5801116838487973,,,467,1362
305,305,5,1,26,1,1,6,478,1339,28,18,96,for,0.07441016333938294,0.5790378006872853,,,506,1357
306,306,5,1,26,1,1,7,517,1339,112,23,96,processing,0.0866606170598911,0.5801116838487973,,,629,1362
307,307,5,1,26,1,1,8,642,1344,11,13,96,a,0.09792800967937085,0.5801116838487973,,,653,1357
308,308,5,1,26,1,1,9,664,1339,107,23,92,workpiece,0.10851482153660012,0.5801116838487973,,,771,1362
309,309,5,1,26,1,1,10,783,1339,24,18,91,in-,0.12023593466424683,0.5790378006872853,,,807,1357
310,310,4,1,26,1,2,0,225,1372,582,23,-1,,0.0780399274047187,0.594286941580756,,,807,1395
311,311,5,1,26,1,2,1,225,1372,68,19,96,cludes,0.039171203871748335,0.5934278350515464,,,293,1391
312,312,5,1,26,1,2,2,299,1377,11,14,96,a,0.046052631578947366,0.5945017182130584,,,310,1391
313,313,5,1,26,1,2,3,318,1373,79,22,96,support,0.054068360556563826,0.5945017182130584,,,397,1395
314,314,5,1,26,1,2,4,402,1372,77,19,96,surface,0.06662129461584997,0.5934278350515464,,,479,1391
315,315,5,1,26,1,2,5,486,1372,40,23,96,(88),0.0765275257108288,0.594286941580756,,,526,1395
316,316,5,1,26,1,2,6,532,1372,28,19,96,for,0.08257713248638839,0.5934278350515464,,,560,1391
317,317,5,1,26,1,2,7,566,1372,109,23,96,supporting,0.09384452510586812,0.594286941580756,,,675,1395
318,318,5,1,26,1,2,8,683,1377,11,14,96,a,0.10412885662431942,0.5945017182130584,,,694,1391
319,319,5,1,26,1,2,9,700,1372,107,23,96,workpiece,0.11395946763460375,0.594286941580756,,,807,1395
320,320,4,1,26,1,3,0,225,1405,582,23,-1,,0.0780399274047187,0.6084621993127147,,,807,1428
321,321,5,1,26,1,3,1,225,1405,47,23,96,(44).,0.03758318209316394,0.6084621993127147,,,272,1428
322,322,5,1,26,1,3,2,283,1405,40,18,96,The,0.04582577132486389,0.6073883161512027,,,323,1423
323,323,5,1,26,1,3,3,334,1406,74,22,96,system,0.056110102843315184,0.6086769759450171,,,408,1428
324,324,5,1,26,1,3,4,420,1405,40,23,96,(40),0.06654567453115548,0.6084621993127147,,,460,1428
325,325,5,1,26,1,3,5,473,1405,86,18,96,includes,0.0780399274047187,0.6073883161512027,,,559,1423
326,326,5,1,26,1,3,6,570,1410,11,13,96,a,0.08703871748336359,0.6084621993127147,,,581,1423
327,327,5,1,26,1,3,7,594,1405,112,23,96,processing,0.09830611010284332,0.6084621993127147,,,706,1428
328,328,5,1,26,1,3,8,718,1405,36,18,96,tool,0.11131276467029642,0.6073883161512027,,,754,1423
329,329,5,1,26,1,3,9,767,1405,40,23,96,(92),0.11902601330913491,0.6084621993127147,,,807,1428
330,330,4,1,26,1,4,0,226,1438,580,23,-1,,0.0780399274047187,0.6226374570446735,,,806,1461
331,331,5,1,26,1,4,1,226,1438,88,18,94,movable,0.04083484573502722,0.6215635738831615,,,314,1456
332,332,5,1,26,1,4,2,321,1438,41,18,96,with,0.05164851784633999,0.6215635738831615,,,362,1456
333,333,5,1,26,1,4,3,371,1442,71,19,96,respect,0.06147912885662432,0.6234965635738832,,,442,1461
334,334,5,1,26,1,4,4,443,1438,31,18,96,to,0.06934361766485178,0.6215635738831615,,,474,1456
335,335,5,1,26,1,4,5,483,1442,12,14,96,a,0.07395644283121597,0.6224226804123711,,,495,1456
336,336,5,1,26,1,4,6,504,1438,112,23,96,processing,0.08469449485783424,0.6226374570446735,,,616,1461
337,337,5,1,26,1,4,7,626,1438,50,23,96,path.,0.0984573502722323,0.6226374570446735,,,676,1461
338,338,5,1,26,1,4,8,685,1438,39,18,96,The,0.10654869933454325,0.6215635738831615,,,724,1456
339,339,5,1,26,1,4,9,733,1438,73,23,96,system,0.11637931034482758,0.6226374570446735,,,806,1461
340,340,4,1,26,1,5,0,225,1470,582,23,-1,,0.0780399274047187,0.6363831615120275,,,807,1493
341,341,5,1,26,1,5,1,225,1470,40,23,96,(40),0.03705384150030248,0.6363831615120275,,,265,1493
342,342,5,1,26,1,5,2,276,1470,85,19,96,includes,0.048169993950393224,0.6355240549828178,,,361,1489
343,343,5,1,26,1,5,3,371,1475,11,14,96,a,0.05694192377495463,0.6365979381443299,,,382,1489
344,344,5,1,26,1,5,4,393,1475,70,14,96,sensor,0.0647307924984876,0.6365979381443299,,,463,1489
345,345,5,1,26,1,5,5,473,1470,84,23,96,carriage,0.0778886872353297,0.6363831615120275,,,557,1493
346,346,5,1,26,1,5,6,567,1470,53,23,96,(408),0.0897610405323654,0.6363831615120275,,,620,1493
347,347,5,1,26,1,5,7,631,1470,88,19,95,movable,0.10208711433756806,0.6355240549828178,,,719,1489
348,348,5,1,26,1,5,8,729,1470,56,23,95,along,0.11448880822746521,0.6363831615120275,,,785,1493
349,349,5,1,26,1,5,9,796,1475,11,14,96,a,0.12121899576527526,0.6365979381443299,,,807,1489
350,350,4,1,26,1,6,0,225,1503,582,23,-1,,0.0780399274047187,0.6505584192439863,,,807,1526
351,351,5,1,26,1,6,1,225,1508,48,13,96,scan,0.03765880217785844,0.6505584192439863,,,273,1521
352,352,5,1,26,1,6,2,281,1503,41,18,96,axis,0.0455989110707804,0.6494845360824743,,,322,1521
353,353,5,1,26,1,6,3,329,1503,38,18,96,and,0.05263157894736842,0.6494845360824743,,,367,1521
354,354,5,1,26,1,6,4,376,1503,66,23,96,having,0.06185722928009679,0.6505584192439863,,,442,1526
355,355,5,1,26,1,6,5,0,0,1653,2328,94,a,0.125,0.5,,,1653,2328
356,356,5,1,26,1,6,6,450,1503,63,23,94,light,0.07282214156079855,0.6505584192439863,,,513,1526
357,357,5,1,26,1,6,7,519,1508,70,13,96,source,0.0837870538415003,0.6505584192439863,,,589,1521
358,358,5,1,26,1,6,8,597,1503,51,23,96,"(476,",0.0941470054446461,0.6505584192439863,,,648,1526
359,359,5,1,26,1,6,9,657,1503,43,21,96,"515,",0.10261645493042952,0.6501288659793815,,,700,1524
360,360,5,1,26,1,6,10,709,1503,43,22,96,"550,",0.11048094373865698,0.6503436426116839,,,752,1525
361,361,5,1,26,1,6,11,761,1503,46,23,96,586),0.11857229280096794,0.6505584192439863,,,807,1526
362,362,4,1,26,1,7,0,226,1536,581,23,-1,,0.07811554748941318,0.664733676975945,,,807,1559
363,363,5,1,26,1,7,1,226,1536,74,18,96,located,0.03977616454930429,0.663659793814433,,,300,1554
364,364,5,1,26,1,7,2,308,1536,18,18,96,to,0.04794313369630974,0.663659793814433,,,326,1554
365,365,5,1,26,1,7,3,334,1536,45,18,95,emit,0.05391712038717483,0.663659793814433,,,379,1554
366,366,5,1,26,1,7,4,386,1540,11,14,95,a,0.05921052631578947,0.6645189003436426,,,397,1554
367,367,5,1,26,1,7,5,406,1536,42,23,96,light,0.06457955232909861,0.664733676975945,,,448,1559
368,368,5,1,26,1,7,6,456,1536,56,18,95,beam,0.07320024198427103,0.663659793814433,,,512,1554
369,369,5,1,26,1,7,7,521,1536,19,18,95,at,0.08023290986085904,0.663659793814433,,,540,1554
370,370,5,1,26,1,7,8,547,1540,24,14,96,an,0.08454325468844526,0.6645189003436426,,,571,1554
371,371,5,1,26,1,7,9,580,1536,56,23,96,angle,0.09195402298850575,0.664733676975945,,,636,1559
372,372,5,1,26,1,7,10,644,1536,18,18,96,to,0.09875983061101029,0.663659793814433,,,662,1554
373,373,5,1,26,1,7,11,670,1536,32,18,96,the,0.10375075620084695,0.663659793814433,,,702,1554
374,374,5,1,26,1,7,12,710,1540,47,14,95,scan,0.11093466424682395,0.6645189003436426,,,757,1554
375,375,5,1,26,1,7,13,766,1536,41,18,89,axis,0.11895039322444041,0.663659793814433,,,807,1554
376,376,4,1,26,1,8,0,225,1569,582,23,-1,,0.0780399274047187,0.6789089347079038,,,807,1592
377,377,5,1,26,1,8,1,225,1570,45,17,96,onto,0.037431941923774956,0.6780498281786942,,,270,1587
378,378,5,1,26,1,8,2,278,1574,11,13,96,a,0.042876588021778586,0.6789089347079038,,,289,1587
379,379,5,1,26,1,8,3,297,1570,53,22,96,target,0.048926194797338174,0.6791237113402062,,,350,1592
380,380,5,1,26,1,8,4,352,1569,89,18,96,surface,0.05996672716273442,0.6778350515463918,,,441,1587
381,381,5,1,26,1,8,5,448,1569,21,18,96,of,0.06934361766485178,0.6778350515463918,,,469,1587
382,382,5,1,26,1,8,6,475,1574,11,13,96,a,0.07267090139140955,0.6789089347079038,,,486,1587
383,383,5,1,26,1,8,7,494,1569,107,23,96,workpiece,0.08280399274047187,0.6789089347079038,,,601,1592
384,384,5,1,26,1,8,8,609,1569,46,23,96,"(44),",0.0955837870538415,0.6789089347079038,,,655,1592
385,385,5,1,26,1,8,9,664,1569,37,18,96,and,0.10322141560798548,0.6778350515463918,,,701,1587
386,386,5,1,26,1,8,10,710,1574,11,13,96,a,0.10821234119782214,0.6789089347079038,,,721,1587
387,387,5,1,26,1,8,11,730,1574,77,13,96,camera,0.1162280701754386,0.6789089347079038,,,807,1587
388,388,4,1,26,1,9,0,225,1602,582,23,-1,,0.0780399274047187,0.6930841924398625,,,807,1625
389,389,5,1,26,1,9,1,225,1602,52,23,96,"(484,",0.03796128251663642,0.6930841924398625,,,277,1625
390,390,5,1,26,1,9,2,286,1602,45,21,96,"522,",0.04665759225650333,0.6926546391752577,,,331,1623
391,391,5,1,26,1,9,3,341,1602,44,21,96,"558,",0.05490018148820327,0.6926546391752577,,,385,1623
392,392,5,1,26,1,9,4,395,1602,46,23,96,594),0.06321839080459771,0.6930841924398625,,,441,1625
393,393,5,1,26,1,9,5,451,1602,109,23,96,configured,0.0764519056261343,0.6930841924398625,,,560,1625
394,394,5,1,26,1,9,6,569,1602,19,18,96,to,0.08749243799153054,0.6920103092783505,,,588,1620
395,395,5,1,26,1,9,7,598,1602,64,18,96,record,0.09528130671506352,0.6920103092783505,,,662,1620
396,396,5,1,26,1,9,8,674,1602,78,18,81,location,0.10783424077434967,0.6920103092783505,,,752,1620
397,397,5,1,26,1,9,9,762,1602,45,18,95,data,0.11864791288566243,0.6920103092783505,,,807,1620
398,398,2,1,27,0,0,0,316,1263,552,21,-1,,0.08953418027828192,0.5470360824742269,,,868,1284
399,399,3,1,27,1,0,0,316,1263,552,21,-1,,0.08953418027828192,0.5470360824742269,,,868,1284
400,400,4,1,27,1,1,0,316,1263,552,21,-1,,0.08953418027828192,0.5470360824742269,,,868,1284
401,401,5,1,27,1,1,1,316,1263,105,21,96,SYSTEM,0.05573200241984271,0.5470360824742269,title_line_1,SYSTEM,421,1284
402,402,5,1,27,1,1,2,433,1263,53,21,96,FOR,0.06949485783424078,0.5470360824742269,title_line_1,FOR,486,1284
403,403,5,1,27,1,1,3,496,1263,173,21,95,PROCESSING,0.08809739866908652,0.5470360824742269,title_line_1,PROCESSING,669,1284
404,404,5,1,27,1,1,4,679,1264,19,19,96,A,0.10412885662431942,0.5470360824742269,title_line_1,A,698,1283
405,405,5,1,27,1,1,5,705,1263,163,21,96,WORKPIECE,0.11895039322444041,0.5470360824742269,title_line_1,WORKPIECE,868,1284
406,406,2,1,28,0,0,0,884,1339,582,253,-1,,0.17770719903206292,0.6295103092783505,,,1466,1592
407,407,3,1,28,1,0,0,884,1339,582,253,-1,,0.17770719903206292,0.6295103092783505,,,1466,1592
408,408,4,1,28,1,1,0,884,1339,581,23,-1,,0.17763157894736842,0.5801116838487973,,,1465,1362
409,409,5,1,28,1,1,1,884,1344,12,13,96,of,0.13460375075620085,0.5801116838487973,,,896,1357
410,410,5,1,28,1,1,2,896,1339,45,18,96,the,0.13891409558378706,0.5790378006872853,,,941,1357
411,411,5,1,28,1,1,3,950,1339,42,23,96,light,0.14685420447670902,0.5801116838487973,,,992,1362
412,412,5,1,28,1,1,4,999,1339,57,18,96,beam,0.15539927404718692,0.5790378006872853,,,1056,1357
413,413,5,1,28,1,1,5,1064,1344,24,13,96,on,0.16273442226255294,0.5801116838487973,,,1088,1357
414,414,5,1,28,1,1,6,0,0,1653,2328,96,a,0.125,0.5,,,1653,2328
415,415,5,1,28,1,1,7,1096,1340,80,22,96,target,0.17180883242589232,0.5803264604810997,,,1176,1362
416,416,5,1,28,1,1,8,1182,1339,77,18,96,surface,0.18458862673926194,0.5790378006872853,,,1259,1357
417,417,5,1,28,1,1,9,1267,1339,20,18,97,of,0.19313369630973987,0.5790378006872853,,,1287,1357
418,418,5,1,28,1,1,10,1293,1344,11,13,96,a,0.19638535995160314,0.5801116838487973,,,1304,1357
419,419,5,1,28,1,1,11,1311,1339,107,23,96,workpiece,0.20636721113127646,0.5801116838487973,,,1418,1362
420,420,5,1,28,1,1,12,1425,1339,40,23,95,(44),0.21854204476709013,0.5801116838487973,,,1465,1362
421,421,4,1,28,1,2,0,884,1372,581,23,-1,,0.17763157894736842,0.594286941580756,,,1465,1395
422,422,5,1,28,1,2,1,884,1377,23,14,96,as,0.1354355716878403,0.5945017182130584,,,907,1391
423,423,5,1,28,1,2,2,915,1372,31,19,96,the,0.14072897761645492,0.5934278350515464,,,946,1391
424,424,5,1,28,1,2,3,954,1377,62,14,96,sensor,0.14897156684815488,0.5945017182130584,,,1016,1391
425,425,5,1,28,1,2,4,1018,1372,97,23,95,carriage,0.16129764065335753,0.594286941580756,,,1115,1395
426,426,5,1,28,1,2,5,1123,1372,53,23,96,(408),0.17385057471264367,0.594286941580756,,,1176,1395
427,427,5,1,28,1,2,6,1185,1377,67,14,96,moves,0.18428614640048396,0.5945017182130584,,,1252,1391
428,428,5,1,28,1,2,7,1260,1372,56,23,96,along,0.19479733817301875,0.594286941580756,,,1316,1395
429,429,5,1,28,1,2,8,1323,1372,33,19,96,the,0.2025862068965517,0.5934278350515464,,,1356,1391
430,430,5,1,28,1,2,9,1363,1377,48,14,96,scan,0.20977011494252873,0.5945017182130584,,,1411,1391
431,431,5,1,28,1,2,10,1418,1372,47,19,96,axis.,0.2180127041742287,0.5934278350515464,,,1465,1391
432,432,4,1,28,1,3,0,884,1405,581,23,-1,,0.17763157894736842,0.6084621993127147,,,1465,1428
433,433,5,1,28,1,3,1,884,1405,39,18,96,The,0.1366454930429522,0.6073883161512027,,,923,1423
434,434,5,1,28,1,3,2,929,1406,73,22,96,system,0.14602238354506958,0.6086769759450171,,,1002,1428
435,435,5,1,28,1,3,3,1010,1405,33,23,96,(40),0.15524803387779795,0.6084621993127147,,,1043,1428
436,436,5,1,28,1,3,4,1045,1405,98,23,96,includes,0.16545674531155474,0.6084621993127147,,,1143,1428
437,437,5,1,28,1,3,5,1149,1410,11,13,95,a,0.17460677555958862,0.6084621993127147,,,1160,1423
438,438,5,1,28,1,3,6,1167,1405,69,18,95,control,0.18171506352087113,0.6073883161512027,,,1236,1423
439,439,5,1,28,1,3,7,1242,1406,74,22,96,system,0.19343617664851784,0.6086769759450171,,,1316,1428
440,440,5,1,28,1,3,8,1322,1405,28,18,96,for,0.20205686630369027,0.6073883161512027,,,1350,1423
441,441,5,1,28,1,3,9,1355,1405,110,23,96,generating,0.2132486388384755,0.6084621993127147,,,1465,1428
442,442,4,1,28,1,4,0,884,1438,582,23,-1,,0.17770719903206292,0.6226374570446735,,,1466,1461
443,443,5,1,28,1,4,1,884,1442,12,14,91,a,0.13460375075620085,0.6224226804123711,,,896,1456
444,444,5,1,28,1,4,2,903,1438,183,18,91,three-dimensional,0.15040834845735027,0.6215635738831615,,,1086,1456
445,445,5,1,28,1,4,3,1089,1438,61,23,96,point,0.169313369630974,0.6226374570446735,,,1150,1461
446,446,5,1,28,1,4,4,1157,1438,150,23,96,representation,0.18632788868723532,0.6226374570446735,,,1307,1461
447,447,5,1,28,1,4,5,1315,1438,20,18,96,of,0.20039322444041138,0.6215635738831615,,,1335,1456
448,448,5,1,28,1,4,6,1341,1442,11,14,96,a,0.20364488808227466,0.6224226804123711,,,1352,1456
449,449,5,1,28,1,4,7,1359,1438,107,23,96,workpiece,0.21362673926194797,0.6226374570446735,,,1466,1461
450,450,4,1,28,1,5,0,884,1470,582,23,-1,,0.17770719903206292,0.6363831615120275,,,1466,1493
451,451,5,1,28,1,5,1,884,1470,77,19,96,surface,0.139519056261343,0.6355240549828178,,,961,1489
452,452,5,1,28,1,5,2,973,1470,46,19,96,from,0.15063520871143377,0.6355240549828178,,,1019,1489
453,453,5,1,28,1,5,3,1033,1470,32,19,96,the,0.15865093768905023,0.6355240549828178,,,1065,1489
454,454,5,1,28,1,5,4,1080,1470,42,23,96,light,0.16651542649727769,0.6363831615120275,,,1122,1493
455,455,5,1,28,1,5,5,1135,1470,56,19,96,beam,0.17589231699939503,0.6355240549828178,,,1191,1489
456,456,5,1,28,1,5,6,1207,1470,79,19,96,location,0.18852087114337568,0.6355240549828178,,,1286,1489
457,457,5,1,28,1,5,7,1299,1470,51,22,96,"data,",0.20031760435571688,0.636168384879725,,,1350,1492
458,458,5,1,28,1,5,8,1364,1471,18,18,96,to,0.20765275257108287,0.6357388316151202,,,1382,1489
459,459,5,1,28,1,5,9,1397,1470,69,19,96,control,0.21650030248033877,0.6355240549828178,,,1466,1489
460,460,4,1,28,1,6,0,885,1503,581,23,-1,,0.17778281911675742,0.6505584192439863,,,1466,1526
461,461,5,1,28,1,6,1,885,1508,101,13,96,movement,0.1414851784633999,0.6505584192439863,,,986,1521
462,462,5,1,28,1,6,2,989,1503,38,18,96,of,0.15245009074410162,0.6494845360824743,,,1027,1521
463,463,5,1,28,1,6,3,1040,1503,31,18,96,the,0.15963399879007864,0.6494845360824743,,,1071,1521
464,464,5,1,28,1,6,4,1086,1503,112,23,96,processing,0.17271627344222626,0.6505584192439863,,,1198,1526
465,465,5,1,28,1,6,5,1212,1503,38,18,92,tool,0.18617664851784635,0.6494845360824743,,,1250,1521
466,466,5,1,28,1,6,6,1264,1503,40,23,95,(92),0.19419237749546278,0.6505584192439863,,,1304,1526
467,467,5,1,28,1,6,7,1320,1503,61,18,96,based,0.2042498487598306,0.6494845360824743,,,1381,1521
468,468,5,1,28,1,6,8,1395,1508,25,13,96,on,0.21287053841500303,0.6505584192439863,,,1420,1521
469,469,5,1,28,1,6,9,1434,1503,32,18,96,the,0.21929824561403508,0.6494845360824743,,,1466,1521
470,470,4,1,28,1,7,0,884,1536,582,23,-1,,0.17770719903206292,0.664733676975945,,,1466,1559
471,471,5,1,28,1,7,1,884,1536,188,18,92,three-dimensional,0.14791288566243194,0.663659793814433,,,1072,1554
472,472,5,1,28,1,7,2,1084,1536,50,23,95,point,0.1677253478523896,0.664733676975945,,,1134,1559
473,473,5,1,28,1,7,3,1146,1536,150,23,96,representation,0.18466424682395643,0.664733676975945,,,1296,1559
474,474,5,1,28,1,7,4,1307,1536,20,18,96,of,0.19918330308529947,0.663659793814433,,,1327,1554
475,475,5,1,28,1,7,5,1337,1540,12,14,96,a,0.20311554748941318,0.6645189003436426,,,1349,1554
476,476,5,1,28,1,7,6,1359,1536,107,23,96,workpiece,0.21362673926194797,0.664733676975945,,,1466,1559
477,477,4,1,28,1,8,0,885,1569,45,23,-1,,0.13725045372050818,0.6789089347079038,,,930,1592
478,478,5,1,28,1,8,1,885,1569,45,23,95,(44).,0.13725045372050818,0.6789089347079038,,,930,1592
479,479,2,1,29,0,0,0,450,1670,791,538,-1,,0.1278735632183908,0.8329037800687286,,,1241,2208
480,480,3,1,29,1,0,0,450,1670,791,538,-1,,0.1278735632183908,0.8329037800687286,,,1241,2208
481,481,4,1,29,1,1,0,450,1670,791,538,-1,,0.1278735632183908,0.8329037800687286,,,1241,2208
482,482,5,1,29,1,1,1,450,1670,791,538,95, ,0.1278735632183908,0.8329037800687286,,,1241,2208
483,483,2,1,30,0,0,0,716,2270,259,16,-1,,0.1278735632183908,0.9785223367697594,,,975,2286
484,484,3,1,30,1,0,0,716,2270,259,16,-1,,0.1278735632183908,0.9785223367697594,,,975,2286
485,485,4,1,30,1,1,0,716,2270,259,16,-1,,0.1278735632183908,0.9785223367697594,,,975,2286
486,486,5,1,30,1,1,1,716,2270,49,12,96,Printed,0.11199334543254688,0.9776632302405498,,,765,2282
487,487,5,1,30,1,1,2,771,2270,15,16,96,by,0.1177404718693285,0.9785223367697594,,,786,2286
488,488,5,1,30,1,1,3,792,2270,45,14,96,"Jouve,",0.12318511796733213,0.9780927835051546,,,837,2284
489,489,5,1,30,1,1,4,843,2270,41,12,96,75001,0.13059588626739263,0.9776632302405498,,,884,2282
490,490,5,1,30,1,1,5,893,2270,46,12,96,PARIS,0.1385359951603146,0.9776632302405498,,,939,2282
491,491,5,1,30,1,1,6,945,2270,30,16,95,(FR),0.14519056261343014,0.9785223367697594,,,975,2286
