,Unnamed: 0,level,page_num,block_num,par_num,line_num,word_num,left,top,width,height,conf,text,x,y,label,target,right,bottom
0,0,1,1,0,0,0,0,0,0,1653,2328,-1,,0.125,0.5,,,1653,2328
1,1,2,1,1,0,0,0,144,1905,31,328,-1,,0.02412280701754386,0.8887457044673539,,,175,2233
2,2,3,1,1,1,0,0,144,1905,31,328,-1,,0.02412280701754386,0.8887457044673539,,,175,2233
3,3,4,1,1,1,1,0,144,1905,31,328,-1,,0.02412280701754386,0.8887457044673539,,,175,2233
4,4,5,1,1,1,1,1,144,2179,30,54,96,EP,0.024047186932849365,0.947594501718213,,,174,2233
5,5,5,1,1,1,1,2,144,2142,31,21,95,3,0.02412280701754386,0.9246134020618557,,,175,2163
6,6,5,1,1,1,1,3,144,2061,31,65,95,401,0.02412280701754386,0.8992697594501718,,,175,2126
7,7,5,1,1,1,1,4,144,1968,31,71,90,016,0.02412280701754386,0.8606099656357389,,,175,2039
8,8,5,1,1,1,1,5,144,1905,30,50,90,A1,0.024047186932849365,0.8290378006872853,,,174,1955
9,9,2,1,2,0,0,0,429,153,88,28,-1,,0.07153660012099214,0.07173539518900343,,,517,181
10,10,3,1,2,1,0,0,429,153,88,28,-1,,0.07153660012099214,0.07173539518900343,,,517,181
11,11,4,1,2,1,1,0,429,153,88,16,-1,,0.07153660012099214,0.06915807560137457,,,517,169
12,12,5,1,2,1,1,1,429,153,88,16,84,Europaisches,0.07153660012099214,0.06915807560137457,,,517,169
13,13,4,1,2,1,2,0,429,170,71,11,-1,,0.07025105868118572,0.07538659793814433,,,500,181
14,14,5,1,2,1,2,1,429,170,71,11,96,Patentamt,0.07025105868118572,0.07538659793814433,,,500,181
15,15,2,1,3,0,0,0,429,196,89,28,-1,,0.07161222020568662,0.09020618556701031,,,518,224
16,16,3,1,3,1,0,0,429,196,89,28,-1,,0.07161222020568662,0.09020618556701031,,,518,224
17,17,4,1,3,1,1,0,429,196,63,15,-1,,0.06964609800362977,0.08741408934707903,,,492,211
18,18,5,1,3,1,1,1,429,196,63,15,95,European,0.06964609800362977,0.08741408934707903,,,492,211
19,19,4,1,3,1,2,0,429,212,89,12,-1,,0.07161222020568662,0.0936426116838488,,,518,224
20,20,5,1,3,1,2,1,429,213,43,11,96,Patent,0.06813369630973987,0.0938573883161512,,,472,224
21,21,5,1,3,1,2,2,478,212,40,12,90,Office,0.07531760435571688,0.0936426116838488,,,518,224
22,22,2,1,4,0,0,0,429,239,109,28,-1,,0.07312462189957653,0.10867697594501718,,,538,267
23,23,3,1,4,1,0,0,429,239,109,28,-1,,0.07312462189957653,0.10867697594501718,,,538,267
24,24,4,1,4,1,1,0,429,239,109,15,-1,,0.07312462189957653,0.10588487972508591,,,538,254
25,25,5,1,4,1,1,1,429,239,40,12,93,Office,0.06790683605565638,0.1052405498281787,,,469,251
26,26,5,1,4,1,1,2,474,239,64,15,93,européen,0.0765275257108288,0.10588487972508591,,,538,254
27,27,4,1,4,1,2,0,429,255,77,12,-1,,0.0707047791893527,0.11211340206185567,,,506,267
28,28,5,1,4,1,2,1,429,255,22,12,95,des,0.06654567453115548,0.11211340206185567,,,451,267
29,29,5,1,4,1,2,2,457,255,49,12,82,brevets,0.07282214156079855,0.11211340206185567,,,506,267
30,30,2,1,5,0,0,0,281,136,274,150,-1,,0.06321839080459771,0.09063573883161512,,,555,286
31,31,3,1,5,1,0,0,281,136,274,150,-1,,0.06321839080459771,0.09063573883161512,,,555,286
32,32,4,1,5,1,1,0,281,136,274,150,-1,,0.06321839080459771,0.09063573883161512,,,555,286
33,33,5,1,5,1,1,1,281,136,274,150,95, ,0.06321839080459771,0.09063573883161512,,,555,286
34,34,2,1,6,0,0,0,225,324,45,26,-1,,0.037431941923774956,0.14475945017182132,,,270,350
35,35,3,1,6,1,0,0,225,324,45,26,-1,,0.037431941923774956,0.14475945017182132,,,270,350
36,36,4,1,6,1,1,0,225,324,45,26,-1,,0.037431941923774956,0.14475945017182132,,,270,350
37,37,5,1,6,1,1,1,225,324,45,26,96,(12),0.037431941923774956,0.14475945017182132,,,270,350
38,38,2,1,7,0,0,0,225,395,378,53,-1,,0.06261343012704174,0.18105670103092783,,,603,448
39,39,3,1,7,1,0,0,225,395,378,53,-1,,0.06261343012704174,0.18105670103092783,,,603,448
40,40,4,1,7,1,1,0,225,395,262,26,-1,,0.05384150030248034,0.17525773195876287,,,487,421
41,41,5,1,7,1,1,1,225,395,45,26,95,(43),0.037431941923774956,0.17525773195876287,,,270,421
42,42,5,1,7,1,1,2,286,397,48,18,95,Date,0.04688445251058681,0.17439862542955326,,,334,415
43,43,5,1,7,1,1,3,342,397,20,18,96,of,0.05323653962492438,0.17439862542955326,,,362,415
44,44,5,1,7,1,1,4,370,397,117,23,96,publication:,0.0648064125831821,0.17547250859106528,,,487,420
45,45,4,1,7,1,2,0,287,430,316,18,-1,,0.06730187537810042,0.18857388316151202,,,603,448
46,46,5,1,7,1,2,1,287,430,116,18,95,14.11.2018,0.052177858439201454,0.18857388316151202,publication_date,14.11.2018,403,448
47,47,5,1,7,1,2,2,426,430,84,18,95,Bulletin,0.07078039927404718,0.18857388316151202,,,510,448
48,48,5,1,7,1,2,3,519,430,84,18,96,2018/46,0.08484573502722323,0.18857388316151202,,,603,448
49,49,2,1,8,0,0,0,225,493,402,26,-1,,0.06442831215970962,0.21735395189003437,,,627,519
50,50,3,1,8,1,0,0,225,493,402,26,-1,,0.06442831215970962,0.21735395189003437,,,627,519
51,51,4,1,8,1,1,0,225,493,402,26,-1,,0.06442831215970962,0.21735395189003437,,,627,519
52,52,5,1,8,1,1,1,225,493,45,26,95,(21),0.037431941923774956,0.21735395189003437,,,270,519
53,53,5,1,8,1,1,2,285,495,115,23,96,Application,0.051799758015728975,0.21756872852233677,,,400,518
54,54,5,1,8,1,1,3,410,495,83,18,93,number:,0.06828493647912885,0.21649484536082475,,,493,513
55,55,5,1,8,1,1,4,505,495,122,18,92,18180197.8,0.08560193587416817,0.21649484536082475,application_number,18180197.8,627,513
56,56,2,1,9,0,0,0,225,559,325,26,-1,,0.05860556563823351,0.24570446735395188,,,550,585
57,57,3,1,9,1,0,0,225,559,325,26,-1,,0.05860556563823351,0.24570446735395188,,,550,585
58,58,4,1,9,1,1,0,225,559,325,26,-1,,0.05860556563823351,0.24570446735395188,,,550,585
59,59,5,1,9,1,1,1,225,559,45,26,96,(22),0.037431941923774956,0.24570446735395188,,,270,585
60,60,5,1,9,1,1,2,286,561,48,18,96,Date,0.04688445251058681,0.24484536082474226,,,334,579
61,61,5,1,9,1,1,3,342,566,12,13,96,of,0.05263157894736842,0.24591924398625428,,,354,579
62,62,5,1,9,1,1,4,355,561,67,23,96,filing:,0.058756805807622506,0.24591924398625428,,,422,584
63,63,5,1,9,1,1,5,432,561,118,18,96,04.02.2015,0.07425892316999395,0.24484536082474226,filing_date,04.02.2015,550,579
64,64,2,1,10,0,0,0,1002,245,458,38,-1,,0.18617664851784635,0.1134020618556701,,,1460,283
65,65,3,1,10,1,0,0,1002,245,458,38,-1,,0.18617664851784635,0.1134020618556701,,,1460,283
66,66,4,1,10,1,1,0,1002,245,458,38,-1,,0.18617664851784635,0.1134020618556701,,,1460,283
67,67,5,1,10,1,1,1,1002,256,44,27,74,(11),0.15486993345432548,0.11576460481099657,,,1046,283
68,68,5,1,10,1,1,2,1146,245,52,32,95,EP,0.17725347852389595,0.11211340206185567,number,EP,1198,277
69,69,5,1,10,1,1,3,1214,245,20,32,93,3,0.1851179673321234,0.11211340206185567,number,3,1234,277
70,70,5,1,10,1,1,4,1248,245,64,32,93,401,0.19358741681790684,0.11211340206185567,number,401,1312,277
71,71,5,1,10,1,1,5,1332,245,68,32,87,016,0.20659407138535996,0.11211340206185567,number,016,1400,277
72,72,5,1,10,1,1,6,1413,245,47,32,86,A1,0.21725650332728372,0.11211340206185567,number,A1,1460,277
73,73,2,1,11,0,0,0,577,319,537,26,-1,,0.1278735632183908,0.14261168384879724,,,1114,345
74,74,3,1,11,1,0,0,577,319,537,26,-1,,0.1278735632183908,0.14261168384879724,,,1114,345
75,75,4,1,11,1,1,0,577,319,537,26,-1,,0.1278735632183908,0.14261168384879724,,,1114,345
76,76,5,1,11,1,1,1,577,319,156,26,95,EUROPEAN,0.09906231094978826,0.14261168384879724,,,733,345
77,77,5,1,11,1,1,2,735,320,135,24,95,PATENT,0.12137023593466424,0.14261168384879724,,,870,344
78,78,5,1,11,1,1,3,873,319,241,26,96,APPLICATION,0.1502571082879613,0.14261168384879724,,,1114,345
79,79,2,1,12,0,0,0,862,395,126,26,-1,,0.13989715668481548,0.17525773195876287,,,988,421
80,80,3,1,12,1,0,0,862,395,126,26,-1,,0.13989715668481548,0.17525773195876287,,,988,421
81,81,4,1,12,1,1,0,862,395,126,26,-1,,0.13989715668481548,0.17525773195876287,,,988,421
82,82,5,1,12,1,1,1,862,395,44,26,67,(51),0.1336963097398669,0.17525773195876287,,,906,421
83,83,5,1,12,1,1,2,923,397,25,18,93,Int,0.1414851784633999,0.17439862542955326,,,948,415
84,84,5,1,12,1,1,3,955,397,33,18,65,Cl:,0.14692982456140352,0.17439862542955326,,,988,415
85,85,2,1,13,0,0,0,922,425,485,23,-1,,0.17611917725347853,0.1875,,,1407,448
86,86,3,1,13,1,0,0,922,425,485,23,-1,,0.17611917725347853,0.1875,,,1407,448
87,87,4,1,13,1,1,0,922,425,485,23,-1,,0.17611917725347853,0.1875,,,1407,448
88,88,5,1,13,1,1,1,922,428,57,18,39,BOTL,0.14375378100423472,0.1877147766323024,class_international,B01L,979,446
89,89,5,1,13,1,1,2,989,428,44,18,90,7100,0.1529038112522686,0.1877147766323024,class_international,7/00,1033,446
90,90,5,1,13,1,1,3,1038,425,67,16,59,(2006.09,0.16205384150030247,0.18599656357388317,,,1105,441
91,91,5,1,13,1,1,4,1195,428,59,20,23,€12Q,0.1851935874168179,0.18814432989690721,,,1254,448
92,92,5,1,13,1,1,5,1264,428,71,18,95,116806,0.19653660012099214,0.1877147766323024,,,1335,446
93,93,5,1,13,1,1,6,1340,425,67,16,80,(2018.01),0.20772837265577737,0.18599656357388317,,,1407,441
94,94,2,1,14,0,0,0,224,612,1243,6,-1,,0.1278735632183908,0.26417525773195877,,,1467,618
95,95,3,1,14,1,0,0,224,612,1243,6,-1,,0.1278735632183908,0.26417525773195877,,,1467,618
96,96,4,1,14,1,1,0,224,612,1243,6,-1,,0.1278735632183908,0.26417525773195877,,,1467,618
97,97,5,1,14,1,1,1,224,612,1243,6,95, ,0.1278735632183908,0.26417525773195877,,,1467,618
98,98,2,1,15,0,0,0,225,631,599,119,-1,,0.07932546884452511,0.296606529209622,,,824,750
99,99,3,1,15,1,0,0,225,631,599,119,-1,,0.07932546884452511,0.296606529209622,,,824,750
100,100,4,1,15,1,1,0,225,631,388,27,-1,,0.0633696309739867,0.2768470790378007,,,613,658
101,101,5,1,15,1,1,1,225,631,45,27,96,(84),0.037431941923774956,0.2768470790378007,,,270,658
102,102,5,1,15,1,1,2,286,633,118,23,96,Designated,0.052177858439201454,0.2768470790378007,,,404,656
103,103,5,1,15,1,1,3,413,633,119,23,96,Contracting,0.07146098003629764,0.2768470790378007,,,532,656
104,104,5,1,15,1,1,4,542,633,71,19,96,States:,0.08734119782214156,0.2759879725085911,,,613,652
105,105,4,1,15,1,2,0,285,666,537,18,-1,,0.08371143375680581,0.28994845360824745,,,822,684
106,106,5,1,15,1,2,1,285,666,31,18,94,AL,0.04544767090139141,0.28994845360824745,,,316,684
107,107,5,1,15,1,2,2,323,666,31,18,94,AT,0.05119479733817302,0.28994845360824745,,,354,684
108,108,5,1,15,1,2,3,363,666,30,18,96,BE,0.05716878402903811,0.28994845360824745,,,393,684
109,109,5,1,15,1,2,4,403,666,32,18,96,BG,0.0633696309739867,0.28994845360824745,,,435,684
110,110,5,1,15,1,2,5,445,666,31,18,96,CH,0.06964609800362977,0.28994845360824745,,,476,684
111,111,5,1,15,1,2,6,486,666,32,18,95,CY,0.07592256503327284,0.28994845360824745,,,518,684
112,112,5,1,15,1,2,7,526,666,30,18,93,CZ,0.08182093163944344,0.28994845360824745,,,556,684
113,113,5,1,15,1,2,8,565,666,30,18,93,DE,0.08771929824561403,0.28994845360824745,,,595,684
114,114,5,1,15,1,2,9,605,666,32,18,95,DK,0.09392014519056262,0.28994845360824745,,,637,684
115,115,5,1,15,1,2,10,646,666,29,18,95,EE,0.0998941318814277,0.28994845360824745,,,675,684
116,116,5,1,15,1,2,11,684,666,29,18,93,ES,0.10564125831820932,0.28994845360824745,,,713,684
117,117,5,1,15,1,2,12,723,666,57,18,90,FIFR,0.11365698729582577,0.28994845360824745,,,780,684
118,118,5,1,15,1,2,13,788,666,34,18,95,GB,0.12174833635813673,0.28994845360824745,,,822,684
119,119,4,1,15,1,3,0,285,699,539,18,-1,,0.0838626739261948,0.30412371134020616,,,824,717
120,120,5,1,15,1,3,1,285,699,297,18,83,GRHRHUIEISITLILTLU,0.06556261343012704,0.30412371134020616,,,582,717
121,121,5,1,15,1,3,2,591,699,28,18,85,LV,0.09150030248033877,0.30412371134020616,,,619,717
122,122,5,1,15,1,3,3,627,699,35,18,85,MC,0.09747428917120388,0.30412371134020616,,,662,717
123,123,5,1,15,1,3,4,670,699,35,18,94,MK,0.10397761645493044,0.30412371134020616,,,705,717
124,124,5,1,15,1,3,5,713,699,32,18,91,MT,0.11025408348457351,0.30412371134020616,,,745,717
125,125,5,1,15,1,3,6,753,699,29,18,49,NL,0.11607683000604961,0.30412371134020616,,,782,717
126,126,5,1,15,1,3,7,791,699,33,18,49,NO,0.1221264367816092,0.30412371134020616,,,824,717
127,127,4,1,15,1,4,0,286,732,336,18,-1,,0.06866303690260134,0.31829896907216493,,,622,750
128,128,5,1,15,1,4,1,286,732,28,18,93,PL,0.045372050816696916,0.31829896907216493,,,314,750
129,129,5,1,15,1,4,2,323,732,29,18,92,PT,0.05104355716878403,0.31829896907216493,,,352,750
130,130,5,1,15,1,4,3,360,732,58,18,92,RORS,0.058832425892317,0.31829896907216493,,,418,750
131,131,5,1,15,1,4,4,420,732,52,18,92,SE,0.06745311554748941,0.31829896907216493,,,472,750
132,132,5,1,15,1,4,5,480,732,20,18,95,SI,0.07410768300060495,0.31829896907216493,,,500,750
133,133,5,1,15,1,4,6,510,732,31,18,93,SK,0.0794767090139141,0.31829896907216493,,,541,750
134,134,5,1,15,1,4,7,550,732,72,18,90,SMTR,0.08862673926194797,0.31829896907216493,,,622,750
135,135,2,1,16,0,0,0,225,795,513,27,-1,,0.07282214156079855,0.3472938144329897,,,738,822
136,136,3,1,16,1,0,0,225,795,513,27,-1,,0.07282214156079855,0.3472938144329897,,,738,822
137,137,4,1,16,1,1,0,225,795,513,27,-1,,0.07282214156079855,0.3472938144329897,,,738,822
138,138,5,1,16,1,1,1,225,795,45,27,96,(30),0.037431941923774956,0.3472938144329897,,,270,822
139,139,5,1,16,1,1,2,286,797,77,23,96,Priority:,0.04907743496672716,0.3472938144329897,,,363,820
140,140,5,1,16,1,1,3,384,797,118,19,96,18.02.2014,0.06699939503932244,0.34643470790378006,priority_date_eu,18.02.2014,502,816
141,141,5,1,16,1,1,4,520,797,30,19,96,US,0.0809134906231095,0.34643470790378006,,,550,816
142,142,5,1,16,1,1,5,559,797,154,19,91,201461940981,0.09618874773139746,0.34643470790378006,,,713,816
143,143,5,1,16,1,1,6,725,797,13,19,92,P,0.11063218390804598,0.34643470790378006,,,738,816
144,144,2,1,17,0,0,0,225,861,596,86,-1,,0.07909860859044163,0.38831615120274915,,,821,947
145,145,3,1,17,1,0,0,225,861,596,86,-1,,0.07909860859044163,0.38831615120274915,,,821,947
146,146,4,1,17,1,1,0,225,861,596,26,-1,,0.07909860859044163,0.3754295532646048,,,821,887
147,147,5,1,17,1,1,1,225,861,45,26,96,(62),0.037431941923774956,0.3754295532646048,,,270,887
148,148,5,1,17,1,1,2,286,863,107,18,96,Document,0.05134603750756201,0.3745704467353952,,,393,881
149,149,5,1,17,1,1,3,402,863,105,23,96,number(s),0.06873865698729582,0.3756443298969072,,,507,886
150,150,5,1,17,1,1,4,516,863,20,18,96,of,0.07955232909860858,0.3745704467353952,,,536,881
151,151,5,1,17,1,1,5,542,863,32,18,96,the,0.08439201451905626,0.3745704467353952,,,574,881
152,152,5,1,17,1,1,6,583,863,65,18,96,earlier,0.09308832425892317,0.3745704467353952,,,648,881
153,153,5,1,17,1,1,7,655,863,140,23,94,application(s),0.10964912280701754,0.3756443298969072,,,795,886
154,154,5,1,17,1,1,8,805,863,16,18,96,in,0.12295825771324864,0.3745704467353952,,,821,881
155,155,4,1,17,1,2,0,286,895,308,19,-1,,0.06654567453115548,0.38853092783505155,,,594,914
156,156,5,1,17,1,2,1,286,895,109,19,96,accordance,0.051497277676950996,0.38853092783505155,,,395,914
157,157,5,1,17,1,2,2,395,895,60,19,96,with,0.06427707199032062,0.38853092783505155,,,455,914
158,158,5,1,17,1,2,3,464,895,35,19,96,Art.,0.07282214156079855,0.38853092783505155,,,499,914
159,159,5,1,17,1,2,4,508,895,25,19,96,76,0.07872050816696914,0.38853092783505155,,,533,914
160,160,5,1,17,1,2,5,542,895,52,19,96,EPC:,0.08590441621294616,0.38853092783505155,,,594,914
161,161,4,1,17,1,3,0,286,929,250,18,-1,,0.06215970961887477,0.4029209621993127,,,536,947
162,162,5,1,17,1,3,1,286,929,124,18,92,15704906.5,0.05263157894736842,0.4029209621993127,,,410,947
163,163,5,1,17,1,3,2,417,929,7,18,92,/,0.06359649122807018,0.4029209621993127,,,424,947
164,164,5,1,17,1,3,3,432,929,11,18,95,3,0.066167574107683,0.4029209621993127,,,443,947
165,165,5,1,17,1,3,4,452,929,37,18,95,107,0.07115849969751967,0.4029209621993127,,,489,947
166,166,5,1,17,1,3,5,498,929,38,18,96,658,0.07819116757410768,0.4029209621993127,,,536,947
167,167,2,1,18,0,0,0,225,992,516,58,-1,,0.07304900181488204,0.438573883161512,,,741,1050
168,168,3,1,18,1,0,0,225,992,516,58,-1,,0.07304900181488204,0.438573883161512,,,741,1050
169,169,4,1,18,1,1,0,225,992,516,26,-1,,0.07304900181488204,0.43170103092783507,,,741,1018
170,170,5,1,18,1,1,1,225,992,45,26,96,(71),0.037431941923774956,0.43170103092783507,,,270,1018
171,171,5,1,18,1,1,2,285,994,103,23,96,Applicant:,0.05089231699939504,0.4319158075601375,,,388,1017
172,172,5,1,18,1,1,3,397,994,40,18,96,Life,0.06306715063520871,0.43084192439862545,applicant_line_1,Life,437,1012
173,173,5,1,18,1,1,4,445,994,153,23,96,Technologies,0.07887174833635814,0.4319158075601375,applicant_line_1,Technologies,598,1017
174,174,5,1,18,1,1,5,607,994,134,23,96,Corporation,0.10193587416817906,0.4319158075601375,applicant_line_1,Corporation,741,1017
175,175,4,1,18,1,2,0,286,1027,276,23,-1,,0.06412583182093164,0.44609106529209624,,,562,1050
176,176,5,1,18,1,2,1,286,1027,106,22,96,"Carlsbad,",0.05127041742286751,0.44587628865979384,,,392,1049
177,177,5,1,18,1,2,2,401,1027,33,18,96,CA,0.06314277071990321,0.44501718213058417,,,434,1045
178,178,5,1,18,1,2,3,441,1027,65,18,94,92008,0.07161222020568662,0.44501718213058417,,,506,1045
179,179,5,1,18,1,2,4,515,1027,47,23,96,(US),0.08144283121597096,0.44609106529209624,,,562,1050
180,180,2,1,19,0,0,0,225,1090,337,222,-1,,0.059513006654567456,0.5158934707903781,,,562,1312
181,181,3,1,19,1,0,0,225,1090,337,222,-1,,0.059513006654567456,0.5158934707903781,,,562,1312
182,182,4,1,19,1,1,0,225,1090,163,26,-1,,0.046355111917725345,0.4737972508591065,,,388,1116
183,183,5,1,19,1,1,1,225,1090,45,26,96,(72),0.037431941923774956,0.4737972508591065,,,270,1116
184,184,5,1,19,1,1,2,287,1092,101,18,96,Inventors:,0.05104355716878403,0.4729381443298969,,,388,1110
185,185,4,1,19,1,2,0,262,1125,209,23,-1,,0.05542952208106473,0.4881872852233677,,,471,1148
186,186,5,1,19,1,2,1,262,1131,7,7,22,¢,0.04015426497277677,0.48732817869415807,,,269,1138
187,187,5,1,19,1,2,2,286,1125,46,22,96,"Lim,",0.04673321234119782,0.4879725085910653,inventor_line_1,"Lim,",332,1147
188,188,5,1,19,1,2,3,341,1125,57,19,93,Chee,0.0558832425892317,0.48732817869415807,inventor_line_1,Chee,398,1144
189,189,5,1,19,1,2,4,407,1125,64,23,92,Kiong,0.06639443436176648,0.4881872852233677,inventor_line_1,Kiong,471,1148
190,190,4,1,19,1,3,0,286,1158,276,23,-1,,0.06412583182093164,0.5023625429553265,,,562,1181
191,191,5,1,19,1,3,1,286,1158,106,22,96,"Carlsbad,",0.05127041742286751,0.502147766323024,,,392,1180
192,192,5,1,19,1,3,2,401,1158,33,18,95,CA,0.06314277071990321,0.5012886597938144,,,434,1176
193,193,5,1,19,1,3,3,441,1158,65,18,96,92008,0.07161222020568662,0.5012886597938144,,,506,1176
194,194,5,1,19,1,3,4,515,1158,47,23,96,(US),0.08144283121597096,0.5023625429553265,,,562,1181
195,195,4,1,19,1,4,0,262,1191,204,23,-1,,0.055051421657592255,0.5165378006872853,,,466,1214
196,196,5,1,19,1,4,1,262,1196,7,8,0,*,0.04015426497277677,0.5154639175257731,,,269,1204
197,197,5,1,19,1,4,2,286,1191,45,22,96,"Lee,",0.04665759225650333,0.5163230240549829,,,331,1213
198,198,5,1,19,1,4,3,339,1191,48,23,91,Way,0.05490018148820327,0.5165378006872853,,,387,1214
199,199,5,1,19,1,4,4,395,1191,71,23,91,Xuang,0.06510889292196008,0.5165378006872853,,,466,1214
200,200,4,1,19,1,5,0,286,1224,276,23,-1,,0.06412583182093164,0.530713058419244,,,562,1247
201,201,5,1,19,1,5,1,286,1224,106,21,96,"Carlsbad,",0.05127041742286751,0.5302835051546392,,,392,1245
202,202,5,1,19,1,5,2,401,1224,33,18,96,CA,0.06314277071990321,0.529639175257732,,,434,1242
203,203,5,1,19,1,5,3,441,1224,65,18,96,92008,0.07161222020568662,0.529639175257732,,,506,1242
204,204,5,1,19,1,5,4,515,1224,47,23,96,(US),0.08144283121597096,0.530713058419244,,,562,1247
205,205,4,1,19,1,6,0,262,1256,181,22,-1,,0.053312159709618875,0.5442439862542955,,,443,1278
206,206,5,1,19,1,6,1,262,1262,7,7,53,*,0.04015426497277677,0.5435996563573883,,,269,1269
207,207,5,1,19,1,6,2,286,1256,47,22,93,"Loh,",0.046808832425892316,0.5442439862542955,,,333,1278
208,208,5,1,19,1,6,3,341,1256,50,19,92,Wuh,0.05535390199637023,0.5435996563573883,,,391,1275
209,209,5,1,19,1,6,4,402,1256,41,19,96,Ken,0.06389897156684815,0.5435996563573883,,,443,1275
210,210,4,1,19,1,7,0,286,1289,276,23,-1,,0.06412583182093164,0.5586340206185567,,,562,1312
211,211,5,1,19,1,7,1,286,1289,106,22,96,"Carlsbad,",0.05127041742286751,0.5584192439862543,,,392,1311
212,212,5,1,19,1,7,2,401,1289,33,18,96,CA,0.06314277071990321,0.5575601374570447,,,434,1307
213,213,5,1,19,1,7,3,441,1289,65,18,96,92008,0.07161222020568662,0.5575601374570447,,,506,1307
214,214,5,1,19,1,7,4,515,1289,47,23,96,(US),0.08144283121597096,0.5586340206185567,,,562,1312
215,215,2,1,20,0,0,0,844,614,4,763,-1,,0.1279491833030853,0.4276202749140893,,,848,1377
216,216,3,1,20,1,0,0,844,614,4,763,-1,,0.1279491833030853,0.4276202749140893,,,848,1377
217,217,4,1,20,1,1,0,844,614,4,763,-1,,0.1279491833030853,0.4276202749140893,,,848,1377
218,218,5,1,20,1,1,1,844,614,4,763,95, ,0.1279491833030853,0.4276202749140893,,,848,1377
219,219,2,1,21,0,0,0,898,633,300,384,-1,,0.15849969751966123,0.3543814432989691,,,1198,1017
220,220,3,1,21,1,0,0,898,633,300,384,-1,,0.15849969751966123,0.3543814432989691,,,1198,1017
221,221,4,1,21,1,1,0,898,633,217,23,-1,,0.15222323049001815,0.2768470790378007,,,1115,656
222,222,5,1,21,1,1,1,898,639,7,7,62,*,0.13634301270417423,0.2759879725085911,,,905,646
223,223,5,1,21,1,1,2,922,633,72,23,95,"Ching,",0.14488808227465214,0.2768470790378007,,,994,656
224,224,5,1,21,1,1,3,1003,633,56,19,96,Chee,0.1559286146400484,0.2759879725085911,,,1059,652
225,225,5,1,21,1,1,4,1066,633,49,19,96,Wee,0.16492740471869327,0.2759879725085911,,,1115,652
226,226,4,1,21,1,2,0,922,666,276,23,-1,,0.1603145795523291,0.29102233676975947,,,1198,689
227,227,5,1,21,1,2,1,922,666,107,22,96,"Carlsbad,",0.14753478523895946,0.29080756013745707,,,1029,688
228,228,5,1,21,1,2,2,1038,666,33,18,96,CA,0.15948275862068967,0.28994845360824745,,,1071,684
229,229,5,1,21,1,2,3,1078,666,65,18,96,92008,0.16795220810647307,0.28994845360824745,,,1143,684
230,230,5,1,21,1,2,4,1152,666,46,23,96,(US),0.17770719903206292,0.29102233676975947,,,1198,689
231,231,4,1,21,1,3,0,898,699,201,23,-1,,0.15101330913490624,0.30519759450171824,,,1099,722
232,232,5,1,21,1,3,1,898,704,7,8,31,*,0.13634301270417423,0.30412371134020616,,,905,712
233,233,5,1,21,1,3,2,923,699,49,22,95,"Koo,",0.14330006049606775,0.30498281786941583,,,972,721
234,234,5,1,21,1,3,3,982,699,50,18,96,Chin,0.15229885057471265,0.30412371134020616,,,1032,717
235,235,5,1,21,1,3,4,1041,699,58,23,96,Yong,0.161826981246219,0.30519759450171824,,,1099,722
236,236,4,1,21,1,4,0,922,732,276,23,-1,,0.1603145795523291,0.31937285223367695,,,1198,755
237,237,5,1,21,1,4,1,922,732,107,22,96,"Carlsbad,",0.14753478523895946,0.31915807560137455,,,1029,754
238,238,5,1,21,1,4,2,1038,732,33,18,96,CA,0.15948275862068967,0.31829896907216493,,,1071,750
239,239,5,1,21,1,4,3,1078,732,65,18,96,92008,0.16795220810647307,0.31829896907216493,,,1143,750
240,240,5,1,21,1,4,4,1152,732,46,23,96,(US),0.17770719903206292,0.31937285223367695,,,1198,755
241,241,4,1,21,1,5,0,898,765,194,23,-1,,0.15048396854204477,0.3335481099656357,,,1092,788
242,242,5,1,21,1,5,1,898,770,7,8,45,«,0.13634301270417423,0.3324742268041237,,,905,778
243,243,5,1,21,1,5,2,923,765,49,21,96,"Koh,",0.14330006049606775,0.3331185567010309,,,972,786
244,244,5,1,21,1,5,3,982,765,52,18,96,Siew,0.15245009074410162,0.3324742268041237,,,1034,783
245,245,5,1,21,1,5,4,1042,765,50,23,96,Ying,0.16137326073805203,0.3335481099656357,,,1092,788
246,246,4,1,21,1,6,0,922,797,276,23,-1,,0.1603145795523291,0.3472938144329897,,,1198,820
247,247,5,1,21,1,6,1,922,797,107,23,96,"Carlsbad,",0.14753478523895946,0.3472938144329897,,,1029,820
248,248,5,1,21,1,6,2,1038,797,33,19,96,CA,0.15948275862068967,0.34643470790378006,,,1071,816
249,249,5,1,21,1,6,3,1078,797,65,19,96,92008,0.16795220810647307,0.34643470790378006,,,1143,816
250,250,5,1,21,1,6,4,1152,797,46,23,95,(US),0.17770719903206292,0.3472938144329897,,,1198,820
251,251,4,1,21,1,7,0,898,830,195,23,-1,,0.15055958862673927,0.36146907216494845,,,1093,853
252,252,5,1,21,1,7,1,898,835,7,8,42,¢,0.13634301270417423,0.3603951890034364,,,905,843
253,253,5,1,21,1,7,2,922,830,48,22,96,"Toh,",0.14307320024198428,0.36125429553264604,,,970,852
254,254,5,1,21,1,7,3,978,830,63,23,96,Tiong,0.15267695099818512,0.36146907216494845,,,1041,853
255,255,5,1,21,1,7,4,1051,830,42,18,96,Han,0.16212946158499697,0.3603951890034364,,,1093,848
256,256,4,1,21,1,8,0,922,863,276,23,-1,,0.1603145795523291,0.3756443298969072,,,1198,886
257,257,5,1,21,1,8,1,922,863,107,22,96,"Carlsbad,",0.14753478523895946,0.3754295532646048,,,1029,885
258,258,5,1,21,1,8,2,1038,863,33,18,96,CA,0.15948275862068967,0.3745704467353952,,,1071,881
259,259,5,1,21,1,8,3,1078,863,65,18,96,92008,0.16795220810647307,0.3745704467353952,,,1143,881
260,260,5,1,21,1,8,4,1152,863,46,23,96,(US),0.17770719903206292,0.3756443298969072,,,1198,886
261,261,4,1,21,1,9,0,898,895,211,22,-1,,0.15176950998185118,0.38917525773195877,,,1109,917
262,262,5,1,21,1,9,1,898,901,7,7,50,*,0.13634301270417423,0.38853092783505155,,,905,908
263,263,5,1,21,1,9,2,923,895,49,22,96,"Boo,",0.14330006049606775,0.38917525773195877,,,972,917
264,264,5,1,21,1,9,3,982,895,57,19,96,Kuan,0.1528281911675741,0.38853092783505155,,,1039,914
265,265,5,1,21,1,9,4,1049,895,60,19,96,Moon,0.1631881427707199,0.38853092783505155,,,1109,914
266,266,4,1,21,1,10,0,922,929,276,23,-1,,0.1603145795523291,0.40399484536082475,,,1198,952
267,267,5,1,21,1,10,1,922,929,107,21,96,"Carlsbad,",0.14753478523895946,0.40356529209621994,,,1029,950
268,268,5,1,21,1,10,2,1038,929,33,18,95,CA,0.15948275862068967,0.4029209621993127,,,1071,947
269,269,5,1,21,1,10,3,1078,929,65,18,96,92008,0.16795220810647307,0.4029209621993127,,,1143,947
270,270,5,1,21,1,10,4,1152,929,46,23,96,(US),0.17770719903206292,0.40399484536082475,,,1198,952
271,271,4,1,21,1,11,0,898,961,189,23,-1,,0.1501058681185723,0.4177405498281787,,,1087,984
272,272,5,1,21,1,11,1,898,967,7,7,69,*,0.13634301270417423,0.4168814432989691,,,905,974
273,273,5,1,21,1,11,2,923,961,46,22,95,"Lau,",0.14307320024198428,0.4175257731958763,,,969,983
274,274,5,1,21,1,11,3,978,961,43,19,96,Soo,0.1511645493042952,0.4168814432989691,,,1021,980
275,275,5,1,21,1,11,4,1029,961,58,23,96,Yong,0.1600120992135511,0.4177405498281787,,,1087,984
276,276,4,1,21,1,12,0,922,994,276,23,-1,,0.1603145795523291,0.4319158075601375,,,1198,1017
277,277,5,1,21,1,12,1,922,994,107,22,96,"Carlsbad,",0.14753478523895946,0.43170103092783507,,,1029,1016
278,278,5,1,21,1,12,2,1038,994,33,18,95,CA,0.15948275862068967,0.43084192439862545,,,1071,1012
279,279,5,1,21,1,12,3,1078,994,65,18,96,92008,0.16795220810647307,0.43084192439862545,,,1143,1012
280,280,5,1,21,1,12,4,1152,994,46,23,96,(US),0.17770719903206292,0.4319158075601375,,,1198,1017
281,281,2,1,22,0,0,0,862,1057,521,124,-1,,0.16976709013914096,0.4806701030927835,,,1383,1181
282,282,3,1,22,1,0,0,862,1057,521,124,-1,,0.16976709013914096,0.4806701030927835,,,1383,1181
283,283,4,1,22,1,1,0,862,1057,521,27,-1,,0.16976709013914096,0.45983676975945015,,,1383,1084
284,284,5,1,22,1,1,1,862,1057,44,27,96,(74),0.1336963097398669,0.45983676975945015,,,906,1084
285,285,5,1,22,1,1,2,923,1059,163,23,96,Representative:,0.15192075015124018,0.45983676975945015,,,1086,1082
286,286,5,1,22,1,1,3,1096,1059,87,23,96,"Ludwig,",0.1723381730187538,0.45983676975945015,representative_line_1_eu,"Ludwig,",1183,1082
287,287,5,1,22,1,1,4,1193,1059,101,19,96,Christine,0.1880671506352087,0.45897766323024053,representative_line_1_eu,Christine,1294,1078
288,288,5,1,22,1,1,5,1302,1059,81,19,96,Andrea,0.20303992740471868,0.45897766323024053,representative_line_1_eu,Andrea,1383,1078
289,289,4,1,22,1,2,0,923,1092,278,23,-1,,0.16061705989110708,0.4740120274914089,,,1201,1115
290,290,5,1,22,1,2,1,923,1092,39,18,96,Life,0.1425438596491228,0.4729381443298969,,,962,1110
291,291,5,1,22,1,2,2,971,1092,152,23,96,Technologies,0.15834845735027223,0.4740120274914089,,,1123,1115
292,292,5,1,22,1,2,3,1131,1092,70,18,96,GmbH,0.176346037507562,0.4729381443298969,,,1201,1110
293,293,4,1,22,1,3,0,923,1125,281,19,-1,,0.16084392014519056,0.48732817869415807,,,1204,1144
294,294,5,1,22,1,3,1,923,1125,126,19,96,Frankfurter,0.14912280701754385,0.48732817869415807,,,1049,1144
295,295,5,1,22,1,3,2,1056,1125,84,19,90,Strasse,0.16606170598911071,0.48732817869415807,,,1140,1144
296,296,5,1,22,1,3,3,1149,1125,55,19,90,129B,0.1779340592861464,0.48732817869415807,,,1204,1144
297,297,4,1,22,1,4,0,922,1158,244,23,-1,,0.15789473684210525,0.5023625429553265,,,1166,1181
298,298,5,1,22,1,4,1,922,1158,64,18,96,64293,0.1442831215970962,0.5012886597938144,,,986,1176
299,299,5,1,22,1,4,2,996,1158,116,18,96,Darmstadt,0.15940713853599517,0.5012886597938144,,,1112,1176
300,300,5,1,22,1,4,3,1120,1158,46,23,95,(DE),0.17286751361161526,0.5023625429553265,,,1166,1181
301,301,2,1,23,0,0,0,862,1224,99,18,-1,,0.13785541439806412,0.529639175257732,,,961,1242
302,302,3,1,23,1,0,0,862,1224,99,18,-1,,0.13785541439806412,0.529639175257732,,,961,1242
303,303,4,1,23,1,1,0,862,1224,99,18,-1,,0.13785541439806412,0.529639175257732,,,961,1242
304,304,5,1,23,1,1,1,862,1224,99,18,96,Remarks:,0.13785541439806412,0.529639175257732,,,961,1242
305,305,2,1,24,0,0,0,922,1256,522,85,-1,,0.17891712038717483,0.5577749140893471,,,1444,1341
306,306,3,1,24,1,0,0,922,1256,522,85,-1,,0.17891712038717483,0.5577749140893471,,,1444,1341
307,307,4,1,24,1,1,0,922,1256,474,23,-1,,0.1752873563218391,0.5444587628865979,,,1396,1279
308,308,5,1,24,1,1,1,922,1256,43,19,96,This,0.1426950998185118,0.5435996563573883,,,965,1275
309,309,5,1,24,1,1,2,974,1256,111,23,96,application,0.15570175438596492,0.5444587628865979,,,1085,1279
310,310,5,1,24,1,1,3,1093,1261,42,14,96,was,0.16848154869933454,0.5446735395189003,,,1135,1275
311,311,5,1,24,1,1,4,1142,1256,43,19,96,filed,0.17596793708408953,0.5435996563573883,,,1185,1275
312,312,5,1,24,1,1,5,1193,1261,25,14,96,on,0.1823200241984271,0.5446735395189003,,,1218,1275
313,313,5,1,24,1,1,6,1226,1256,119,19,96,27.06.2018,0.19441923774954628,0.5435996563573883,,,1345,1275
314,314,5,1,24,1,1,7,1353,1261,24,14,96,as,0.20644283121597096,0.5446735395189003,,,1377,1275
315,315,5,1,24,1,1,8,1385,1261,11,14,96,a,0.2102994555353902,0.5446735395189003,,,1396,1275
316,316,4,1,24,1,2,0,922,1289,522,23,-1,,0.17891712038717483,0.5586340206185567,,,1444,1312
317,317,5,1,24,1,2,1,922,1289,96,18,96,divisional,0.14670296430732002,0.5575601374570447,,,1018,1307
318,318,5,1,24,1,2,2,1026,1289,112,23,96,application,0.16364186327888688,0.5586340206185567,,,1138,1312
319,319,5,1,24,1,2,3,1147,1290,19,17,96,to,0.17490925589836662,0.5577749140893471,,,1166,1307
320,320,5,1,24,1,2,4,1174,1289,31,18,96,the,0.17990018148820328,0.5575601374570447,,,1205,1307
321,321,5,1,24,1,2,5,1214,1289,112,23,96,application,0.19207501512401695,0.5586340206185567,,,1326,1312
322,322,5,1,24,1,2,6,1336,1289,108,18,96,mentioned,0.2102238354506957,0.5575601374570447,,,1444,1307
323,323,4,1,24,1,3,0,923,1322,209,19,-1,,0.15539927404718692,0.5719501718213058,,,1132,1341
324,324,5,1,24,1,3,1,923,1322,59,19,93,under,0.1440562613430127,0.5719501718213058,,,982,1341
325,325,5,1,24,1,3,2,991,1322,45,19,92,INID,0.15328191167574107,0.5719501718213058,,,1036,1341
326,326,5,1,24,1,3,3,1044,1322,50,19,96,code,0.16167574107683,0.5719501718213058,,,1094,1341
327,327,5,1,24,1,3,4,1103,1322,29,19,96,62.,0.16901088929219601,0.5719501718213058,,,1132,1341
328,328,2,1,25,0,0,0,224,1373,1243,6,-1,,0.1278735632183908,0.5910652920962199,,,1467,1379
329,329,3,1,25,1,0,0,224,1373,1243,6,-1,,0.1278735632183908,0.5910652920962199,,,1467,1379
330,330,4,1,25,1,1,0,224,1373,1243,6,-1,,0.1278735632183908,0.5910652920962199,,,1467,1379
331,331,5,1,25,1,1,1,224,1373,1243,6,95, ,0.1278735632183908,0.5910652920962199,,,1467,1379
332,332,2,1,26,0,0,0,225,1394,1145,133,-1,,0.1206140350877193,0.6273625429553265,,,1370,1527
333,333,3,1,26,1,0,0,225,1394,1145,133,-1,,0.1206140350877193,0.6273625429553265,,,1370,1527
334,334,4,1,26,1,1,0,225,1394,1145,27,-1,,0.1206140350877193,0.6045962199312714,,,1370,1421
335,335,5,1,26,1,1,1,225,1394,45,27,90,(54),0.037431941923774956,0.6045962199312714,,,270,1421
336,336,5,1,26,1,1,2,315,1394,206,25,90,"APPARATUSES,",0.06321839080459771,0.6041666666666666,title_line_1,"APPARATUSES,",521,1419
337,337,5,1,26,1,1,3,531,1394,125,21,96,SYSTEMS,0.0897610405323654,0.603307560137457,title_line_1,SYSTEMS,656,1415
338,338,5,1,26,1,1,4,664,1395,56,20,96,AND,0.10465819721718088,0.6035223367697594,title_line_1,AND,720,1415
339,339,5,1,26,1,1,5,731,1394,112,21,95,METHODS,0.11902601330913491,0.603307560137457,title_line_1,METHODS,843,1415
340,340,5,1,26,1,1,6,845,1394,80,21,96,FOR,0.1338475499092559,0.603307560137457,title_line_1,FOR,925,1415
341,341,5,1,26,1,1,7,934,1394,146,21,96,PROVIDING,0.15229885057471265,0.603307560137457,title_line_1,PROVIDING,1080,1415
342,342,5,1,26,1,1,8,1091,1394,142,21,96,SCALABLE,0.17574107683000606,0.603307560137457,title_line_1,SCALABLE,1233,1415
343,343,5,1,26,1,1,9,1242,1395,128,20,96,THERMAL,0.19751966122202058,0.6035223367697594,title_line_1,THERMAL,1370,1415
344,344,4,1,26,1,2,0,316,1427,721,21,-1,,0.10231397459165155,0.6174828178694158,,,1037,1448
345,345,5,1,26,1,2,1,316,1427,107,21,96,CYCLERS,0.0558832425892317,0.6174828178694158,,,423,1448
346,346,5,1,26,1,2,2,425,1427,80,21,96,AND,0.07032667876588022,0.6174828178694158,,,505,1448
347,347,5,1,26,1,2,3,515,1427,141,21,93,ISOLATING,0.08855111917725347,0.6174828178694158,,,656,1448
348,348,5,1,26,1,2,4,666,1427,246,21,91,THERMOELECTRIC,0.11932849364791288,0.6174828178694158,,,912,1448
349,349,5,1,26,1,2,5,923,1427,114,21,96,DEVICES,0.1482153660012099,0.6174828178694158,,,1037,1448
350,350,4,1,26,1,3,0,225,1501,582,26,-1,,0.0780399274047187,0.6503436426116839,,,807,1527
351,351,5,1,26,1,3,1,225,1501,45,26,0,(57),0.037431941923774956,0.6503436426116839,,,270,1527
352,352,5,1,26,1,3,2,316,1503,62,18,66,Inone,0.05248033877797943,0.6494845360824743,,,378,1521
353,353,5,1,26,1,3,3,384,1504,74,22,96,"aspect,",0.06367211131276466,0.6507731958762887,,,458,1526
354,354,5,1,26,1,3,4,465,1508,12,13,95,a,0.07123411978221415,0.6505584192439863,,,477,1521
355,355,5,1,26,1,3,5,483,1503,78,18,95,thermal,0.07894736842105263,0.6494845360824743,,,561,1521
356,356,5,1,26,1,3,6,568,1503,61,23,96,cycler,0.09051724137931035,0.6505584192439863,,,629,1526
357,357,5,1,26,1,3,7,634,1504,73,22,96,system,0.1014065335753176,0.6507731958762887,,,707,1526
358,358,5,1,26,1,3,8,716,1503,91,23,96,including,0.11516938898971567,0.6505584192439863,,,807,1526
359,359,2,1,27,0,0,0,224,1536,583,253,-1,,0.0779643073200242,0.7141323024054983,,,807,1789
360,360,3,1,27,1,0,0,224,1536,583,253,-1,,0.0779643073200242,0.7141323024054983,,,807,1789
361,361,4,1,27,1,1,0,225,1536,581,23,-1,,0.0779643073200242,0.664733676975945,,,806,1559
362,362,5,1,27,1,1,1,225,1540,11,14,78,a,0.034860859044162126,0.6645189003436426,,,236,1554
363,363,5,1,27,1,1,2,243,1536,76,23,78,sample,0.04249848759830611,0.664733676975945,,,319,1559
364,364,5,1,27,1,1,3,327,1536,54,18,96,block,0.05353901996370236,0.663659793814433,,,381,1554
365,365,5,1,27,1,1,4,387,1536,37,18,96,and,0.06132788868723533,0.663659793814433,,,424,1554
366,366,5,1,27,1,1,5,432,1540,12,14,96,a,0.0662431941923775,0.6645189003436426,,,444,1554
367,367,5,1,27,1,1,6,450,1536,149,18,96,thermoelectric,0.07932546884452511,0.663659793814433,,,599,1554
368,368,5,1,27,1,1,7,605,1536,68,18,96,device,0.09664246823956443,0.663659793814433,,,673,1554
369,369,5,1,27,1,1,8,681,1536,15,18,96,is,0.10412885662431942,0.663659793814433,,,696,1554
370,370,5,1,27,1,1,9,702,1536,104,18,96,disclosed.,0.11403508771929824,0.663659793814433,,,806,1554
371,371,4,1,27,1,2,0,226,1569,581,23,-1,,0.07811554748941318,0.6789089347079038,,,807,1592
372,372,5,1,27,1,2,1,226,1569,16,18,60,In,0.03539019963702359,0.6778350515463918,,,242,1587
373,373,5,1,27,1,2,2,249,1569,75,18,96,various,0.04333030852994555,0.6778350515463918,,,324,1587
374,374,5,1,27,1,2,3,330,1569,148,22,96,"embodiments,",0.06110102843315184,0.6786941580756014,,,478,1591
375,375,5,1,27,1,2,4,485,1569,31,18,96,the,0.07569570477918935,0.6778350515463918,,,516,1587
376,376,5,1,27,1,2,5,522,1569,76,23,96,sample,0.08469449485783424,0.6789089347079038,,,598,1592
377,377,5,1,27,1,2,6,605,1569,42,18,96,block,0.09467634603750756,0.6778350515463918,,,647,1587
378,378,5,1,27,1,2,7,649,1569,40,18,96,has,0.10117967332123412,0.6778350515463918,,,689,1587
379,379,5,1,27,1,2,8,690,1574,11,13,95,a,0.10518753781004235,0.6789089347079038,,,701,1587
380,380,5,1,27,1,2,9,707,1569,56,18,93,first,0.11116152450090744,0.6778350515463918,,,763,1587
381,381,5,1,27,1,2,10,767,1574,40,13,93,sur-,0.11902601330913491,0.6789089347079038,,,807,1587
382,382,4,1,27,1,3,0,224,1602,583,23,-1,,0.0779643073200242,0.6930841924398625,,,807,1625
383,383,5,1,27,1,3,1,224,1602,44,18,96,face,0.03720508166969147,0.6920103092783505,,,268,1620
384,384,5,1,27,1,3,2,277,1602,109,23,96,configured,0.05013611615245009,0.6930841924398625,,,386,1625
385,385,5,1,27,1,3,3,394,1602,18,18,96,to,0.06094978826376286,0.6920103092783505,,,412,1620
386,386,5,1,27,1,3,4,420,1602,75,18,96,receive,0.0691923774954628,0.6920103092783505,,,495,1620
387,387,5,1,27,1,3,5,504,1606,11,14,96,a,0.07705686630369026,0.6928694158075601,,,515,1620
388,388,5,1,27,1,3,6,524,1602,80,23,96,plurality,0.0852994555353902,0.6930841924398625,,,604,1625
389,389,5,1,27,1,3,7,611,1602,20,18,96,of,0.09392014519056262,0.6920103092783505,,,631,1620
390,390,5,1,27,1,3,8,639,1602,81,18,96,reaction,0.1027676950998185,0.6920103092783505,,,720,1620
391,391,5,1,27,1,3,9,729,1602,78,18,96,vessels,0.1161524500907441,0.6920103092783505,,,807,1620
392,392,4,1,27,1,4,0,225,1634,582,23,-1,,0.0780399274047187,0.7068298969072165,,,807,1657
393,393,5,1,27,1,4,1,225,1634,38,19,96,and,0.03690260133091349,0.7059707903780069,,,263,1653
394,394,5,1,27,1,4,2,275,1639,25,14,96,an,0.043481548699334543,0.7070446735395189,,,300,1653
395,395,5,1,27,1,4,3,313,1634,94,23,96,opposing,0.0544464609800363,0.7068298969072165,,,407,1657
396,396,5,1,27,1,4,4,421,1634,74,19,96,second,0.0692679975801573,0.7059707903780069,,,495,1653
397,397,5,1,27,1,4,5,508,1634,82,19,96,surface.,0.08303085299455536,0.7059707903780069,,,590,1653
398,398,5,1,27,1,4,6,605,1634,17,19,95,In,0.09278584392014519,0.7059707903780069,,,622,1653
399,399,5,1,27,1,4,7,635,1634,75,19,93,various,0.10170901391409558,0.7059707903780069,,,710,1653
400,400,5,1,27,1,4,8,722,1634,85,19,90,embodi-,0.11562310949788264,0.7059707903780069,,,807,1653
401,401,4,1,27,1,5,0,226,1667,581,23,-1,,0.07811554748941318,0.7210051546391752,,,807,1690
402,402,5,1,27,1,5,1,226,1668,62,17,96,ments,0.038868723532970356,0.7201460481099656,,,288,1685
403,403,5,1,27,1,5,2,297,1667,32,18,96,the,0.04733817301875378,0.7199312714776632,,,329,1685
404,404,5,1,27,1,5,3,338,1667,150,18,96,thermoelectric,0.06246218995765275,0.7199312714776632,,,488,1685
405,405,5,1,27,1,5,4,496,1667,68,18,96,device,0.08015728977616456,0.7199312714776632,,,564,1685
406,406,5,1,27,1,5,5,574,1667,14,18,96,is,0.08787053841500303,0.7199312714776632,,,588,1685
407,407,5,1,27,1,5,6,598,1667,91,23,96,operably,0.09732304900181488,0.7210051546391752,,,689,1690
408,408,5,1,27,1,5,7,698,1667,81,23,96,coupled,0.11169086509376891,0.7210051546391752,,,779,1690
409,409,5,1,27,1,5,8,788,1668,19,17,96,to,0.1206140350877193,0.7201460481099656,,,807,1685
410,410,4,1,27,1,6,0,225,1700,582,23,-1,,0.0780399274047187,0.7351804123711341,,,807,1723
411,411,5,1,27,1,6,1,225,1700,31,18,96,the,0.03637326073805203,0.7341065292096219,,,256,1718
412,412,5,1,27,1,6,2,265,1700,75,18,96,second,0.04575015124016939,0.7341065292096219,,,340,1718
413,413,5,1,27,1,6,3,349,1700,77,18,96,surface,0.05860556563823351,0.7341065292096219,,,426,1718
414,414,5,1,27,1,6,4,434,1700,21,18,96,of,0.06722625529340592,0.7341065292096219,,,455,1718
415,415,5,1,27,1,6,5,462,1700,31,18,96,the,0.0722171808832426,0.7341065292096219,,,493,1718
416,416,5,1,27,1,6,6,502,1700,76,23,96,sample,0.08166969147005444,0.7351804123711341,,,578,1723
417,417,5,1,27,1,6,7,587,1700,60,18,96,block.,0.09331518451300666,0.7341065292096219,,,647,1718
418,418,5,1,27,1,6,8,657,1700,17,18,91,In,0.10065033272837265,0.7341065292096219,,,674,1718
419,419,5,1,27,1,6,9,683,1700,76,18,92,various,0.10904416212946158,0.7341065292096219,,,759,1718
420,420,5,1,27,1,6,10,768,1704,39,14,91,em-,0.1191016333938294,0.7349656357388317,,,807,1718
421,421,4,1,27,1,7,0,226,1732,581,23,-1,,0.07811554748941318,0.748926116838488,,,807,1755
422,422,5,1,27,1,7,1,226,1732,107,19,90,bodiments,0.04227162734422263,0.7480670103092784,,,333,1751
423,423,5,1,27,1,7,2,342,1737,11,14,96,a,0.052555958862673925,0.7491408934707904,,,353,1751
424,424,5,1,27,1,7,3,362,1732,73,19,96,thermal,0.0602692075015124,0.7480670103092784,,,435,1751
425,425,5,1,27,1,7,4,438,1732,82,19,96,control,0.07244404113732607,0.7480670103092784,,,520,1751
426,426,5,1,27,1,7,5,529,1732,37,19,96,unit,0.08280399274047187,0.7480670103092784,,,566,1751
427,427,5,1,27,1,7,6,575,1732,15,19,96,is,0.08809739866908652,0.7480670103092784,,,590,1751
428,428,5,1,27,1,7,7,600,1732,94,23,96,provided.,0.09785238959467635,0.748926116838488,,,694,1755
429,429,5,1,27,1,7,8,706,1732,16,19,96,In,0.10798548094373865,0.7480670103092784,,,722,1751
430,430,5,1,27,1,7,9,732,1732,75,19,96,various,0.11637931034482758,0.7480670103092784,,,807,1751
431,431,4,1,27,1,8,0,225,1766,582,23,-1,,0.0780399274047187,0.7635309278350515,,,807,1789
432,432,5,1,27,1,8,1,225,1766,142,18,96,embodiments,0.04476709013914096,0.7624570446735395,,,367,1784
433,433,5,1,27,1,8,2,373,1766,32,18,96,the,0.058832425892317,0.7624570446735395,,,405,1784
434,434,5,1,27,1,8,3,411,1766,79,18,96,thermal,0.06813369630973987,0.7624570446735395,,,490,1784
435,435,5,1,27,1,8,4,498,1766,64,18,96,control,0.08015728977616456,0.7624570446735395,,,562,1784
436,436,5,1,27,1,8,5,565,1766,46,18,96,unit,0.08892921960072596,0.7624570446735395,,,611,1784
437,437,5,1,27,1,8,6,619,1766,84,18,96,includes,0.0999697519661222,0.7624570446735395,,,703,1784
438,438,5,1,27,1,8,7,710,1770,11,14,93,a,0.10821234119782214,0.7633161512027491,,,721,1784
439,439,5,1,27,1,8,8,730,1770,77,19,93,compu-,0.1162280701754386,0.7643900343642611,,,807,1789
440,440,2,1,28,0,0,0,884,1503,582,252,-1,,0.17770719903206292,0.6997422680412371,,,1466,1755
441,441,3,1,28,1,0,0,884,1503,582,252,-1,,0.17770719903206292,0.6997422680412371,,,1466,1755
442,442,4,1,28,1,1,0,884,1503,582,23,-1,,0.17770719903206292,0.6505584192439863,,,1466,1526
443,443,5,1,28,1,1,1,884,1504,27,17,96,ter,0.13573805202661826,0.6496993127147767,,,911,1521
444,444,5,1,28,1,1,2,919,1503,112,23,97,processing,0.14745916515426497,0.6505584192439863,,,1031,1526
445,445,5,1,28,1,1,3,1040,1503,42,18,96,unit.,0.16046581972171808,0.6494845360824743,,,1082,1521
446,446,5,1,28,1,1,4,1091,1503,17,18,95,In,0.16628856624319419,0.6494845360824743,,,1108,1521
447,447,5,1,28,1,1,5,1116,1503,76,18,95,various,0.17453115547489415,0.6494845360824743,,,1192,1521
448,448,5,1,28,1,1,6,1199,1503,142,18,96,embodiments,0.19207501512401695,0.6494845360824743,,,1341,1521
449,449,5,1,28,1,1,7,1349,1503,32,18,96,the,0.20644283121597096,0.6494845360824743,,,1381,1521
450,450,5,1,28,1,1,8,1388,1503,78,18,96,thermal,0.21581972171808833,0.6494845360824743,,,1466,1521
451,451,4,1,28,1,2,0,885,1536,581,18,-1,,0.17778281911675742,0.663659793814433,,,1466,1554
452,452,5,1,28,1,2,1,885,1536,69,18,96,control,0.13906533575317603,0.663659793814433,,,954,1554
453,453,5,1,28,1,2,2,963,1536,37,18,96,unit,0.1484422262552934,0.663659793814433,,,1000,1554
454,454,5,1,28,1,2,3,1008,1536,85,18,96,includes,0.1588777979431337,0.663659793814433,,,1093,1554
455,455,5,1,28,1,2,4,1101,1540,24,14,96,an,0.16833030852994554,0.6645189003436426,,,1125,1554
456,456,5,1,28,1,2,5,1134,1536,92,18,96,electrical,0.17846339987900786,0.663659793814433,,,1226,1554
457,457,5,1,28,1,2,6,1235,1536,73,18,96,current,0.19230187537810042,0.663659793814433,,,1308,1554
458,458,5,1,28,1,2,7,1316,1540,70,14,96,source.,0.2043254688445251,0.6645189003436426,,,1386,1554
459,459,5,1,28,1,2,8,1388,1536,30,18,93,In,0.21218995765275256,0.663659793814433,,,1418,1554
460,460,5,1,28,1,2,9,1426,1540,40,14,92,var-,0.21869328493647913,0.6645189003436426,,,1466,1554
461,461,4,1,28,1,3,0,885,1569,581,18,-1,,0.17778281911675742,0.6778350515463918,,,1466,1587
462,462,5,1,28,1,3,1,885,1569,41,18,96,ious,0.13694797338173018,0.6778350515463918,,,926,1587
463,463,5,1,28,1,3,2,934,1569,130,18,96,embodiments,0.15108892921960074,0.6778350515463918,,,1064,1587
464,464,5,1,28,1,3,3,1065,1569,50,18,96,the,0.1648517846339988,0.6778350515463918,,,1115,1587
465,465,5,1,28,1,3,4,1122,1569,73,18,96,thermal,0.1752117362371446,0.6778350515463918,,,1195,1587
466,466,5,1,28,1,3,5,1198,1569,75,18,96,control,0.1868572292800968,0.6778350515463918,,,1273,1587
467,467,5,1,28,1,3,6,1276,1569,48,18,95,unit,0.19661222020568664,0.6778350515463918,,,1324,1587
468,468,5,1,28,1,3,7,1330,1569,42,18,95,also,0.2043254688445251,0.6778350515463918,,,1372,1587
469,469,5,1,28,1,3,8,1381,1569,85,18,90,includes,0.21529038112522686,0.6778350515463918,,,1466,1587
470,470,4,1,28,1,4,0,884,1602,582,23,-1,,0.17770719903206292,0.6930841924398625,,,1466,1625
471,471,5,1,28,1,4,1,884,1606,24,14,96,an,0.1355111917725348,0.6928694158075601,,,908,1620
472,472,5,1,28,1,4,2,917,1602,93,18,96,electrical,0.14571990320629158,0.6920103092783505,,,1010,1620
473,473,5,1,28,1,4,3,1020,1602,89,18,96,interface,0.16099516031457956,0.6920103092783505,,,1109,1620
474,474,5,1,28,1,4,4,1119,1602,70,23,96,portion,0.17453115547489415,0.6930841924398625,,,1189,1625
475,475,5,1,28,1,4,5,1198,1602,109,23,96,configured,0.18942831215970962,0.6930841924398625,,,1307,1625
476,476,5,1,28,1,4,6,1316,1602,19,18,96,to,0.20046884452510585,0.6920103092783505,,,1335,1620
477,477,5,1,28,1,4,7,1344,1602,82,18,96,connect,0.20946763460375076,0.6920103092783505,,,1426,1620
478,478,5,1,28,1,4,8,1434,1602,32,18,96,the,0.21929824561403508,0.6920103092783505,,,1466,1620
479,479,4,1,28,1,5,0,884,1634,582,19,-1,,0.17770719903206292,0.7059707903780069,,,1466,1653
480,480,5,1,28,1,5,1,884,1634,149,19,96,thermoelectric,0.14496370235934664,0.7059707903780069,,,1033,1653
481,481,5,1,28,1,5,2,1042,1634,68,19,96,device,0.16273442226255294,0.7059707903780069,,,1110,1653
482,482,5,1,28,1,5,3,1118,1634,41,19,97,with,0.1721869328493648,0.7059707903780069,,,1159,1653
483,483,5,1,28,1,5,4,1170,1634,31,19,96,the,0.1792952208106473,0.7059707903780069,,,1201,1653
484,484,5,1,28,1,5,5,1211,1634,92,19,96,electrical,0.19010889292196007,0.7059707903780069,,,1303,1653
485,485,5,1,28,1,5,6,1314,1635,73,18,96,current,0.2042498487598306,0.7061855670103093,,,1387,1653
486,486,5,1,28,1,5,7,1396,1639,70,14,96,source,0.21642468239564427,0.7070446735395189,,,1466,1653
487,487,4,1,28,1,6,0,885,1667,581,23,-1,,0.17778281911675742,0.7210051546391752,,,1466,1690
488,488,5,1,28,1,6,1,885,1667,23,23,96,by,0.1355868118572293,0.7210051546391752,,,908,1690
489,489,5,1,28,1,6,2,917,1672,42,18,96,way,0.14186327888687236,0.7220790378006873,,,959,1690
490,490,5,1,28,1,6,3,969,1672,12,13,96,of,0.14745916515426497,0.7210051546391752,,,981,1685
491,491,5,1,28,1,6,4,982,1667,28,18,96,an,0.15063520871143377,0.7199312714776632,,,1010,1685
492,492,5,1,28,1,6,5,1013,1667,113,18,95,electrical,0.1617513611615245,0.7199312714776632,,,1126,1685
493,493,5,1,28,1,6,6,1137,1667,61,18,96,cable.,0.1765728977616455,0.7199312714776632,,,1198,1685
494,494,5,1,28,1,6,7,1211,1667,16,18,95,In,0.18436176648517846,0.7199312714776632,,,1227,1685
495,495,5,1,28,1,6,8,1238,1667,76,18,95,various,0.19298245614035087,0.7199312714776632,,,1314,1685
496,496,5,1,28,1,6,9,1324,1667,142,18,96,embodiments,0.21098003629764064,0.7199312714776632,,,1466,1685
497,497,4,1,28,1,7,0,884,1700,582,23,-1,,0.17770719903206292,0.7351804123711341,,,1466,1723
498,498,5,1,28,1,7,1,884,1700,32,18,96,the,0.13611615245009073,0.7341065292096219,,,916,1718
499,499,5,1,28,1,7,2,926,1700,78,18,96,thermal,0.14594676346037508,0.7341065292096219,,,1004,1718
500,500,5,1,28,1,7,3,1015,1700,70,18,96,control,0.1588021778584392,0.7341065292096219,,,1085,1718
501,501,5,1,28,1,7,4,1096,1700,37,18,94,unit,0.16855716878402904,0.7341065292096219,,,1133,1718
502,502,5,1,28,1,7,5,1144,1700,15,18,94,is,0.17415305505142165,0.7341065292096219,,,1159,1718
503,503,5,1,28,1,7,6,1169,1700,84,18,96,oriented,0.18315184513006655,0.7341065292096219,,,1253,1718
504,504,5,1,28,1,7,7,1265,1700,15,18,96,in,0.19245311554748942,0.7341065292096219,,,1280,1718
505,505,5,1,28,1,7,8,1292,1704,11,14,95,a,0.19623411978221417,0.7349656357388317,,,1303,1718
506,506,5,1,28,1,7,9,1314,1700,86,18,95,different,0.20523290986085904,0.7341065292096219,,,1400,1718
507,507,5,1,28,1,7,10,1410,1700,56,23,96,plane,0.21748336358136722,0.7351804123711341,,,1466,1723
508,508,4,1,28,1,8,0,884,1732,511,23,-1,,0.1723381730187538,0.748926116838488,,,1395,1755
509,509,5,1,28,1,8,1,884,1732,44,19,96,than,0.13702359346642468,0.7480670103092784,,,928,1751
510,510,5,1,28,1,8,2,937,1732,32,19,96,the,0.1441318814277072,0.7480670103092784,,,969,1751
511,511,5,1,28,1,8,3,977,1732,75,23,96,sample,0.15343315184513007,0.748926116838488,,,1052,1755
512,512,5,1,28,1,8,4,1061,1732,54,19,96,block,0.1645493042952208,0.7480670103092784,,,1115,1751
513,513,5,1,28,1,8,5,1123,1732,38,19,96,and,0.17271627344222626,0.7480670103092784,,,1161,1751
514,514,5,1,28,1,8,6,1169,1732,150,19,96,thermoelectric,0.1881427707199032,0.7480670103092784,,,1319,1751
515,515,5,1,28,1,8,7,1327,1732,68,19,96,cooler.,0.205837870538415,0.7480670103092784,,,1395,1751
516,516,2,1,29,0,0,0,716,2270,259,16,-1,,0.1278735632183908,0.9785223367697594,,,975,2286
517,517,3,1,29,1,0,0,716,2270,259,16,-1,,0.1278735632183908,0.9785223367697594,,,975,2286
518,518,4,1,29,1,1,0,716,2270,259,16,-1,,0.1278735632183908,0.9785223367697594,,,975,2286
519,519,5,1,29,1,1,1,716,2270,49,12,96,Printed,0.11199334543254688,0.9776632302405498,,,765,2282
520,520,5,1,29,1,1,2,771,2270,15,16,96,by,0.1177404718693285,0.9785223367697594,,,786,2286
521,521,5,1,29,1,1,3,792,2270,45,14,96,"Jouve,",0.12318511796733213,0.9780927835051546,,,837,2284
522,522,5,1,29,1,1,4,843,2270,41,12,96,75001,0.13059588626739263,0.9776632302405498,,,884,2282
523,523,5,1,29,1,1,5,893,2270,46,12,96,PARIS,0.1385359951603146,0.9776632302405498,,,939,2282
524,524,5,1,29,1,1,6,945,2270,30,16,95,(FR),0.14519056261343014,0.9785223367697594,,,975,2286
