,Unnamed: 0,level,page_num,block_num,par_num,line_num,word_num,left,top,width,height,conf,text,x,y,label,target,right,bottom
0,0,1,1,0,0,0,0,0,0,1653,2328,-1,,0.125,0.5,,,1653,2328
1,1,2,1,1,0,0,0,144,1905,31,328,-1,,0.02412280701754386,0.8887457044673539,,,175,2233
2,2,3,1,1,1,0,0,144,1905,31,328,-1,,0.02412280701754386,0.8887457044673539,,,175,2233
3,3,4,1,1,1,1,0,144,1905,31,328,-1,,0.02412280701754386,0.8887457044673539,,,175,2233
4,4,5,1,1,1,1,1,144,2179,30,54,96,EP,0.024047186932849365,0.947594501718213,,,174,2233
5,5,5,1,1,1,1,2,144,2142,31,21,96,3,0.02412280701754386,0.9246134020618557,,,175,2163
6,6,5,1,1,1,1,3,144,2055,31,71,96,399,0.02412280701754386,0.8979810996563574,,,175,2126
7,7,5,1,1,1,1,4,144,1968,31,71,92,806,0.02412280701754386,0.8606099656357389,,,175,2039
8,8,5,1,1,1,1,5,144,1905,30,50,86,A1,0.024047186932849365,0.8290378006872853,,,174,1955
9,9,2,1,2,0,0,0,429,153,88,28,-1,,0.07153660012099214,0.07173539518900343,,,517,181
10,10,3,1,2,1,0,0,429,153,88,28,-1,,0.07153660012099214,0.07173539518900343,,,517,181
11,11,4,1,2,1,1,0,429,153,88,16,-1,,0.07153660012099214,0.06915807560137457,,,517,169
12,12,5,1,2,1,1,1,429,153,88,16,84,Europaisches,0.07153660012099214,0.06915807560137457,,,517,169
13,13,4,1,2,1,2,0,429,170,71,11,-1,,0.07025105868118572,0.07538659793814433,,,500,181
14,14,5,1,2,1,2,1,429,170,71,11,96,Patentamt,0.07025105868118572,0.07538659793814433,,,500,181
15,15,2,1,3,0,0,0,429,196,89,28,-1,,0.07161222020568662,0.09020618556701031,,,518,224
16,16,3,1,3,1,0,0,429,196,89,28,-1,,0.07161222020568662,0.09020618556701031,,,518,224
17,17,4,1,3,1,1,0,429,196,63,15,-1,,0.06964609800362977,0.08741408934707903,,,492,211
18,18,5,1,3,1,1,1,429,196,63,15,95,European,0.06964609800362977,0.08741408934707903,,,492,211
19,19,4,1,3,1,2,0,429,212,89,12,-1,,0.07161222020568662,0.0936426116838488,,,518,224
20,20,5,1,3,1,2,1,429,213,43,11,96,Patent,0.06813369630973987,0.0938573883161512,,,472,224
21,21,5,1,3,1,2,2,478,212,40,12,90,Office,0.07531760435571688,0.0936426116838488,,,518,224
22,22,2,1,4,0,0,0,429,239,109,28,-1,,0.07312462189957653,0.10867697594501718,,,538,267
23,23,3,1,4,1,0,0,429,239,109,28,-1,,0.07312462189957653,0.10867697594501718,,,538,267
24,24,4,1,4,1,1,0,429,239,109,15,-1,,0.07312462189957653,0.10588487972508591,,,538,254
25,25,5,1,4,1,1,1,429,239,40,12,93,Office,0.06790683605565638,0.1052405498281787,,,469,251
26,26,5,1,4,1,1,2,474,239,64,15,93,europ√©en,0.0765275257108288,0.10588487972508591,,,538,254
27,27,4,1,4,1,2,0,429,255,77,12,-1,,0.0707047791893527,0.11211340206185567,,,506,267
28,28,5,1,4,1,2,1,429,255,22,12,95,des,0.06654567453115548,0.11211340206185567,,,451,267
29,29,5,1,4,1,2,2,457,255,49,12,82,brevets,0.07282214156079855,0.11211340206185567,,,506,267
30,30,2,1,5,0,0,0,281,136,274,150,-1,,0.06321839080459771,0.09063573883161512,,,555,286
31,31,3,1,5,1,0,0,281,136,274,150,-1,,0.06321839080459771,0.09063573883161512,,,555,286
32,32,4,1,5,1,1,0,281,136,274,150,-1,,0.06321839080459771,0.09063573883161512,,,555,286
33,33,5,1,5,1,1,1,281,136,274,150,95, ,0.06321839080459771,0.09063573883161512,,,555,286
34,34,2,1,6,0,0,0,225,324,45,26,-1,,0.037431941923774956,0.14475945017182132,,,270,350
35,35,3,1,6,1,0,0,225,324,45,26,-1,,0.037431941923774956,0.14475945017182132,,,270,350
36,36,4,1,6,1,1,0,225,324,45,26,-1,,0.037431941923774956,0.14475945017182132,,,270,350
37,37,5,1,6,1,1,1,225,324,45,26,96,(12),0.037431941923774956,0.14475945017182132,,,270,350
38,38,2,1,7,0,0,0,225,395,378,53,-1,,0.06261343012704174,0.18105670103092783,,,603,448
39,39,3,1,7,1,0,0,225,395,378,53,-1,,0.06261343012704174,0.18105670103092783,,,603,448
40,40,4,1,7,1,1,0,225,395,262,26,-1,,0.05384150030248034,0.17525773195876287,,,487,421
41,41,5,1,7,1,1,1,225,395,45,26,95,(43),0.037431941923774956,0.17525773195876287,,,270,421
42,42,5,1,7,1,1,2,286,397,48,18,95,Date,0.04688445251058681,0.17439862542955326,,,334,415
43,43,5,1,7,1,1,3,342,397,20,18,96,of,0.05323653962492438,0.17439862542955326,,,362,415
44,44,5,1,7,1,1,4,370,397,117,23,96,publication:,0.0648064125831821,0.17547250859106528,,,487,420
45,45,4,1,7,1,2,0,286,430,317,18,-1,,0.06722625529340592,0.18857388316151202,,,603,448
46,46,5,1,7,1,2,1,286,430,117,18,96,07.11.2018,0.052102238354506954,0.18857388316151202,publication_date,07.11.2018,403,448
47,47,5,1,7,1,2,2,426,430,84,18,95,Bulletin,0.07078039927404718,0.18857388316151202,,,510,448
48,48,5,1,7,1,2,3,519,430,84,18,95,2018/45,0.08484573502722323,0.18857388316151202,,,603,448
49,49,2,1,8,0,0,0,225,493,402,26,-1,,0.06442831215970962,0.21735395189003437,,,627,519
50,50,3,1,8,1,0,0,225,493,402,26,-1,,0.06442831215970962,0.21735395189003437,,,627,519
51,51,4,1,8,1,1,0,225,493,402,26,-1,,0.06442831215970962,0.21735395189003437,,,627,519
52,52,5,1,8,1,1,1,225,493,45,26,95,(21),0.037431941923774956,0.21735395189003437,,,270,519
53,53,5,1,8,1,1,2,285,495,115,23,96,Application,0.051799758015728975,0.21756872852233677,,,400,518
54,54,5,1,8,1,1,3,410,495,83,18,93,number:,0.06828493647912885,0.21649484536082475,,,493,513
55,55,5,1,8,1,1,4,505,495,122,18,92,18180438.6,0.08560193587416817,0.21649484536082475,application_number,18180438.6,627,513
56,56,2,1,9,0,0,0,225,559,325,26,-1,,0.05860556563823351,0.24570446735395188,,,550,585
57,57,3,1,9,1,0,0,225,559,325,26,-1,,0.05860556563823351,0.24570446735395188,,,550,585
58,58,4,1,9,1,1,0,225,559,325,26,-1,,0.05860556563823351,0.24570446735395188,,,550,585
59,59,5,1,9,1,1,1,225,559,45,26,96,(22),0.037431941923774956,0.24570446735395188,,,270,585
60,60,5,1,9,1,1,2,286,561,48,18,96,Date,0.04688445251058681,0.24484536082474226,,,334,579
61,61,5,1,9,1,1,3,342,566,12,13,96,of,0.05263157894736842,0.24591924398625428,,,354,579
62,62,5,1,9,1,1,4,355,561,67,23,95,filing:,0.058756805807622506,0.24591924398625428,,,422,584
63,63,5,1,9,1,1,5,433,561,117,18,95,19.07.2016,0.07433454325468844,0.24484536082474226,filing_date,19.07.2016,550,579
64,64,2,1,10,0,0,0,1002,245,458,38,-1,,0.18617664851784635,0.1134020618556701,,,1460,283
65,65,3,1,10,1,0,0,1002,245,458,38,-1,,0.18617664851784635,0.1134020618556701,,,1460,283
66,66,4,1,10,1,1,0,1002,245,458,38,-1,,0.18617664851784635,0.1134020618556701,,,1460,283
67,67,5,1,10,1,1,1,1002,256,44,27,74,(11),0.15486993345432548,0.11576460481099657,,,1046,283
68,68,5,1,10,1,1,2,1146,245,52,32,94,EP,0.17725347852389595,0.11211340206185567,number,EP,1198,277
69,69,5,1,10,1,1,3,1214,245,20,32,95,3,0.1851179673321234,0.11211340206185567,number,3,1234,277
70,70,5,1,10,1,1,4,1249,245,68,32,95,399,0.1940411373260738,0.11211340206185567,number,399,1317,277
71,71,5,1,10,1,1,5,1332,245,68,32,93,806,0.20659407138535996,0.11211340206185567,number,806,1400,277
72,72,5,1,10,1,1,6,1413,245,47,32,90,A1,0.21725650332728372,0.11211340206185567,number,A1,1460,277
73,73,2,1,11,0,0,0,577,319,537,26,-1,,0.1278735632183908,0.14261168384879724,,,1114,345
74,74,3,1,11,1,0,0,577,319,537,26,-1,,0.1278735632183908,0.14261168384879724,,,1114,345
75,75,4,1,11,1,1,0,577,319,537,26,-1,,0.1278735632183908,0.14261168384879724,,,1114,345
76,76,5,1,11,1,1,1,577,319,156,26,95,EUROPEAN,0.09906231094978826,0.14261168384879724,,,733,345
77,77,5,1,11,1,1,2,735,320,135,24,95,PATENT,0.12137023593466424,0.14261168384879724,,,870,344
78,78,5,1,11,1,1,3,873,319,241,26,96,APPLICATION,0.1502571082879613,0.14261168384879724,,,1114,345
79,79,2,1,12,0,0,0,862,395,126,26,-1,,0.13989715668481548,0.17525773195876287,,,988,421
80,80,3,1,12,1,0,0,862,395,126,26,-1,,0.13989715668481548,0.17525773195876287,,,988,421
81,81,4,1,12,1,1,0,862,395,126,26,-1,,0.13989715668481548,0.17525773195876287,,,988,421
82,82,5,1,12,1,1,1,862,395,44,26,67,(51),0.1336963097398669,0.17525773195876287,,,906,421
83,83,5,1,12,1,1,2,923,397,25,18,93,Int,0.1414851784633999,0.17439862542955326,,,948,415
84,84,5,1,12,1,1,3,955,397,33,18,65,Cl:,0.14692982456140352,0.17439862542955326,,,988,415
85,85,2,1,13,0,0,0,922,425,475,21,-1,,0.1753629764065336,0.1870704467353952,,,1397,446
86,86,3,1,13,1,0,0,922,425,475,21,-1,,0.1753629764065336,0.1870704467353952,,,1397,446
87,87,4,1,13,1,1,0,922,425,475,21,-1,,0.1753629764065336,0.1870704467353952,,,1397,446
88,88,5,1,13,1,1,1,922,428,68,18,88,HO4W,0.14458560193587416,0.1877147766323024,class_international,H04W,990,446
89,89,5,1,13,1,1,2,995,428,59,18,92,52/14,0.15494555353901995,0.1877147766323024,class_international,52/14,1054,446
90,90,5,1,13,1,1,3,1059,425,67,16,68,(2009.07),0.16522988505747127,0.18599656357388317,,,1126,441
91,91,5,1,13,1,1,4,1193,428,68,18,85,HO4W,0.18557168784029038,0.1877147766323024,,,1261,446
92,92,5,1,13,1,1,5,1266,428,59,18,83,52/24,0.19593163944343617,0.1877147766323024,,,1325,446
93,93,5,1,13,1,1,6,1330,425,67,16,91,(2009.01),0.20621597096188748,0.18599656357388317,,,1397,441
94,94,2,1,14,0,0,0,224,613,1243,4,-1,,0.1278735632183908,0.26417525773195877,,,1467,617
95,95,3,1,14,1,0,0,224,613,1243,4,-1,,0.1278735632183908,0.26417525773195877,,,1467,617
96,96,4,1,14,1,1,0,224,613,1243,4,-1,,0.1278735632183908,0.26417525773195877,,,1467,617
97,97,5,1,14,1,1,1,224,613,1243,4,95, ,0.1278735632183908,0.26417525773195877,,,1467,617
98,98,2,1,15,0,0,0,225,631,599,119,-1,,0.07932546884452511,0.296606529209622,,,824,750
99,99,3,1,15,1,0,0,225,631,599,119,-1,,0.07932546884452511,0.296606529209622,,,824,750
100,100,4,1,15,1,1,0,225,631,388,27,-1,,0.0633696309739867,0.2768470790378007,,,613,658
101,101,5,1,15,1,1,1,225,631,45,27,96,(84),0.037431941923774956,0.2768470790378007,,,270,658
102,102,5,1,15,1,1,2,286,633,118,23,96,Designated,0.052177858439201454,0.2768470790378007,,,404,656
103,103,5,1,15,1,1,3,413,633,119,23,96,Contracting,0.07146098003629764,0.2768470790378007,,,532,656
104,104,5,1,15,1,1,4,542,633,71,19,96,States:,0.08734119782214156,0.2759879725085911,,,613,652
105,105,4,1,15,1,2,0,285,666,537,18,-1,,0.08371143375680581,0.28994845360824745,,,822,684
106,106,5,1,15,1,2,1,285,666,31,18,94,AL,0.04544767090139141,0.28994845360824745,,,316,684
107,107,5,1,15,1,2,2,323,666,31,18,94,AT,0.05119479733817302,0.28994845360824745,,,354,684
108,108,5,1,15,1,2,3,363,666,30,18,96,BE,0.05716878402903811,0.28994845360824745,,,393,684
109,109,5,1,15,1,2,4,403,666,32,18,96,BG,0.0633696309739867,0.28994845360824745,,,435,684
110,110,5,1,15,1,2,5,445,666,31,18,96,CH,0.06964609800362977,0.28994845360824745,,,476,684
111,111,5,1,15,1,2,6,486,666,32,18,95,CY,0.07592256503327284,0.28994845360824745,,,518,684
112,112,5,1,15,1,2,7,526,666,30,18,93,CZ,0.08182093163944344,0.28994845360824745,,,556,684
113,113,5,1,15,1,2,8,565,666,30,18,93,DE,0.08771929824561403,0.28994845360824745,,,595,684
114,114,5,1,15,1,2,9,605,666,32,18,95,DK,0.09392014519056262,0.28994845360824745,,,637,684
115,115,5,1,15,1,2,10,646,666,29,18,95,EE,0.0998941318814277,0.28994845360824745,,,675,684
116,116,5,1,15,1,2,11,684,666,29,18,93,ES,0.10564125831820932,0.28994845360824745,,,713,684
117,117,5,1,15,1,2,12,723,666,57,18,90,FIFR,0.11365698729582577,0.28994845360824745,,,780,684
118,118,5,1,15,1,2,13,788,666,34,18,95,GB,0.12174833635813673,0.28994845360824745,,,822,684
119,119,4,1,15,1,3,0,285,699,539,18,-1,,0.0838626739261948,0.30412371134020616,,,824,717
120,120,5,1,15,1,3,1,285,699,297,18,83,GRHRHUIEISITLILTLU,0.06556261343012704,0.30412371134020616,,,582,717
121,121,5,1,15,1,3,2,591,699,28,18,85,LV,0.09150030248033877,0.30412371134020616,,,619,717
122,122,5,1,15,1,3,3,627,699,35,18,85,MC,0.09747428917120388,0.30412371134020616,,,662,717
123,123,5,1,15,1,3,4,670,699,35,18,94,MK,0.10397761645493044,0.30412371134020616,,,705,717
124,124,5,1,15,1,3,5,713,699,32,18,91,MT,0.11025408348457351,0.30412371134020616,,,745,717
125,125,5,1,15,1,3,6,753,699,29,18,49,NL,0.11607683000604961,0.30412371134020616,,,782,717
126,126,5,1,15,1,3,7,791,699,33,18,49,NO,0.1221264367816092,0.30412371134020616,,,824,717
127,127,4,1,15,1,4,0,286,732,336,18,-1,,0.06866303690260134,0.31829896907216493,,,622,750
128,128,5,1,15,1,4,1,286,732,28,18,93,PL,0.045372050816696916,0.31829896907216493,,,314,750
129,129,5,1,15,1,4,2,323,732,29,18,92,PT,0.05104355716878403,0.31829896907216493,,,352,750
130,130,5,1,15,1,4,3,360,732,58,18,92,RORS,0.058832425892317,0.31829896907216493,,,418,750
131,131,5,1,15,1,4,4,420,732,52,18,92,SE,0.06745311554748941,0.31829896907216493,,,472,750
132,132,5,1,15,1,4,5,480,732,20,18,95,SI,0.07410768300060495,0.31829896907216493,,,500,750
133,133,5,1,15,1,4,6,510,732,31,18,93,SK,0.0794767090139141,0.31829896907216493,,,541,750
134,134,5,1,15,1,4,7,550,732,72,18,90,SMTR,0.08862673926194797,0.31829896907216493,,,622,750
135,135,2,1,16,0,0,0,225,795,491,53,-1,,0.07115849969751967,0.35287800687285226,,,716,848
136,136,3,1,16,1,0,0,225,795,491,53,-1,,0.07115849969751967,0.35287800687285226,,,716,848
137,137,4,1,16,1,1,0,225,795,488,27,-1,,0.07093163944343618,0.3472938144329897,,,713,822
138,138,5,1,16,1,1,1,225,795,45,27,96,(30),0.037431941923774956,0.3472938144329897,,,270,822
139,139,5,1,16,1,1,2,286,797,77,23,95,Priority:,0.04907743496672716,0.3472938144329897,,,363,820
140,140,5,1,16,1,1,3,383,797,118,19,95,25.07.2015,0.06684815486993345,0.34643470790378006,,,501,816
141,141,5,1,16,1,1,4,520,797,30,19,96,US,0.0809134906231095,0.34643470790378006,,,550,816
142,142,5,1,16,1,1,5,559,797,154,19,93,201514809201,0.09618874773139746,0.34643470790378006,,,713,816
143,143,4,1,16,1,2,0,383,830,333,18,-1,,0.08310647307924984,0.3603951890034364,,,716,848
144,144,5,1,16,1,2,1,383,830,118,18,93,24.08.2015,0.06684815486993345,0.3603951890034364,,,501,848
145,145,5,1,16,1,2,2,520,830,30,18,95,US,0.0809134906231095,0.3603951890034364,,,550,848
146,146,5,1,16,1,2,3,559,830,157,18,95,201514833519,0.09641560798548095,0.3603951890034364,,,716,848
147,147,2,1,17,0,0,0,225,893,596,87,-1,,0.07909860859044163,0.4022766323024055,,,821,980
148,148,3,1,17,1,0,0,225,893,596,87,-1,,0.07909860859044163,0.4022766323024055,,,821,980
149,149,4,1,17,1,1,0,225,893,596,27,-1,,0.07909860859044163,0.3893900343642612,,,821,920
150,150,5,1,17,1,1,1,225,893,45,27,96,(62),0.037431941923774956,0.3893900343642612,,,270,920
151,151,5,1,17,1,1,2,286,895,107,19,96,Document,0.05134603750756201,0.38853092783505155,,,393,914
152,152,5,1,17,1,1,3,402,895,105,23,95,number(s),0.06873865698729582,0.3893900343642612,,,507,918
153,153,5,1,17,1,1,4,516,895,20,19,96,of,0.07955232909860858,0.38853092783505155,,,536,914
154,154,5,1,17,1,1,5,542,895,32,19,96,the,0.08439201451905626,0.38853092783505155,,,574,914
155,155,5,1,17,1,1,6,582,895,66,19,96,earlier,0.09301270417422867,0.38853092783505155,,,648,914
156,156,5,1,17,1,1,7,655,895,140,23,95,application(s),0.10964912280701754,0.3893900343642612,,,795,918
157,157,5,1,17,1,1,8,805,895,16,19,96,in,0.12295825771324864,0.38853092783505155,,,821,914
158,158,4,1,17,1,2,0,286,929,308,18,-1,,0.06654567453115548,0.4029209621993127,,,594,947
159,159,5,1,17,1,2,1,286,929,121,18,96,accordance,0.05240471869328494,0.4029209621993127,,,407,947
160,160,5,1,17,1,2,2,415,929,40,18,96,with,0.06578947368421052,0.4029209621993127,,,455,947
161,161,5,1,17,1,2,3,464,929,35,18,95,Art.,0.07282214156079855,0.4029209621993127,,,499,947
162,162,5,1,17,1,2,4,508,929,25,18,95,76,0.07872050816696914,0.4029209621993127,,,533,947
163,163,5,1,17,1,2,5,542,929,52,18,96,EPC:,0.08590441621294616,0.4029209621993127,,,594,947
164,164,4,1,17,1,3,0,286,961,250,19,-1,,0.06215970961887477,0.4168814432989691,,,536,980
165,165,5,1,17,1,3,1,286,961,124,19,84,16180195.6,0.05263157894736842,0.4168814432989691,,,410,980
166,166,5,1,17,1,3,2,417,961,7,19,84,/,0.06359649122807018,0.4168814432989691,,,424,980
167,167,5,1,17,1,3,3,432,961,11,19,85,3,0.066167574107683,0.4168814432989691,,,443,980
168,168,5,1,17,1,3,4,452,961,37,19,85,125,0.07115849969751967,0.4168814432989691,,,489,980
169,169,5,1,17,1,3,5,498,961,38,19,95,618,0.07819116757410768,0.4168814432989691,,,536,980
170,170,2,1,18,0,0,0,225,1025,430,57,-1,,0.06654567453115548,0.4525343642611684,,,655,1082
171,171,3,1,18,1,0,0,225,1025,430,57,-1,,0.06654567453115548,0.4525343642611684,,,655,1082
172,172,4,1,18,1,1,0,225,1025,430,26,-1,,0.06654567453115548,0.44587628865979384,,,655,1051
173,173,5,1,18,1,1,1,225,1025,45,26,96,(71),0.037431941923774956,0.44587628865979384,,,270,1051
174,174,5,1,18,1,1,2,285,1027,103,23,96,Applicant:,0.05089231699939504,0.44609106529209624,,,388,1050
175,175,5,1,18,1,1,3,397,1027,63,18,96,Cisco,0.0648064125831821,0.44501718213058417,applicant_line_1,Cisco,460,1045
176,176,5,1,18,1,1,4,468,1027,133,23,96,"Technology,",0.080837870538415,0.44609106529209624,applicant_line_1,"Technology,",601,1050
177,177,5,1,18,1,1,5,603,1027,52,22,96,Inc.,0.09513006654567453,0.44587628865979384,applicant_line_1,Inc.,655,1049
178,178,4,1,18,1,2,0,286,1059,278,23,-1,,0.06427707199032062,0.45983676975945015,,,564,1082
179,179,5,1,18,1,2,1,286,1059,40,19,96,San,0.04627949183303085,0.45897766323024053,,,326,1078
180,180,5,1,18,1,2,2,336,1059,59,22,96,"Jose,",0.05527828191167574,0.45962199312714774,,,395,1081
181,181,5,1,18,1,2,3,404,1059,33,19,96,CA,0.06359649122807018,0.45897766323024053,,,437,1078
182,182,5,1,18,1,2,4,444,1059,66,19,96,95134,0.0721415607985481,0.45897766323024053,,,510,1078
183,183,5,1,18,1,2,5,518,1059,46,23,95,(US),0.08182093163944344,0.45983676975945015,,,564,1082
184,184,2,1,19,0,0,0,225,1123,334,91,-1,,0.05928614640048397,0.5019329896907216,,,559,1214
185,185,3,1,19,1,0,0,225,1123,334,91,-1,,0.05928614640048397,0.5019329896907216,,,559,1214
186,186,4,1,19,1,1,0,225,1123,163,27,-1,,0.046355111917725345,0.4881872852233677,,,388,1150
187,187,5,1,19,1,1,1,225,1123,45,27,93,(72),0.037431941923774956,0.4881872852233677,,,270,1150
188,188,5,1,19,1,1,2,287,1125,101,19,93,Inventors:,0.05104355716878403,0.48732817869415807,,,388,1144
189,189,4,1,19,1,2,0,262,1158,227,22,-1,,0.05679068360556564,0.502147766323024,,,489,1180
190,190,5,1,19,1,2,1,262,1163,7,8,49,+,0.04015426497277677,0.5012886597938144,,,269,1171
191,191,5,1,19,1,2,2,286,1158,86,18,92,"MADAN,",0.04975801572897762,0.5012886597938144,inventor_line_1,"MADAN,",372,1176
192,192,5,1,19,1,2,3,375,1158,83,22,93,Ritesh,0.06299153055051422,0.502147766323024,inventor_line_1,Ritesh,458,1180
193,193,5,1,19,1,2,4,468,1158,21,18,92,K.,0.07236842105263158,0.5012886597938144,inventor_line_1,K.,489,1176
194,194,4,1,19,1,3,0,286,1191,273,23,-1,,0.06389897156684815,0.5165378006872853,,,559,1214
195,195,5,1,19,1,3,1,286,1191,104,23,95,"Berkeley,",0.051119177253478525,0.5165378006872853,,,390,1214
196,196,5,1,19,1,3,2,398,1191,34,18,95,CA,0.06276467029643074,0.5154639175257731,,,432,1209
197,197,5,1,19,1,3,3,439,1191,65,18,96,94709,0.07130973986690865,0.5154639175257731,,,504,1209
198,198,5,1,19,1,3,4,512,1191,47,23,96,(US),0.080989110707804,0.5165378006872853,,,559,1214
199,199,2,1,20,0,0,0,845,614,2,664,-1,,0.1279491833030853,0.4063573883161512,,,847,1278
200,200,3,1,20,1,0,0,845,614,2,664,-1,,0.1279491833030853,0.4063573883161512,,,847,1278
201,201,4,1,20,1,1,0,845,614,2,664,-1,,0.1279491833030853,0.4063573883161512,,,847,1278
202,202,5,1,20,1,1,1,845,614,2,664,95, ,0.1279491833030853,0.4063573883161512,,,847,1278
203,203,2,1,21,0,0,0,898,633,365,253,-1,,0.16341500302480338,0.32624570446735396,,,1263,886
204,204,3,1,21,1,0,0,898,633,317,56,-1,,0.15978523895946764,0.28393470790378006,,,1215,689
205,205,4,1,21,1,1,0,898,633,268,22,-1,,0.1560798548094374,0.2766323024054983,,,1166,655
206,206,5,1,21,1,1,1,898,639,7,7,59,¬´,0.13634301270417423,0.2759879725085911,,,905,646
207,207,5,1,21,1,1,2,923,633,84,19,91,"NABAR,",0.14594676346037508,0.2759879725085911,,,1007,652
208,208,5,1,21,1,1,3,1009,633,72,22,96,Rohit,0.15804597701149425,0.2766323024054983,,,1081,655
209,209,5,1,21,1,1,4,1090,633,76,19,96,Umesh,0.1705989110707804,0.2759879725085911,,,1166,652
210,210,4,1,21,1,2,0,922,666,293,23,-1,,0.1616001209921355,0.29102233676975947,,,1215,689
211,211,5,1,21,1,2,1,922,666,124,23,96,"Sunnyvale,",0.14882032667876588,0.29102233676975947,,,1046,689
212,212,5,1,21,1,2,2,1055,666,33,18,96,CA,0.16205384150030247,0.28994845360824745,,,1088,684
213,213,5,1,21,1,2,3,1095,666,66,18,96,94087,0.1705989110707804,0.28994845360824745,,,1161,684
214,214,5,1,21,1,2,4,1169,666,46,23,96,(US),0.18027828191167575,0.29102233676975947,,,1215,689
215,215,3,1,21,2,0,0,898,699,365,56,-1,,0.16341500302480338,0.3122852233676976,,,1263,755
216,216,4,1,21,2,1,0,898,699,336,21,-1,,0.16122202056866303,0.30476804123711343,,,1234,720
217,217,5,1,21,2,1,1,898,704,7,8,37,¬´,0.13634301270417423,0.30412371134020616,,,905,712
218,218,5,1,21,2,1,2,922,699,220,18,92,"CHANDRASEKHAR,",0.1560798548094374,0.30412371134020616,,,1142,717
219,219,5,1,21,2,1,3,1144,699,90,21,96,Vikram,0.17982456140350878,0.30476804123711343,,,1234,720
220,220,4,1,21,2,2,0,923,732,340,23,-1,,0.16530550514216577,0.31937285223367695,,,1263,755
221,221,5,1,21,2,2,1,923,732,102,18,96,Mountain,0.147307924984876,0.31829896907216493,,,1025,750
222,222,5,1,21,2,2,2,1033,732,61,22,96,"View,",0.16084392014519056,0.31915807560137455,,,1094,754
223,223,5,1,21,2,2,3,1103,732,33,18,96,CA,0.169313369630974,0.31829896907216493,,,1136,750
224,224,5,1,21,2,2,4,1143,732,62,18,96,94041,0.17755595886267392,0.31829896907216493,,,1205,750
225,225,5,1,21,2,2,5,1217,732,46,23,96,(US),0.18753781004234724,0.31937285223367695,,,1263,755
226,226,3,1,21,3,0,0,898,765,317,55,-1,,0.15978523895946764,0.3404209621993127,,,1215,820
227,227,4,1,21,3,1,0,898,765,315,23,-1,,0.15963399879007864,0.3335481099656357,,,1213,788
228,228,5,1,21,3,1,1,898,770,7,8,47,¬¢,0.13634301270417423,0.3324742268041237,,,905,778
229,229,5,1,21,3,1,2,922,765,100,21,92,"SHIRALI,",0.147005444646098,0.3331185567010309,,,1022,786
230,230,5,1,21,3,1,3,1031,765,67,18,92,Kedar,0.16099516031457956,0.3324742268041237,,,1098,783
231,231,5,1,21,3,1,4,1106,765,107,23,91,Durgadas,0.1753629764065336,0.3335481099656357,,,1213,788
232,232,4,1,21,3,2,0,922,797,293,23,-1,,0.1616001209921355,0.3472938144329897,,,1215,820
233,233,5,1,21,3,2,1,922,797,124,23,96,"Sunnyvale,",0.14882032667876588,0.3472938144329897,,,1046,820
234,234,5,1,21,3,2,2,1055,797,33,19,96,CA,0.16205384150030247,0.34643470790378006,,,1088,816
235,235,5,1,21,3,2,3,1095,797,66,19,96,94087,0.1705989110707804,0.34643470790378006,,,1161,816
236,236,5,1,21,3,2,4,1169,797,46,23,96,(US),0.18027828191167575,0.3472938144329897,,,1215,820
237,237,3,1,21,4,0,0,898,830,294,56,-1,,0.15804597701149425,0.36855670103092786,,,1192,886
238,238,4,1,21,4,1,0,898,830,157,23,-1,,0.14768602540834846,0.36146907216494845,,,1055,853
239,239,5,1,21,4,1,1,898,835,7,8,59,¬´,0.13634301270417423,0.3603951890034364,,,905,843
240,240,5,1,21,4,1,2,921,830,67,18,96,"ZHAO,",0.1443587416817907,0.3603951890034364,,,988,848
241,241,5,1,21,4,1,3,991,830,64,23,96,Qing,0.15471869328493648,0.36146907216494845,,,1055,853
242,242,4,1,21,4,2,0,923,863,269,23,-1,,0.1599364791288566,0.3756443298969072,,,1192,886
243,243,5,1,21,4,2,1,923,863,99,22,96,"Fremont,",0.1470810647307925,0.3754295532646048,,,1022,885
244,244,5,1,21,4,2,2,1031,863,33,18,96,CA,0.15842407743496673,0.3745704467353952,,,1064,881
245,245,5,1,21,4,2,3,1072,863,64,18,96,94539,0.16696914700544466,0.3745704467353952,,,1136,881
246,246,5,1,21,4,2,4,1145,863,47,23,96,(US),0.17672413793103448,0.3756443298969072,,,1192,886
247,247,2,1,22,0,0,0,862,927,599,155,-1,,0.17566545674531156,0.43148625429553267,,,1461,1082
248,248,3,1,22,1,0,0,862,927,599,155,-1,,0.17566545674531156,0.43148625429553267,,,1461,1082
249,249,4,1,22,1,1,0,862,927,599,26,-1,,0.17566545674531156,0.40378006872852235,,,1461,953
250,250,5,1,22,1,1,1,862,927,44,26,96,(74),0.1336963097398669,0.40378006872852235,,,906,953
251,251,5,1,22,1,1,2,923,929,163,23,96,Representative:,0.15192075015124018,0.40399484536082475,,,1086,952
252,252,5,1,22,1,1,3,1096,929,84,21,96,"Coates,",0.1721113127646703,0.40356529209621994,representative_line_1_eu,"Coates,",1180,950
253,253,5,1,22,1,1,4,1190,929,74,18,96,Robert,0.18557168784029038,0.4029209621993127,representative_line_1_eu,Robert,1264,947
254,254,5,1,22,1,1,5,1272,929,73,18,96,James,0.19789776164549305,0.4029209621993127,representative_line_1_eu,James,1345,947
255,255,5,1,22,1,1,6,1354,929,107,18,96,Patterson,0.21287053841500303,0.4029209621993127,representative_line_1_eu,Patterson,1461,947
256,256,4,1,22,1,2,0,923,961,238,19,-1,,0.15759225650332728,0.4168814432989691,,,1161,980
257,257,5,1,22,1,2,1,923,961,80,19,93,Kilburn,0.1456442831215971,0.4168814432989691,,,1003,980
258,258,5,1,22,1,2,2,1012,961,16,19,93,&,0.1542649727767695,0.4168814432989691,,,1028,980
259,259,5,1,22,1,2,3,1036,961,74,19,96,Strode,0.16228070175438597,0.4168814432989691,,,1110,980
260,260,5,1,22,1,2,4,1119,961,42,19,96,LLP,0.1724137931034483,0.4168814432989691,,,1161,980
261,261,4,1,22,1,3,0,923,994,161,18,-1,,0.15176950998185118,0.43084192439862545,,,1084,1012
262,262,5,1,22,1,3,1,923,994,67,18,96,Lacon,0.14466122202056866,0.43084192439862545,,,990,1012
263,263,5,1,22,1,3,2,999,994,85,18,95,London,0.15751663641863278,0.43084192439862545,,,1084,1012
264,264,4,1,22,1,4,0,922,1027,216,18,-1,,0.1557773744706594,0.44501718213058417,,,1138,1045
265,265,5,1,22,1,4,1,922,1027,25,18,91,84,0.1413339382940109,0.44501718213058417,,,947,1045
266,266,5,1,22,1,4,2,955,1027,118,18,91,Theobalds,0.15335753176043557,0.44501718213058417,,,1073,1045
267,267,5,1,22,1,4,3,1082,1027,56,18,96,Road,0.16787658802177857,0.44501718213058417,,,1138,1045
268,268,4,1,22,1,5,0,923,1059,270,23,-1,,0.1600120992135511,0.45983676975945015,,,1193,1082
269,269,5,1,22,1,5,1,923,1059,84,19,93,London,0.14594676346037508,0.45897766323024053,,,1007,1078
270,270,5,1,22,1,5,2,1015,1059,69,19,70,WC1X,0.1587265577737447,0.45897766323024053,,,1084,1078
271,271,5,1,22,1,5,3,1092,1059,28,19,89,8NL,0.16727162734422263,0.45897766323024053,,,1120,1078
272,272,5,1,22,1,5,4,1123,1059,70,23,96,(GB),0.1751361161524501,0.45983676975945015,,,1193,1082
273,273,2,1,23,0,0,0,862,1125,99,19,-1,,0.13785541439806412,0.48732817869415807,,,961,1144
274,274,3,1,23,1,0,0,862,1125,99,19,-1,,0.13785541439806412,0.48732817869415807,,,961,1144
275,275,4,1,23,1,1,0,862,1125,99,19,-1,,0.13785541439806412,0.48732817869415807,,,961,1144
276,276,5,1,23,1,1,1,862,1125,99,19,96,Remarks:,0.13785541439806412,0.48732817869415807,,,961,1144
277,277,2,1,24,0,0,0,922,1158,522,84,-1,,0.17891712038717483,0.5154639175257731,,,1444,1242
278,278,3,1,24,1,0,0,922,1158,522,84,-1,,0.17891712038717483,0.5154639175257731,,,1444,1242
279,279,4,1,24,1,1,0,922,1158,477,23,-1,,0.17551421657592256,0.5023625429553265,,,1399,1181
280,280,5,1,24,1,1,1,922,1158,43,18,97,This,0.1426950998185118,0.5012886597938144,,,965,1176
281,281,5,1,24,1,1,2,974,1158,111,23,96,application,0.15570175438596492,0.5023625429553265,,,1085,1181
282,282,5,1,24,1,1,3,1093,1163,42,13,96,was,0.16848154869933454,0.5023625429553265,,,1135,1176
283,283,5,1,24,1,1,4,1142,1158,43,18,96,filed,0.17596793708408953,0.5012886597938144,,,1185,1176
284,284,5,1,24,1,1,5,1193,1163,25,13,96,on,0.1823200241984271,0.5023625429553265,,,1218,1176
285,285,5,1,24,1,1,6,1226,1158,121,18,96,28-06-2018,0.19457047791893528,0.5012886597938144,,,1347,1176
286,286,5,1,24,1,1,7,1355,1163,24,13,96,as,0.20674531155474893,0.5023625429553265,,,1379,1176
287,287,5,1,24,1,1,8,1387,1163,12,13,96,a,0.21067755595886267,0.5023625429553265,,,1399,1176
288,288,4,1,24,1,2,0,922,1191,522,23,-1,,0.17891712038717483,0.5165378006872853,,,1444,1214
289,289,5,1,24,1,2,1,922,1191,96,18,96,divisional,0.14670296430732002,0.5154639175257731,,,1018,1209
290,290,5,1,24,1,2,2,1027,1191,111,23,96,application,0.16371748336358136,0.5165378006872853,,,1138,1214
291,291,5,1,24,1,2,3,1147,1191,19,18,96,to,0.17490925589836662,0.5154639175257731,,,1166,1209
292,292,5,1,24,1,2,4,1174,1191,31,18,96,the,0.17990018148820328,0.5154639175257731,,,1205,1209
293,293,5,1,24,1,2,5,1214,1191,112,23,96,application,0.19207501512401695,0.5165378006872853,,,1326,1214
294,294,5,1,24,1,2,6,1336,1191,108,18,96,mentioned,0.2102238354506957,0.5154639175257731,,,1444,1209
295,295,4,1,24,1,3,0,923,1224,209,18,-1,,0.15539927404718692,0.529639175257732,,,1132,1242
296,296,5,1,24,1,3,1,923,1224,59,18,92,under,0.1440562613430127,0.529639175257732,,,982,1242
297,297,5,1,24,1,3,2,991,1224,45,18,88,INID,0.15328191167574107,0.529639175257732,,,1036,1242
298,298,5,1,24,1,3,3,1044,1224,50,18,96,code,0.16167574107683,0.529639175257732,,,1094,1242
299,299,5,1,24,1,3,4,1103,1224,29,18,96,62.,0.16901088929219601,0.529639175257732,,,1132,1242
300,300,2,1,25,0,0,0,224,1276,1243,4,-1,,0.1278735632183908,0.5489690721649485,,,1467,1280
301,301,3,1,25,1,0,0,224,1276,1243,4,-1,,0.1278735632183908,0.5489690721649485,,,1467,1280
302,302,4,1,25,1,1,0,224,1276,1243,4,-1,,0.1278735632183908,0.5489690721649485,,,1467,1280
303,303,5,1,25,1,1,1,224,1276,1243,4,95, ,0.1278735632183908,0.5489690721649485,,,1467,1280
304,304,2,1,26,0,0,0,225,1296,430,53,-1,,0.06654567453115548,0.5680841924398625,,,655,1349
305,305,3,1,26,1,0,0,225,1296,430,53,-1,,0.06654567453115548,0.5680841924398625,,,655,1349
306,306,4,1,26,1,1,0,225,1296,45,26,-1,,0.037431941923774956,0.5622852233676976,,,270,1322
307,307,5,1,26,1,1,1,225,1296,45,26,96,(54),0.037431941923774956,0.5622852233676976,,,270,1322
308,308,4,1,26,1,2,0,316,1328,339,21,-1,,0.07342710223835451,0.5749570446735395,,,655,1349
309,309,5,1,26,1,2,1,316,1328,116,21,96,NETWORK,0.056563823351482155,0.5749570446735395,,,432,1349
310,310,5,1,26,1,2,2,434,1328,221,21,96,ENVIRONMENT,0.0823502722323049,0.5749570446735395,,,655,1349
311,311,2,1,27,0,0,0,224,1403,584,254,-1,,0.0780399274047187,0.6572164948453608,,,808,1657
312,312,3,1,27,1,0,0,224,1403,584,254,-1,,0.0780399274047187,0.6572164948453608,,,808,1657
313,313,4,1,27,1,1,0,225,1403,582,26,-1,,0.0780399274047187,0.6082474226804123,,,807,1429
314,314,5,1,27,1,1,1,225,1403,45,26,93,(57),0.037431941923774956,0.6082474226804123,,,270,1429
315,315,5,1,27,1,1,2,0,0,1653,2328,20,|,0.125,0.5,,,1653,2328
316,316,5,1,27,1,1,3,315,1405,15,18,56,A,0.04877495462794918,0.6073883161512027,title_line_1,A,330,1423
317,317,5,1,27,1,1,4,340,1405,76,18,56,method,0.05716878402903811,0.6073883161512027,,,416,1423
318,318,5,1,27,1,1,5,427,1405,15,18,96,is,0.06571385359951604,0.6073883161512027,,,442,1423
319,319,5,1,27,1,1,6,452,1405,89,23,96,provided,0.0750907441016334,0.6084621993127147,,,541,1428
320,320,5,1,27,1,1,7,552,1405,15,18,96,in,0.08461887477313974,0.6073883161512027,,,567,1423
321,321,5,1,27,1,1,8,577,1410,38,13,96,one,0.09013914095583787,0.6084621993127147,,,615,1423
322,322,5,1,27,1,1,9,624,1405,89,23,93,example,0.10110405323653962,0.6084621993127147,,,713,1428
323,323,5,1,27,1,1,10,722,1405,85,18,72,embodi-,0.11562310949788264,0.6073883161512027,,,807,1423
324,324,4,1,27,1,2,0,226,1438,581,23,-1,,0.07811554748941318,0.6226374570446735,,,807,1461
325,325,5,1,27,1,2,1,226,1438,51,18,96,ment,0.03803690260133091,0.6215635738831615,,,277,1456
326,326,5,1,27,1,2,2,286,1438,37,18,96,and,0.046052631578947366,0.6215635738831615,,,323,1456
327,327,5,1,27,1,2,3,334,1442,31,14,96,may,0.052858439201451904,0.6224226804123711,,,365,1456
328,328,5,1,27,1,2,4,366,1438,94,23,93,include,0.06246218995765275,0.6226374570446735,,,460,1461
329,329,5,1,27,1,2,5,470,1438,116,23,96,"calculating,",0.07985480943738657,0.6226374570446735,,,586,1461
330,330,5,1,27,1,2,6,598,1438,22,23,96,by,0.09210526315789473,0.6226374570446735,,,620,1461
331,331,5,1,27,1,2,7,629,1442,39,14,96,one,0.09807924984875983,0.6224226804123711,,,668,1456
332,332,5,1,27,1,2,8,677,1442,21,14,96,or,0.10397761645493044,0.6224226804123711,,,698,1456
333,333,5,1,27,1,2,9,707,1442,51,14,95,more,0.11078342407743497,0.6224226804123711,,,758,1456
334,334,5,1,27,1,2,10,767,1438,20,18,95,of,0.11751361161524501,0.6215635738831615,,,787,1456
335,335,5,1,27,1,2,11,796,1442,11,14,96,a,0.12121899576527526,0.6224226804123711,,,807,1456
336,336,4,1,27,1,3,0,226,1470,581,23,-1,,0.07811554748941318,0.6363831615120275,,,807,1493
337,337,5,1,27,1,3,1,226,1470,80,23,96,plurality,0.040229885057471264,0.6363831615120275,,,306,1493
338,338,5,1,27,1,3,2,311,1470,19,19,96,of,0.0484724742891712,0.6355240549828178,,,330,1489
339,339,5,1,27,1,3,3,334,1470,54,19,88,small,0.05459770114942529,0.6355240549828178,,,388,1489
340,340,5,1,27,1,3,4,394,1470,33,19,88,cell,0.06208408953418028,0.6355240549828178,,,427,1489
341,341,5,1,27,1,3,5,433,1470,69,22,92,"radios,",0.0707047791893527,0.636168384879725,,,502,1492
342,342,5,1,27,1,3,6,508,1475,38,14,95,one,0.07970356926799758,0.6365979381443299,,,546,1489
343,343,5,1,27,1,3,7,551,1475,21,14,96,or,0.08492135511191773,0.6365979381443299,,,572,1489
344,344,5,1,27,1,3,8,577,1475,40,14,95,more,0.09029038112522686,0.6365979381443299,,,617,1489
345,345,5,1,27,1,3,9,618,1471,58,18,95,sets,0.09785238959467635,0.6357388316151202,,,676,1489
346,346,5,1,27,1,3,10,681,1470,20,19,96,of,0.10450695704779189,0.6355240549828178,,,701,1489
347,347,5,1,27,1,3,11,705,1470,102,19,96,candidate,0.11433756805807622,0.6355240549828178,,,807,1489
348,348,4,1,27,1,4,0,226,1503,581,23,-1,,0.07811554748941318,0.6505584192439863,,,807,1526
349,349,5,1,27,1,4,1,226,1508,54,18,96,power,0.0382637628554144,0.6516323024054983,,,280,1526
350,350,5,1,27,1,4,2,283,1503,83,18,93,control,0.04907743496672716,0.6494845360824743,,,366,1521
351,351,5,1,27,1,4,3,376,1504,117,22,96,parameters,0.06571385359951604,0.6507731958762887,,,493,1526
352,352,5,1,27,1,4,4,503,1503,54,23,96,using,0.08015728977616456,0.6505584192439863,,,557,1526
353,353,5,1,27,1,4,5,0,0,1653,2328,96,a,0.125,0.5,,,1653,2328
354,354,5,1,27,1,4,6,565,1503,57,18,95,first,0.0897610405323654,0.6494845360824743,,,622,1521
355,355,5,1,27,1,4,7,631,1503,123,18,93,interference,0.10473381730187538,0.6494845360824743,,,754,1521
356,356,5,1,27,1,4,8,763,1508,44,13,93,con-,0.11872353297035693,0.6505584192439863,,,807,1521
357,357,4,1,27,1,5,0,225,1536,583,23,-1,,0.07811554748941318,0.664733676975945,,,808,1559
358,358,5,1,27,1,5,1,225,1536,64,18,96,straint,0.038868723532970356,0.663659793814433,,,289,1554
359,359,5,1,27,1,5,2,296,1536,28,18,96,for,0.04688445251058681,0.663659793814433,,,324,1554
360,360,5,1,27,1,5,3,332,1536,61,23,96,uplink,0.05482456140350877,0.664733676975945,,,393,1559
361,361,5,1,27,1,5,4,402,1540,44,14,96,user,0.06412583182093164,0.6645189003436426,,,446,1554
362,362,5,1,27,1,5,5,454,1536,110,23,96,equipment,0.07698124621899577,0.664733676975945,,,564,1559
363,363,5,1,27,1,5,6,573,1536,46,23,96,(UE),0.09013914095583787,0.664733676975945,,,619,1559
364,364,5,1,27,1,5,7,628,1536,144,18,96,transmissions,0.10586811857229281,0.663659793814433,,,772,1554
365,365,5,1,27,1,5,8,780,1536,28,18,96,for,0.12008469449485784,0.663659793814433,,,808,1554
366,366,4,1,27,1,6,0,226,1569,581,23,-1,,0.07811554748941318,0.6789089347079038,,,807,1592
367,367,5,1,27,1,6,1,226,1569,30,18,95,UE,0.03644888082274652,0.6778350515463918,,,256,1587
368,368,5,1,27,1,6,2,266,1569,70,18,95,served,0.0455232909860859,0.6778350515463918,,,336,1587
369,369,5,1,27,1,6,3,348,1569,23,23,96,by,0.054370840895341804,0.6789089347079038,,,371,1592
370,370,5,1,27,1,6,4,380,1569,32,18,96,the,0.05989110707803993,0.6778350515463918,,,412,1587
371,371,5,1,27,1,6,5,422,1574,38,13,95,one,0.06669691470054447,0.6789089347079038,,,460,1587
372,372,5,1,27,1,6,6,471,1574,20,13,95,or,0.07274652147610405,0.6789089347079038,,,491,1587
373,373,5,1,27,1,6,7,501,1574,40,13,96,more,0.07879612825166364,0.6789089347079038,,,541,1587
374,374,5,1,27,1,6,8,542,1574,33,13,96,of,0.08446763460375076,0.6789089347079038,,,575,1587
375,375,5,1,27,1,6,9,576,1569,48,18,96,the,0.09074410163339383,0.6778350515463918,,,624,1587
376,376,5,1,27,1,6,10,635,1569,79,23,96,plurality,0.10201149425287356,0.6789089347079038,,,714,1592
377,377,5,1,27,1,6,11,724,1569,20,18,96,of,0.11101028433151845,0.6778350515463918,,,744,1587
378,378,5,1,27,1,6,12,753,1569,54,18,96,small,0.11796733212341198,0.6778350515463918,,,807,1587
379,379,4,1,27,1,7,0,225,1602,581,23,-1,,0.0779643073200242,0.6930841924398625,,,806,1625
380,380,5,1,27,1,7,1,225,1602,34,18,69,cell,0.03660012099213551,0.6920103092783505,,,259,1620
381,381,5,1,27,1,7,2,266,1602,69,21,69,radios;,0.04544767090139141,0.6926546391752577,,,335,1623
382,382,5,1,27,1,7,3,343,1602,129,23,96,"determining,",0.06163036902601331,0.6930841924398625,,,472,1625
383,383,5,1,27,1,7,4,479,1602,20,18,90,at,0.07395644283121597,0.6920103092783505,,,499,1620
384,384,5,1,27,1,7,5,505,1606,11,14,90,a,0.07720810647307925,0.6928694158075601,,,516,1620
385,385,5,1,27,1,7,6,524,1602,69,18,96,central,0.08446763460375076,0.6920103092783505,,,593,1620
386,386,5,1,27,1,7,7,602,1606,129,19,96,management,0.10080157289776165,0.6939432989690721,,,731,1625
387,387,5,1,27,1,7,8,733,1602,73,23,96,"entity,",0.11637931034482758,0.6930841924398625,,,806,1625
388,388,4,1,27,1,8,0,224,1634,583,23,-1,,0.0779643073200242,0.7068298969072165,,,807,1657
389,389,5,1,27,1,8,1,224,1634,76,19,96,whether,0.039624924379915306,0.7059707903780069,,,300,1653
390,390,5,1,27,1,8,2,302,1639,36,14,96,an,0.04839685420447671,0.7070446735395189,,,338,1653
391,391,5,1,27,1,8,3,345,1639,71,18,96,average,0.057546884452510584,0.7079037800687286,,,416,1657
392,392,5,1,27,1,8,4,418,1634,37,19,96,of,0.06601633393829401,0.7059707903780069,,,455,1653
393,393,5,1,27,1,8,5,460,1639,11,14,96,a,0.07040229885057471,0.7070446735395189,,,471,1653
394,394,5,1,27,1,8,6,478,1639,42,14,96,sum,0.07546884452510587,0.7070446735395189,,,520,1653
395,395,5,1,27,1,8,7,526,1634,20,19,95,of,0.08106473079249849,0.7059707903780069,,,546,1653
396,396,5,1,27,1,8,8,550,1639,25,14,95,an,0.08507259528130671,0.7070446735395189,,,575,1653
397,397,5,1,27,1,8,9,581,1635,82,22,95,expected,0.0940713853599516,0.7070446735395189,,,663,1657
398,398,5,1,27,1,8,10,665,1634,142,19,96,interference,0.11131276467029642,0.7059707903780069,,,807,1653
399,399,2,1,28,0,0,0,609,1768,172,1,-1,,0.10511191772534785,0.7596649484536082,,,781,1769
400,400,3,1,28,1,0,0,609,1768,172,1,-1,,0.10511191772534785,0.7596649484536082,,,781,1769
401,401,4,1,28,1,1,0,609,1768,172,1,-1,,0.10511191772534785,0.7596649484536082,,,781,1769
402,402,5,1,28,1,1,1,609,1768,172,1,95, ,0.10511191772534785,0.7596649484536082,,,781,1769
403,403,2,1,29,0,0,0,651,1791,119,1,-1,,0.1074561403508772,0.7695446735395189,,,770,1792
404,404,3,1,29,1,0,0,651,1791,119,1,-1,,0.1074561403508772,0.7695446735395189,,,770,1792
405,405,4,1,29,1,1,0,651,1791,119,1,-1,,0.1074561403508772,0.7695446735395189,,,770,1792
406,406,5,1,29,1,1,1,651,1791,119,1,95, ,0.1074561403508772,0.7695446735395189,,,770,1792
407,407,2,1,30,0,0,0,609,1768,1,68,-1,,0.09218088324258923,0.7740549828178694,,,610,1836
408,408,3,1,30,1,0,0,609,1768,1,68,-1,,0.09218088324258923,0.7740549828178694,,,610,1836
409,409,4,1,30,1,1,0,609,1768,1,68,-1,,0.09218088324258923,0.7740549828178694,,,610,1836
410,410,5,1,30,1,1,1,609,1768,1,68,95, ,0.09218088324258923,0.7740549828178694,,,610,1836
411,411,2,1,31,0,0,0,779,1768,2,68,-1,,0.11796733212341198,0.7740549828178694,,,781,1836
412,412,3,1,31,1,0,0,779,1768,2,68,-1,,0.11796733212341198,0.7740549828178694,,,781,1836
413,413,4,1,31,1,1,0,779,1768,2,68,-1,,0.11796733212341198,0.7740549828178694,,,781,1836
414,414,5,1,31,1,1,1,779,1768,2,68,95, ,0.11796733212341198,0.7740549828178694,,,781,1836
415,415,2,1,32,0,0,0,651,1791,2,34,-1,,0.09860859044162129,0.7766323024054983,,,653,1825
416,416,3,1,32,1,0,0,651,1791,2,34,-1,,0.09860859044162129,0.7766323024054983,,,653,1825
417,417,4,1,32,1,1,0,651,1791,2,34,-1,,0.09860859044162129,0.7766323024054983,,,653,1825
418,418,5,1,32,1,1,1,651,1791,2,34,95, ,0.09860859044162129,0.7766323024054983,,,653,1825
419,419,2,1,33,0,0,0,768,1791,3,34,-1,,0.11637931034482758,0.7766323024054983,,,771,1825
420,420,3,1,33,1,0,0,768,1791,3,34,-1,,0.11637931034482758,0.7766323024054983,,,771,1825
421,421,4,1,33,1,1,0,768,1791,3,34,-1,,0.11637931034482758,0.7766323024054983,,,771,1825
422,422,5,1,33,1,1,1,768,1791,3,34,95, ,0.11637931034482758,0.7766323024054983,,,771,1825
423,423,2,1,34,0,0,0,651,1823,119,2,-1,,0.1074561403508772,0.7835051546391752,,,770,1825
424,424,3,1,34,1,0,0,651,1823,119,2,-1,,0.1074561403508772,0.7835051546391752,,,770,1825
425,425,4,1,34,1,1,0,651,1823,119,2,-1,,0.1074561403508772,0.7835051546391752,,,770,1825
426,426,5,1,34,1,1,1,651,1823,119,2,95, ,0.1074561403508772,0.7835051546391752,,,770,1825
427,427,2,1,35,0,0,0,316,1296,1090,21,-1,,0.13021778584392016,0.5612113402061856,,,1406,1317
428,428,3,1,35,1,0,0,316,1296,1090,21,-1,,0.13021778584392016,0.5612113402061856,,,1406,1317
429,429,4,1,35,1,1,0,316,1296,1090,21,-1,,0.13021778584392016,0.5612113402061856,,,1406,1317
430,430,5,1,35,1,1,1,316,1296,105,21,96,SYSTEM,0.05573200241984271,0.5612113402061856,title_line_1,SYSTEM,421,1317
431,431,5,1,35,1,1,2,431,1296,57,20,95,AND,0.06949485783424078,0.5609965635738832,title_line_1,AND,488,1316
432,432,5,1,35,1,1,3,498,1296,92,21,96,METHOD,0.0822746521476104,0.5612113402061856,title_line_1,METHOD,590,1317
433,433,5,1,35,1,1,4,594,1296,60,21,94,TO,0.09437386569872959,0.5612113402061856,title_line_1,TO,654,1317
434,434,5,1,35,1,1,5,665,1296,151,21,95,FACILITATE,0.11199334543254688,0.5612113402061856,title_line_1,FACILITATE,816,1317
435,435,5,1,35,1,1,6,826,1296,90,21,96,SMALL,0.13173018753781005,0.5612113402061856,title_line_1,SMALL,916,1317
436,436,5,1,35,1,1,7,925,1296,68,21,96,CELL,0.14503932244404114,0.5612113402061856,title_line_1,CELL,993,1317
437,437,5,1,35,1,1,8,1003,1296,96,21,96,UPLINK,0.1589534180278282,0.5612113402061856,title_line_1,UPLINK,1099,1317
438,438,5,1,35,1,1,9,1109,1296,97,21,96,POWER,0.1750604960677556,0.5612113402061856,title_line_1,POWER,1206,1317
439,439,5,1,35,1,1,10,1216,1296,112,21,94,CONTROL,0.19237749546279492,0.5612113402061856,title_line_1,CONTROL,1328,1317
440,440,5,1,35,1,1,11,1332,1296,74,20,95,INA,0.20704779189352693,0.5609965635738832,title_line_1,IN,1406,1316
441,441,2,1,36,0,0,0,883,1405,584,220,-1,,0.17770719903206292,0.6507731958762887,,,1467,1625
442,442,3,1,36,1,0,0,883,1405,584,220,-1,,0.17770719903206292,0.6507731958762887,,,1467,1625
443,443,4,1,36,1,1,0,883,1405,583,23,-1,,0.17763157894736842,0.6084621993127147,,,1466,1428
444,444,5,1,36,1,1,1,883,1405,28,18,96,for,0.13566243194192376,0.6073883161512027,,,911,1423
445,445,5,1,36,1,1,2,921,1405,30,18,96,UE,0.14156079854809436,0.6073883161512027,,,951,1423
446,446,5,1,36,1,1,3,962,1405,111,18,96,associated,0.15388687235329704,0.6073883161512027,,,1073,1423
447,447,5,1,36,1,1,4,1083,1405,41,18,97,with,0.16689352692075016,0.6073883161512027,,,1124,1423
448,448,5,1,36,1,1,5,1135,1405,31,18,96,the,0.17400181488203267,0.6073883161512027,,,1166,1423
449,449,5,1,36,1,1,6,1177,1405,80,23,96,plurality,0.1840592861464005,0.6084621993127147,,,1257,1428
450,450,5,1,36,1,1,7,1266,1405,20,18,96,of,0.19298245614035087,0.6073883161512027,,,1286,1423
451,451,5,1,36,1,1,8,1295,1405,54,18,96,small,0.1999395039322444,0.6073883161512027,,,1349,1423
452,452,5,1,36,1,1,9,1359,1405,34,18,96,cell,0.20810647307924984,0.6073883161512027,,,1393,1423
453,453,5,1,36,1,1,10,1403,1405,63,18,96,radios,0.21695402298850575,0.6073883161512027,,,1466,1423
454,454,4,1,36,1,2,0,884,1438,582,23,-1,,0.17770719903206292,0.6226374570446735,,,1466,1461
455,455,5,1,36,1,2,1,884,1438,79,18,96,violates,0.139670296430732,0.6215635738831615,,,963,1456
456,456,5,1,36,1,2,2,973,1442,12,14,96,a,0.14806412583182094,0.6224226804123711,,,985,1456
457,457,5,1,36,1,2,3,994,1438,75,18,96,second,0.1560042347247429,0.6215635738831615,,,1069,1456
458,458,5,1,36,1,2,4,1080,1438,123,18,96,interference,0.17264065335753176,0.6215635738831615,,,1203,1456
459,459,5,1,36,1,2,5,1214,1438,102,18,96,constraint,0.19131881427707198,0.6215635738831615,,,1316,1456
460,460,5,1,36,1,2,6,1323,1438,29,18,96,for,0.20228372655777374,0.6215635738831615,,,1352,1456
461,461,5,1,36,1,2,7,1360,1442,38,19,97,any,0.20856019358741681,0.6234965635738832,,,1398,1461
462,462,5,1,36,1,2,8,1406,1438,20,18,96,of,0.21415607985480944,0.6215635738831615,,,1426,1456
463,463,5,1,36,1,2,9,1434,1438,32,18,96,the,0.21929824561403508,0.6215635738831615,,,1466,1456
464,464,4,1,36,1,3,0,884,1470,581,23,-1,,0.17763157894736842,0.6363831615120275,,,1465,1493
465,465,5,1,36,1,3,1,884,1475,38,14,95,one,0.1365698729582577,0.6365979381443299,,,922,1489
466,466,5,1,36,1,3,2,928,1475,21,14,95,or,0.14193889897156683,0.6365979381443299,,,949,1489
467,467,5,1,36,1,3,3,955,1475,40,14,96,more,0.14745916515426497,0.6365979381443299,,,995,1489
468,468,5,1,36,1,3,4,995,1471,60,18,96,sets,0.15502117362371445,0.6357388316151202,,,1055,1489
469,469,5,1,36,1,3,5,1061,1470,20,19,96,of,0.161978221415608,0.6355240549828178,,,1081,1489
470,470,5,1,36,1,3,6,1087,1470,101,19,96,candidate,0.1720356926799758,0.6355240549828178,,,1188,1489
471,471,5,1,36,1,3,7,1195,1475,55,18,96,power,0.18489110707803993,0.6374570446735395,,,1250,1493
472,472,5,1,36,1,3,8,1252,1470,82,19,93,control,0.1955535390199637,0.6355240549828178,,,1334,1489
473,473,5,1,36,1,3,9,1341,1471,124,22,96,parameters;,0.21218995765275256,0.6365979381443299,,,1465,1493
474,474,4,1,36,1,4,0,884,1503,582,23,-1,,0.17770719903206292,0.6505584192439863,,,1466,1526
475,475,5,1,36,1,4,1,884,1503,37,18,96,and,0.13649425287356323,0.6494845360824743,,,921,1521
476,476,5,1,36,1,4,2,932,1503,111,23,96,generating,0.14934966727162735,0.6505584192439863,,,1043,1526
477,477,5,1,36,1,4,3,1053,1508,38,13,96,one,0.16212946158499697,0.6505584192439863,,,1091,1521
478,478,5,1,36,1,4,4,1101,1508,21,13,95,or,0.16810344827586207,0.6505584192439863,,,1122,1521
479,479,5,1,36,1,4,5,1131,1508,52,13,96,more,0.1749848759830611,0.6505584192439863,,,1183,1521
480,480,5,1,36,1,4,6,1195,1508,94,18,96,messages,0.18784029038112524,0.6516323024054983,,,1289,1526
481,481,5,1,36,1,4,7,1290,1503,47,18,96,for,0.198653962492438,0.6494845360824743,,,1337,1521
482,482,5,1,36,1,4,8,1347,1503,49,18,96,each,0.2074258923169994,0.6494845360824743,,,1396,1521
483,483,5,1,36,1,4,9,1406,1503,20,18,96,of,0.21415607985480944,0.6494845360824743,,,1426,1521
484,484,5,1,36,1,4,10,1434,1503,32,18,96,the,0.21929824561403508,0.6494845360824743,,,1466,1521
485,485,4,1,36,1,5,0,885,1536,581,23,-1,,0.17778281911675742,0.664733676975945,,,1466,1559
486,486,5,1,36,1,5,1,885,1536,80,23,96,plurality,0.13989715668481548,0.664733676975945,,,965,1559
487,487,5,1,36,1,5,2,973,1536,20,18,97,of,0.14866908650937688,0.663659793814433,,,993,1554
488,488,5,1,36,1,5,3,1000,1536,53,18,96,small,0.15524803387779795,0.663659793814433,,,1053,1554
489,489,5,1,36,1,5,4,1062,1536,33,18,96,cell,0.1631125226860254,0.663659793814433,,,1095,1554
490,490,5,1,36,1,5,5,1105,1536,63,18,96,radios,0.17188445251058682,0.663659793814433,,,1168,1554
491,491,5,1,36,1,5,6,1177,1536,104,23,96,identifying,0.18587416817906835,0.664733676975945,,,1281,1559
492,492,5,1,36,1,5,7,1290,1540,38,14,96,one,0.19797338173018753,0.6645189003436426,,,1328,1554
493,493,5,1,36,1,5,8,1336,1540,21,14,96,or,0.20364488808227466,0.6645189003436426,,,1357,1554
494,494,5,1,36,1,5,9,1366,1540,51,14,93,more,0.2104506957047792,0.6645189003436426,,,1417,1554
495,495,5,1,36,1,5,10,1426,1540,40,19,93,par-,0.21869328493647913,0.6655927835051546,,,1466,1559
496,496,4,1,36,1,6,0,884,1569,583,23,-1,,0.17778281911675742,0.6789089347079038,,,1467,1592
497,497,5,1,36,1,6,1,884,1569,63,18,96,ticular,0.1384603750756201,0.6778350515463918,,,947,1587
498,498,5,1,36,1,6,2,954,1570,43,17,96,sets,0.14753478523895946,0.6780498281786942,,,997,1587
499,499,5,1,36,1,6,3,1005,1569,20,18,96,of,0.15350877192982457,0.6778350515463918,,,1025,1587
500,500,5,1,36,1,6,4,1032,1574,63,18,96,power,0.16084392014519056,0.6799828178694158,,,1095,1592
501,501,5,1,36,1,6,5,1103,1569,70,18,96,control,0.1721113127646703,0.6778350515463918,,,1173,1587
502,502,5,1,36,1,6,6,1182,1570,118,22,95,parameters,0.18768905021173624,0.6791237113402062,,,1300,1592
503,503,5,1,36,1,6,7,1308,1569,39,18,95,that,0.20077132486388385,0.6778350515463918,,,1347,1587
504,504,5,1,36,1,6,8,1356,1569,76,23,96,provide,0.21082879612825167,0.6789089347079038,,,1432,1592
505,505,5,1,36,1,6,9,1439,1569,28,18,96,for,0.21975196612220205,0.6778350515463918,,,1467,1587
506,506,4,1,36,1,7,0,885,1602,454,23,-1,,0.16817906836055657,0.6930841924398625,,,1339,1625
507,507,5,1,36,1,7,1,885,1602,82,23,96,meeting,0.14004839685420448,0.6930841924398625,,,967,1625
508,508,5,1,36,1,7,2,975,1602,32,18,96,the,0.1498790078644888,0.6920103092783505,,,1007,1620
509,509,5,1,36,1,7,3,1016,1602,74,18,96,second,0.15925589836660617,0.6920103092783505,,,1090,1620
510,510,5,1,36,1,7,4,1100,1602,124,18,96,interference,0.17574107683000606,0.6920103092783505,,,1224,1620
511,511,5,1,36,1,7,5,1232,1602,107,18,96,constraint.,0.19441923774954628,0.6920103092783505,,,1339,1620
512,512,2,1,37,0,0,0,1075,1732,70,14,-1,,0.16787658802177857,0.7469931271477663,,,1145,1746
513,513,3,1,37,1,0,0,1075,1732,70,14,-1,,0.16787658802177857,0.7469931271477663,,,1145,1746
514,514,4,1,37,1,1,0,1075,1732,70,14,-1,,0.16787658802177857,0.7469931271477663,,,1145,1746
515,515,5,1,37,1,1,1,1075,1732,38,14,83,FIG.,0.16545674531155474,0.7469931271477663,,,1113,1746
516,516,5,1,37,1,1,2,1122,1733,23,13,83,1A,0.17143073200241984,0.7472079037800687,,,1145,1746
517,517,2,1,38,0,0,0,609,1833,459,4,-1,,0.12681488203266789,0.7882302405498282,,,1068,1837
518,518,3,1,38,1,0,0,609,1833,459,4,-1,,0.12681488203266789,0.7882302405498282,,,1068,1837
519,519,4,1,38,1,1,0,609,1833,459,4,-1,,0.12681488203266789,0.7882302405498282,,,1068,1837
520,520,5,1,38,1,1,1,609,1833,459,4,95, ,0.12681488203266789,0.7882302405498282,,,1068,1837
521,521,2,1,39,0,0,0,535,1714,586,148,-1,,0.12522686025408347,0.7680412371134021,,,1121,1862
522,522,3,1,39,1,0,0,535,1714,586,148,-1,,0.12522686025408347,0.7680412371134021,,,1121,1862
523,523,4,1,39,1,1,0,535,1714,586,148,-1,,0.12522686025408347,0.7680412371134021,,,1121,1862
524,524,5,1,39,1,1,1,535,1714,586,148,95, ,0.12522686025408347,0.7680412371134021,,,1121,1862
525,525,2,1,40,0,0,0,624,1845,433,3,-1,,0.12711736237144586,0.7931701030927835,,,1057,1848
526,526,3,1,40,1,0,0,624,1845,433,3,-1,,0.12711736237144586,0.7931701030927835,,,1057,1848
527,527,4,1,40,1,1,0,624,1845,433,3,-1,,0.12711736237144586,0.7931701030927835,,,1057,1848
528,528,5,1,40,1,1,1,624,1845,433,3,95, ,0.12711736237144586,0.7931701030927835,,,1057,1848
529,529,2,1,41,0,0,0,624,1845,2,131,-1,,0.09452510586811858,0.8206615120274914,,,626,1976
530,530,3,1,41,1,0,0,624,1845,2,131,-1,,0.09452510586811858,0.8206615120274914,,,626,1976
531,531,4,1,41,1,1,0,624,1845,2,131,-1,,0.09452510586811858,0.8206615120274914,,,626,1976
532,532,5,1,41,1,1,1,624,1845,2,131,95, ,0.09452510586811858,0.8206615120274914,,,626,1976
533,533,2,1,42,0,0,0,535,1862,586,320,-1,,0.12522686025408347,0.8685567010309279,,,1121,2182
534,534,3,1,42,1,0,0,535,1862,586,320,-1,,0.12522686025408347,0.8685567010309279,,,1121,2182
535,535,4,1,42,1,1,0,535,1862,586,320,-1,,0.12522686025408347,0.8685567010309279,,,1121,2182
536,536,5,1,42,1,1,1,535,1862,586,320,95,  ,0.12522686025408347,0.8685567010309279,,,1121,2182
537,537,2,1,43,0,0,0,1093,1873,68,23,-1,,0.1704476709013914,0.8094931271477663,,,1161,1896
538,538,3,1,43,1,0,0,1093,1873,68,23,-1,,0.1704476709013914,0.8094931271477663,,,1161,1896
539,539,4,1,43,1,1,0,1093,1873,68,9,-1,,0.1704476709013914,0.8064862542955327,,,1161,1882
540,540,5,1,43,1,1,1,1093,1873,28,9,23,RADIO,0.16742286751361163,0.8064862542955327,,,1121,1882
541,541,5,1,43,1,1,2,1123,1873,38,9,23,ACCESS,0.17271627344222626,0.8064862542955327,,,1161,1882
542,542,4,1,43,1,2,0,1103,1887,47,9,-1,,0.1703720508166969,0.8125,,,1150,1896
543,543,5,1,43,1,2,1,1103,1887,47,9,90,NETWORK,0.1703720508166969,0.8125,,,1150,1896
544,544,2,1,44,0,0,0,1066,1834,2,156,-1,,0.16137326073805203,0.8213058419243986,,,1068,1990
545,545,3,1,44,1,0,0,1066,1834,2,156,-1,,0.16137326073805203,0.8213058419243986,,,1068,1990
546,546,4,1,44,1,1,0,1066,1834,2,156,-1,,0.16137326073805203,0.8213058419243986,,,1068,1990
547,547,5,1,44,1,1,1,1066,1834,2,156,95, ,0.16137326073805203,0.8213058419243986,,,1068,1990
548,548,2,1,45,0,0,0,1056,1845,1,140,-1,,0.15978523895946764,0.822594501718213,,,1057,1985
549,549,3,1,45,1,0,0,1056,1845,1,140,-1,,0.15978523895946764,0.822594501718213,,,1057,1985
550,550,4,1,45,1,1,0,1056,1845,1,140,-1,,0.15978523895946764,0.822594501718213,,,1057,1985
551,551,5,1,45,1,1,1,1056,1845,1,140,95, ,0.15978523895946764,0.822594501718213,,,1057,1985
552,552,2,1,46,0,0,0,914,2068,153,38,-1,,0.14980338777979432,0.8964776632302406,,,1067,2106
553,553,3,1,46,1,0,0,914,2068,153,38,-1,,0.14980338777979432,0.8964776632302406,,,1067,2106
554,554,4,1,46,1,1,0,914,2068,142,20,-1,,0.14897156684815488,0.8926116838487973,,,1056,2088
555,555,5,1,46,1,1,1,914,2068,48,20,2,7,0.14186327888687236,0.8926116838487973,,,962,2088
556,556,5,1,46,1,1,2,965,2076,30,9,0,oat,0.1482153660012099,0.8936855670103093,,,995,2085
557,557,5,1,46,1,1,3,998,2076,22,9,58,cea,0.15260133091349062,0.8936855670103093,,,1020,2085
558,558,5,1,46,1,1,4,1023,2068,33,17,20,ano‚Äù,0.1572141560798548,0.8919673539518901,,,1056,2085
559,559,4,1,46,1,2,0,966,2090,101,16,-1,,0.15373563218390804,0.9012027491408935,,,1067,2106
560,560,5,1,46,1,2,1,966,2091,19,9,62,114,0.14753478523895946,0.9001288659793815,,,985,2100
561,561,5,1,46,1,2,2,987,2090,46,16,94,COVERAGE,0.15275257108287962,0.9012027491408935,,,1033,2106
562,562,5,1,46,1,2,3,1034,2091,33,8,96,AREA,0.1588777979431337,0.8999140893470791,,,1067,2099
563,563,2,1,47,0,0,0,716,2270,259,16,-1,,0.1278735632183908,0.9785223367697594,,,975,2286
564,564,3,1,47,1,0,0,716,2270,259,16,-1,,0.1278735632183908,0.9785223367697594,,,975,2286
565,565,4,1,47,1,1,0,716,2270,259,16,-1,,0.1278735632183908,0.9785223367697594,,,975,2286
566,566,5,1,47,1,1,1,716,2270,49,12,96,Printed,0.11199334543254688,0.9776632302405498,,,765,2282
567,567,5,1,47,1,1,2,771,2270,15,16,96,by,0.1177404718693285,0.9785223367697594,,,786,2286
568,568,5,1,47,1,1,3,792,2270,45,14,96,"Jouve,",0.12318511796733213,0.9780927835051546,,,837,2284
569,569,5,1,47,1,1,4,843,2270,41,12,96,75001,0.13059588626739263,0.9776632302405498,,,884,2282
570,570,5,1,47,1,1,5,893,2270,46,12,96,PARIS,0.1385359951603146,0.9776632302405498,,,939,2282
571,571,5,1,47,1,1,6,945,2270,30,16,95,(FR),0.14519056261343014,0.9785223367697594,,,975,2286
