,Unnamed: 0,level,page_num,block_num,par_num,line_num,word_num,left,top,width,height,conf,text,x,y,label,target,right,bottom
0,0,1,1,0,0,0,0,0,0,1653,2328,-1,,0.125,0.5,,,1653,2328
1,1,2,1,1,0,0,0,144,1905,31,328,-1,,0.02412280701754386,0.8887457044673539,,,175,2233
2,2,3,1,1,1,0,0,144,1905,31,328,-1,,0.02412280701754386,0.8887457044673539,,,175,2233
3,3,4,1,1,1,1,0,144,1905,31,328,-1,,0.02412280701754386,0.8887457044673539,,,175,2233
4,4,5,1,1,1,1,1,144,2179,30,54,94,EP,0.024047186932849365,0.947594501718213,,,174,2233
5,5,5,1,1,1,1,2,144,2142,31,21,93,3,0.02412280701754386,0.9246134020618557,,,175,2163
6,6,5,1,1,1,1,3,144,2055,31,71,93,399,0.02412280701754386,0.8979810996563574,,,175,2126
7,7,5,1,1,1,1,4,144,1969,30,70,93,727,0.024047186932849365,0.8608247422680413,,,174,2039
8,8,5,1,1,1,1,5,144,1905,30,50,87,A1,0.024047186932849365,0.8290378006872853,,,174,1955
9,9,2,1,2,0,0,0,429,153,88,28,-1,,0.07153660012099214,0.07173539518900343,,,517,181
10,10,3,1,2,1,0,0,429,153,88,28,-1,,0.07153660012099214,0.07173539518900343,,,517,181
11,11,4,1,2,1,1,0,429,153,88,16,-1,,0.07153660012099214,0.06915807560137457,,,517,169
12,12,5,1,2,1,1,1,429,153,88,16,84,Europaisches,0.07153660012099214,0.06915807560137457,,,517,169
13,13,4,1,2,1,2,0,429,170,71,11,-1,,0.07025105868118572,0.07538659793814433,,,500,181
14,14,5,1,2,1,2,1,429,170,71,11,96,Patentamt,0.07025105868118572,0.07538659793814433,,,500,181
15,15,2,1,3,0,0,0,429,196,89,28,-1,,0.07161222020568662,0.09020618556701031,,,518,224
16,16,3,1,3,1,0,0,429,196,89,28,-1,,0.07161222020568662,0.09020618556701031,,,518,224
17,17,4,1,3,1,1,0,429,196,63,15,-1,,0.06964609800362977,0.08741408934707903,,,492,211
18,18,5,1,3,1,1,1,429,196,63,15,95,European,0.06964609800362977,0.08741408934707903,,,492,211
19,19,4,1,3,1,2,0,429,212,89,12,-1,,0.07161222020568662,0.0936426116838488,,,518,224
20,20,5,1,3,1,2,1,429,213,43,11,96,Patent,0.06813369630973987,0.0938573883161512,,,472,224
21,21,5,1,3,1,2,2,478,212,40,12,90,Office,0.07531760435571688,0.0936426116838488,,,518,224
22,22,2,1,4,0,0,0,429,239,109,28,-1,,0.07312462189957653,0.10867697594501718,,,538,267
23,23,3,1,4,1,0,0,429,239,109,28,-1,,0.07312462189957653,0.10867697594501718,,,538,267
24,24,4,1,4,1,1,0,429,239,109,15,-1,,0.07312462189957653,0.10588487972508591,,,538,254
25,25,5,1,4,1,1,1,429,239,40,12,93,Office,0.06790683605565638,0.1052405498281787,,,469,251
26,26,5,1,4,1,1,2,474,239,64,15,93,europ√©en,0.0765275257108288,0.10588487972508591,,,538,254
27,27,4,1,4,1,2,0,429,255,77,12,-1,,0.0707047791893527,0.11211340206185567,,,506,267
28,28,5,1,4,1,2,1,429,255,22,12,95,des,0.06654567453115548,0.11211340206185567,,,451,267
29,29,5,1,4,1,2,2,457,255,49,12,82,brevets,0.07282214156079855,0.11211340206185567,,,506,267
30,30,2,1,5,0,0,0,281,136,274,150,-1,,0.06321839080459771,0.09063573883161512,,,555,286
31,31,3,1,5,1,0,0,281,136,274,150,-1,,0.06321839080459771,0.09063573883161512,,,555,286
32,32,4,1,5,1,1,0,281,136,274,150,-1,,0.06321839080459771,0.09063573883161512,,,555,286
33,33,5,1,5,1,1,1,281,136,274,150,95, ,0.06321839080459771,0.09063573883161512,,,555,286
34,34,2,1,6,0,0,0,1002,245,458,38,-1,,0.18617664851784635,0.1134020618556701,,,1460,283
35,35,3,1,6,1,0,0,1002,245,458,38,-1,,0.18617664851784635,0.1134020618556701,,,1460,283
36,36,4,1,6,1,1,0,1002,245,458,38,-1,,0.18617664851784635,0.1134020618556701,,,1460,283
37,37,5,1,6,1,1,1,1002,256,44,27,74,(11),0.15486993345432548,0.11576460481099657,,,1046,283
38,38,5,1,6,1,1,2,1146,245,52,32,95,EP,0.17725347852389595,0.11211340206185567,number,EP,1198,277
39,39,5,1,6,1,1,3,1214,245,20,32,94,3,0.1851179673321234,0.11211340206185567,number,3,1234,277
40,40,5,1,6,1,1,4,1249,245,68,32,94,399,0.1940411373260738,0.11211340206185567,number,399,1317,277
41,41,5,1,6,1,1,5,1332,245,67,32,93,727,0.20651845130066546,0.11211340206185567,number,727,1399,277
42,42,5,1,6,1,1,6,1413,245,47,32,85,A1,0.21725650332728372,0.11211340206185567,number,A1,1460,277
43,43,2,1,7,0,0,0,224,613,1243,4,-1,,0.1278735632183908,0.26417525773195877,,,1467,617
44,44,3,1,7,1,0,0,224,613,1243,4,-1,,0.1278735632183908,0.26417525773195877,,,1467,617
45,45,4,1,7,1,1,0,224,613,1243,4,-1,,0.1278735632183908,0.26417525773195877,,,1467,617
46,46,5,1,7,1,1,1,224,613,1243,4,95, ,0.1278735632183908,0.26417525773195877,,,1467,617
47,47,2,1,8,0,0,0,225,319,1165,339,-1,,0.1221264367816092,0.20983676975945018,,,1390,658
48,48,3,1,8,1,0,0,225,319,1165,339,-1,,0.1221264367816092,0.20983676975945018,,,1390,658
49,49,4,1,8,1,1,0,225,319,889,31,-1,,0.10125529340592862,0.14368556701030927,,,1114,350
50,50,5,1,8,1,1,1,225,324,45,26,96,(12),0.037431941923774956,0.14475945017182132,,,270,350
51,51,5,1,8,1,1,2,577,319,156,26,96,EUROPEAN,0.09906231094978826,0.14261168384879724,,,733,345
52,52,5,1,8,1,1,3,735,320,156,24,95,PATENT,0.12295825771324864,0.14261168384879724,,,891,344
53,53,5,1,8,1,1,4,901,319,213,26,96,APPLICATION,0.15237447065940715,0.14261168384879724,,,1114,345
54,54,4,1,8,1,2,0,225,395,763,26,-1,,0.09172716273442226,0.17525773195876287,,,988,421
55,55,5,1,8,1,2,1,225,395,45,26,95,(43),0.037431941923774956,0.17525773195876287,,,270,421
56,56,5,1,8,1,2,2,286,397,48,18,95,Date,0.04688445251058681,0.17439862542955326,,,334,415
57,57,5,1,8,1,2,3,342,397,20,18,96,of,0.05323653962492438,0.17439862542955326,,,362,415
58,58,5,1,8,1,2,4,370,397,117,23,96,publication:,0.0648064125831821,0.17547250859106528,,,487,420
59,59,5,1,8,1,2,5,862,395,44,26,78,(61),0.1336963097398669,0.17525773195876287,,,906,421
60,60,5,1,8,1,2,6,923,397,25,18,91,Int,0.1414851784633999,0.17439862542955326,,,948,415
61,61,5,1,8,1,2,7,955,397,33,18,73,CL:,0.14692982456140352,0.17439862542955326,,,988,415
62,62,4,1,8,1,3,0,286,425,1104,23,-1,,0.1267392619479734,0.1875,,,1390,448
63,63,5,1,8,1,3,1,286,430,117,18,95,07.11.2018,0.052102238354506954,0.18857388316151202,publication_date,07.11.2018,403,448
64,64,5,1,8,1,3,2,426,430,84,18,95,Bulletin,0.07078039927404718,0.18857388316151202,,,510,448
65,65,5,1,8,1,3,3,519,430,84,18,95,2018/45,0.08484573502722323,0.18857388316151202,,,603,448
66,66,5,1,8,1,3,4,922,428,57,18,76,HO4L,0.14375378100423472,0.1877147766323024,class_international,H04L,979,446
67,67,5,1,8,1,3,5,987,428,59,18,95,29/12,0.15373563218390804,0.1877147766323024,class_international,29/12,1046,446
68,68,5,1,8,1,3,6,1051,425,67,16,70,(2006.07),0.16401996370235936,0.18599656357388317,,,1118,441
69,69,5,1,8,1,3,7,1193,428,57,18,80,HO4L,0.18473986690865093,0.1877147766323024,,,1250,446
70,70,5,1,8,1,3,8,1258,428,59,18,79,29/06,0.19472171808832425,0.1877147766323024,,,1317,446
71,71,5,1,8,1,3,9,1323,425,67,16,80,(2096.07),0.20515728977616454,0.18599656357388317,,,1390,441
72,72,4,1,8,1,4,0,225,493,402,26,-1,,0.06442831215970962,0.21735395189003437,,,627,519
73,73,5,1,8,1,4,1,225,493,45,26,95,(21),0.037431941923774956,0.21735395189003437,,,270,519
74,74,5,1,8,1,4,2,285,495,115,23,96,Application,0.051799758015728975,0.21756872852233677,,,400,518
75,75,5,1,8,1,4,3,410,495,83,18,93,number:,0.06828493647912885,0.21649484536082475,,,493,513
76,76,5,1,8,1,4,4,505,495,122,18,90,18180182.0,0.08560193587416817,0.21649484536082475,application_number,18180182,627,513
77,77,4,1,8,1,5,0,225,559,325,26,-1,,0.05860556563823351,0.24570446735395188,,,550,585
78,78,5,1,8,1,5,1,225,559,45,26,96,(22),0.037431941923774956,0.24570446735395188,,,270,585
79,79,5,1,8,1,5,2,286,561,48,18,96,Date,0.04688445251058681,0.24484536082474226,,,334,579
80,80,5,1,8,1,5,3,342,566,12,13,96,of,0.05263157894736842,0.24591924398625428,,,354,579
81,81,5,1,8,1,5,4,355,561,67,23,95,filing:,0.058756805807622506,0.24591924398625428,,,422,584
82,82,5,1,8,1,5,5,433,561,117,18,96,18.06.2004,0.07433454325468844,0.24484536082474226,filing_date,18.06.2004,550,579
83,83,4,1,8,1,6,0,225,631,787,27,-1,,0.09354204476709013,0.2768470790378007,,,1012,658
84,84,5,1,8,1,6,1,225,631,45,27,96,(84),0.037431941923774956,0.2768470790378007,,,270,658
85,85,5,1,8,1,6,2,286,633,118,23,96,Designated,0.052177858439201454,0.2768470790378007,,,404,656
86,86,5,1,8,1,6,3,413,633,119,23,96,Contracting,0.07146098003629764,0.2768470790378007,,,532,656
87,87,5,1,8,1,6,4,542,633,71,19,96,States:,0.08734119782214156,0.2759879725085911,,,613,652
88,88,5,1,8,1,6,5,898,639,7,7,14,*,0.13634301270417423,0.2759879725085911,,,905,646
89,89,5,1,8,1,6,6,923,633,53,22,95,"Liao,",0.14360254083484575,0.2766323024054983,,,976,655
90,90,5,1,8,1,6,7,983,633,29,19,95,Yu,0.15086206896551724,0.2759879725085911,,,1012,652
91,91,2,1,9,0,0,0,285,666,539,51,-1,,0.0838626739261948,0.2970360824742268,,,824,717
92,92,3,1,9,1,0,0,285,666,539,51,-1,,0.0838626739261948,0.2970360824742268,,,824,717
93,93,4,1,9,1,1,0,285,666,539,18,-1,,0.0838626739261948,0.28994845360824745,,,824,684
94,94,5,1,9,1,1,1,285,666,31,18,74,AT,0.04544767090139141,0.28994845360824745,,,316,684
95,95,5,1,9,1,1,2,324,666,31,18,74,BE,0.05134603750756201,0.28994845360824745,,,355,684
96,96,5,1,9,1,1,3,364,666,33,18,93,BG,0.057546884452510584,0.28994845360824745,,,397,684
97,97,5,1,9,1,1,4,406,666,31,18,95,CH,0.06374773139745916,0.28994845360824745,,,437,684
98,98,5,1,9,1,1,5,447,666,31,18,95,CY,0.06994857834240774,0.28994845360824745,,,478,684
99,99,5,1,9,1,1,6,486,666,30,18,93,CZ,0.07577132486388385,0.28994845360824745,,,516,684
100,100,5,1,9,1,1,7,525,666,30,18,93,DE,0.08166969147005444,0.28994845360824745,,,555,684
101,101,5,1,9,1,1,8,565,666,32,18,94,DK,0.08787053841500303,0.28994845360824745,,,597,684
102,102,5,1,9,1,1,9,605,666,29,18,88,EE,0.09369328493647913,0.28994845360824745,,,634,684
103,103,5,1,9,1,1,10,644,666,29,18,62,ES,0.09959165154264973,0.28994845360824745,,,673,684
104,104,5,1,9,1,1,11,682,666,99,18,62,FIFRGB,0.11063218390804598,0.28994845360824745,,,781,684
105,105,5,1,9,1,1,12,789,666,35,18,96,GR,0.1219751966122202,0.28994845360824745,,,824,684
106,106,4,1,9,1,2,0,286,699,501,18,-1,,0.08114035087719298,0.30412371134020616,,,787,717
107,107,5,1,9,1,2,1,286,699,31,18,65,HU,0.0455989110707804,0.30412371134020616,,,317,717
108,108,5,1,9,1,2,2,327,699,20,18,65,IE,0.05096793708408953,0.30412371134020616,,,347,717
109,109,5,1,9,1,2,3,357,699,18,18,75,IT,0.05535390199637023,0.30412371134020616,,,375,717
110,110,5,1,9,1,2,4,385,699,56,18,75,LILU,0.06246218995765275,0.30412371134020616,,,441,717
111,111,5,1,9,1,2,5,451,699,34,18,93,MC,0.07078039927404718,0.30412371134020616,,,485,717
112,112,5,1,9,1,2,6,494,699,29,18,93,NL,0.07690562613430127,0.30412371134020616,,,523,717
113,113,5,1,9,1,2,7,533,699,28,18,96,PL,0.08272837265577737,0.30412371134020616,,,561,717
114,114,5,1,9,1,2,8,570,699,29,18,95,PT,0.08839987900786449,0.30412371134020616,,,599,717
115,115,5,1,9,1,2,9,607,699,33,18,94,RO,0.09429824561403509,0.30412371134020616,,,640,717
116,116,5,1,9,1,2,10,649,699,30,18,94,SE,0.10042347247428918,0.30412371134020616,,,679,717
117,117,5,1,9,1,2,11,688,699,61,18,0,SISK,0.10866606170598911,0.30412371134020616,,,749,717
118,118,5,1,9,1,2,12,756,699,31,18,0,TR,0.11668179068360557,0.30412371134020616,,,787,717
119,119,2,1,10,0,0,0,225,763,411,26,-1,,0.06510889292196008,0.3333333333333333,,,636,789
120,120,3,1,10,1,0,0,225,763,411,26,-1,,0.06510889292196008,0.3333333333333333,,,636,789
121,121,4,1,10,1,1,0,225,763,411,26,-1,,0.06510889292196008,0.3333333333333333,,,636,789
122,122,5,1,10,1,1,1,225,763,45,26,95,(30),0.037431941923774956,0.3333333333333333,,,270,789
123,123,5,1,10,1,1,2,286,765,77,23,94,Priority:,0.04907743496672716,0.3335481099656357,,,363,788
124,124,5,1,10,1,1,3,383,765,118,18,94,23.06.2003,0.06684815486993345,0.3324742268041237,priority_date_eu,23.06.2003,501,783
125,125,5,1,10,1,1,4,520,765,30,18,96,US,0.0809134906231095,0.3324742268041237,,,550,783
126,126,5,1,10,1,1,5,559,765,77,18,96,602846,0.09036600120992136,0.3324742268041237,,,636,783
127,127,2,1,11,0,0,0,225,828,596,86,-1,,0.07909860859044163,0.3741408934707904,,,821,914
128,128,3,1,11,1,0,0,225,828,596,86,-1,,0.07909860859044163,0.3741408934707904,,,821,914
129,129,4,1,11,1,1,0,225,828,596,26,-1,,0.07909860859044163,0.36125429553264604,,,821,854
130,130,5,1,11,1,1,1,225,828,45,26,96,(62),0.037431941923774956,0.36125429553264604,,,270,854
131,131,5,1,11,1,1,2,286,830,107,18,96,Document,0.05134603750756201,0.3603951890034364,,,393,848
132,132,5,1,11,1,1,3,402,830,105,23,96,number(s),0.06873865698729582,0.36146907216494845,,,507,853
133,133,5,1,11,1,1,4,516,830,20,18,96,of,0.07955232909860858,0.3603951890034364,,,536,848
134,134,5,1,11,1,1,5,542,830,32,18,96,the,0.08439201451905626,0.3603951890034364,,,574,848
135,135,5,1,11,1,1,6,582,830,66,18,95,earlier,0.09301270417422867,0.3603951890034364,,,648,848
136,136,5,1,11,1,1,7,655,830,140,23,96,application(s),0.10964912280701754,0.36146907216494845,,,795,853
137,137,5,1,11,1,1,8,805,830,16,18,96,in,0.12295825771324864,0.3603951890034364,,,821,848
138,138,4,1,11,1,2,0,286,863,308,18,-1,,0.06654567453115548,0.3745704467353952,,,594,881
139,139,5,1,11,1,2,1,286,863,121,18,96,accordance,0.05240471869328494,0.3745704467353952,,,407,881
140,140,5,1,11,1,2,2,415,863,40,18,96,with,0.06578947368421052,0.3745704467353952,,,455,881
141,141,5,1,11,1,2,3,464,863,35,18,95,Art.,0.07282214156079855,0.3745704467353952,,,499,881
142,142,5,1,11,1,2,4,508,863,25,18,95,76,0.07872050816696914,0.3745704467353952,,,533,881
143,143,5,1,11,1,2,5,542,863,52,18,96,EPC:,0.08590441621294616,0.3745704467353952,,,594,881
144,144,4,1,11,1,3,0,286,895,250,19,-1,,0.06215970961887477,0.38853092783505155,,,536,914
145,145,5,1,11,1,3,1,286,895,138,19,46,04777068.0/,0.05369026013309135,0.38853092783505155,,,424,914
146,146,5,1,11,1,3,2,433,895,8,19,94,1,0.06609195402298851,0.38853092783505155,,,441,914
147,147,5,1,11,1,3,3,452,895,37,19,90,636,0.07115849969751967,0.38853092783505155,,,489,914
148,148,5,1,11,1,3,4,498,895,38,19,90,714,0.07819116757410768,0.38853092783505155,,,536,914
149,149,2,1,12,0,0,0,225,959,430,58,-1,,0.06654567453115548,0.42439862542955326,,,655,1017
150,150,3,1,12,1,0,0,225,959,430,58,-1,,0.06654567453115548,0.42439862542955326,,,655,1017
151,151,4,1,12,1,1,0,225,959,430,27,-1,,0.06654567453115548,0.4177405498281787,,,655,986
152,152,5,1,12,1,1,1,225,959,45,27,96,(71),0.037431941923774956,0.4177405498281787,,,270,986
153,153,5,1,12,1,1,2,285,961,103,23,96,Applicant:,0.05089231699939504,0.4177405498281787,,,388,984
154,154,5,1,12,1,1,3,397,961,63,19,94,Cisco,0.0648064125831821,0.4168814432989691,applicant_line_1,Cisco,460,980
155,155,5,1,12,1,1,4,468,961,133,23,96,"Technology,",0.080837870538415,0.4177405498281787,applicant_line_1,"Technology,",601,984
156,156,5,1,12,1,1,5,603,961,52,22,96,Inc.,0.09513006654567453,0.4175257731958763,applicant_line_1,Inc.,655,983
157,157,4,1,12,1,2,0,286,994,339,23,-1,,0.06888989715668481,0.4319158075601375,,,625,1017
158,158,5,1,12,1,2,1,286,994,40,18,96,San,0.04627949183303085,0.43084192439862545,,,326,1012
159,159,5,1,12,1,2,2,336,994,59,22,95,"Jose,",0.05527828191167574,0.43170103092783507,,,395,1016
160,160,5,1,12,1,2,3,404,994,33,18,96,CA,0.06359649122807018,0.43084192439862545,,,437,1012
161,161,5,1,12,1,2,4,444,994,126,18,94,95134-1706,0.07667876588021778,0.43084192439862545,,,570,1012
162,162,5,1,12,1,2,5,579,994,46,23,96,(US),0.0910465819721718,0.4319158075601375,,,625,1017
163,163,2,1,13,0,0,0,225,1057,348,91,-1,,0.0603448275862069,0.4735824742268041,,,573,1148
164,164,3,1,13,1,0,0,225,1057,348,91,-1,,0.0603448275862069,0.4735824742268041,,,573,1148
165,165,4,1,13,1,1,0,225,1057,163,27,-1,,0.046355111917725345,0.45983676975945015,,,388,1084
166,166,5,1,13,1,1,1,225,1057,45,27,93,(72),0.037431941923774956,0.45983676975945015,,,270,1084
167,167,5,1,13,1,1,2,286,1059,102,19,93,Inventors:,0.05096793708408953,0.45897766323024053,,,388,1078
168,168,4,1,13,1,2,0,262,1092,309,22,-1,,0.06299153055051422,0.4737972508591065,,,571,1114
169,169,5,1,13,1,2,1,262,1097,7,8,73,*,0.04015426497277677,0.4729381443298969,,,269,1105
170,170,5,1,13,1,2,2,286,1092,199,18,96,"BHATTACHARYA,",0.058303085299455534,0.4729381443298969,inventor_line_1,"BHATTACHARYA,",485,1110
171,171,5,1,13,1,2,3,487,1092,84,22,96,Partha,0.08000604960677556,0.4737972508591065,inventor_line_1,Partha,571,1114
172,172,4,1,13,1,3,0,286,1125,287,23,-1,,0.06495765275257108,0.4881872852233677,,,573,1148
173,173,5,1,13,1,3,1,286,1125,116,23,96,"Cupertino,",0.05202661826981246,0.4881872852233677,,,402,1148
174,174,5,1,13,1,3,2,411,1125,33,19,96,CA,0.06465517241379311,0.48732817869415807,,,444,1144
175,175,5,1,13,1,3,3,452,1125,66,19,95,95014,0.07335148215366001,0.48732817869415807,,,518,1144
176,176,5,1,13,1,3,4,526,1125,47,23,96,(US),0.08310647307924984,0.4881872852233677,,,573,1148
177,177,2,1,14,0,0,0,844,614,4,566,-1,,0.1279491833030853,0.3853092783505155,,,848,1180
178,178,3,1,14,1,0,0,844,614,4,566,-1,,0.1279491833030853,0.3853092783505155,,,848,1180
179,179,4,1,14,1,1,0,844,614,4,566,-1,,0.1279491833030853,0.3853092783505155,,,848,1180
180,180,5,1,14,1,1,1,844,614,4,566,95, ,0.1279491833030853,0.3853092783505155,,,848,1180
181,181,2,1,15,0,0,0,922,666,279,23,-1,,0.16054143980641258,0.29102233676975947,,,1201,689
182,182,3,1,15,1,0,0,922,666,279,23,-1,,0.16054143980641258,0.29102233676975947,,,1201,689
183,183,4,1,15,1,1,0,922,666,279,23,-1,,0.16054143980641258,0.29102233676975947,,,1201,689
184,184,5,1,15,1,1,1,922,666,41,18,94,San,0.1425438596491228,0.28994845360824745,,,963,684
185,185,5,1,15,1,1,2,972,666,59,22,94,"Jose,",0.1514670296430732,0.29080756013745707,,,1031,688
186,186,5,1,15,1,1,3,1040,666,33,18,94,CA,0.15978523895946764,0.28994845360824745,,,1073,684
187,187,5,1,15,1,1,4,1080,666,63,18,66,95131,0.16810344827586207,0.28994845360824745,,,1143,684
188,188,5,1,15,1,1,5,1154,666,47,23,96,(US),0.1780852994555354,0.29102233676975947,,,1201,689
189,189,2,1,16,0,0,0,862,730,597,188,-1,,0.17551421657592256,0.3539518900343643,,,1459,918
190,190,3,1,16,1,0,0,862,730,597,188,-1,,0.17551421657592256,0.3539518900343643,,,1459,918
191,191,4,1,16,1,1,0,862,730,597,26,-1,,0.17551421657592256,0.31915807560137455,,,1459,756
192,192,5,1,16,1,1,1,862,730,44,26,96,(74),0.1336963097398669,0.31915807560137455,,,906,756
193,193,5,1,16,1,1,2,923,732,163,23,96,Representative:,0.15192075015124018,0.31937285223367695,,,1086,755
194,194,5,1,16,1,1,3,1096,732,83,22,96,"Coates,",0.1720356926799758,0.31915807560137455,representative_line_1_eu,"Coates,",1179,754
195,195,5,1,16,1,1,4,1189,732,75,18,96,Robert,0.18549606775559588,0.31829896907216493,representative_line_1_eu,Robert,1264,750
196,196,5,1,16,1,1,5,1270,732,74,18,96,James,0.19767090139140955,0.31829896907216493,representative_line_1_eu,James,1344,750
197,197,5,1,16,1,1,6,1352,732,107,18,96,Patterson,0.21256805807622506,0.31829896907216493,representative_line_1_eu,Patterson,1459,750
198,198,4,1,16,1,2,0,922,765,45,18,-1,,0.14284633998790078,0.3324742268041237,,,967,783
199,199,5,1,16,1,2,1,922,765,20,18,93,et,0.14095583787053842,0.3324742268041237,,,942,783
200,200,5,1,16,1,2,2,949,765,18,18,93,al,0.14488808227465214,0.3324742268041237,,,967,783
201,201,4,1,16,1,3,0,923,797,238,19,-1,,0.15759225650332728,0.34643470790378006,,,1161,816
202,202,5,1,16,1,3,1,923,797,80,19,93,Kilburn,0.1456442831215971,0.34643470790378006,,,1003,816
203,203,5,1,16,1,3,2,1012,797,16,19,93,&,0.1542649727767695,0.34643470790378006,,,1028,816
204,204,5,1,16,1,3,3,1036,797,74,19,96,Strode,0.16228070175438597,0.34643470790378006,,,1110,816
205,205,5,1,16,1,3,4,1119,797,42,19,96,LLP,0.1724137931034483,0.34643470790378006,,,1161,816
206,206,4,1,16,1,4,0,923,830,161,18,-1,,0.15176950998185118,0.3603951890034364,,,1084,848
207,207,5,1,16,1,4,1,923,830,67,18,96,Lacon,0.14466122202056866,0.3603951890034364,,,990,848
208,208,5,1,16,1,4,2,999,830,85,18,95,London,0.15751663641863278,0.3603951890034364,,,1084,848
209,209,4,1,16,1,5,0,922,863,216,18,-1,,0.1557773744706594,0.3745704467353952,,,1138,881
210,210,5,1,16,1,5,1,922,863,25,18,93,84,0.1413339382940109,0.3745704467353952,,,947,881
211,211,5,1,16,1,5,2,955,863,118,18,92,Theobalds,0.15335753176043557,0.3745704467353952,,,1073,881
212,212,5,1,16,1,5,3,1082,863,56,18,96,Road,0.16787658802177857,0.3745704467353952,,,1138,881
213,213,4,1,16,1,6,0,923,895,270,23,-1,,0.1600120992135511,0.3893900343642612,,,1193,918
214,214,5,1,16,1,6,1,923,895,84,19,93,London,0.14594676346037508,0.38853092783505155,,,1007,914
215,215,5,1,16,1,6,2,1015,895,69,19,84,WC1X,0.1587265577737447,0.38853092783505155,,,1084,914
216,216,5,1,16,1,6,3,1092,895,28,19,91,8NL,0.16727162734422263,0.38853092783505155,,,1120,914
217,217,5,1,16,1,6,4,1123,895,70,23,96,(GB),0.1751361161524501,0.3893900343642612,,,1193,918
218,218,2,1,17,0,0,0,862,961,99,19,-1,,0.13785541439806412,0.4168814432989691,,,961,980
219,219,3,1,17,1,0,0,862,961,99,19,-1,,0.13785541439806412,0.4168814432989691,,,961,980
220,220,4,1,17,1,1,0,862,961,99,19,-1,,0.13785541439806412,0.4168814432989691,,,961,980
221,221,5,1,17,1,1,1,862,961,99,19,96,Remarks:,0.13785541439806412,0.4168814432989691,,,961,980
222,222,2,1,18,0,0,0,922,994,522,84,-1,,0.17891712038717483,0.44501718213058417,,,1444,1078
223,223,3,1,18,1,0,0,922,994,522,84,-1,,0.17891712038717483,0.44501718213058417,,,1444,1078
224,224,4,1,18,1,1,0,922,994,477,23,-1,,0.17551421657592256,0.4319158075601375,,,1399,1017
225,225,5,1,18,1,1,1,922,994,43,18,96,This,0.1426950998185118,0.43084192439862545,,,965,1012
226,226,5,1,18,1,1,2,974,994,111,23,96,application,0.15570175438596492,0.4319158075601375,,,1085,1017
227,227,5,1,18,1,1,3,1093,999,42,13,96,was,0.16848154869933454,0.4319158075601375,,,1135,1012
228,228,5,1,18,1,1,4,1142,994,43,18,96,filed,0.17596793708408953,0.43084192439862545,,,1185,1012
229,229,5,1,18,1,1,5,1193,999,25,13,96,on,0.1823200241984271,0.4319158075601375,,,1218,1012
230,230,5,1,18,1,1,6,1226,994,121,18,96,27-06-2018,0.19457047791893528,0.43084192439862545,,,1347,1012
231,231,5,1,18,1,1,7,1355,999,24,13,95,as,0.20674531155474893,0.4319158075601375,,,1379,1012
232,232,5,1,18,1,1,8,1387,999,12,13,95,a,0.21067755595886267,0.4319158075601375,,,1399,1012
233,233,4,1,18,1,2,0,922,1027,522,23,-1,,0.17891712038717483,0.44609106529209624,,,1444,1050
234,234,5,1,18,1,2,1,922,1027,96,18,95,divisional,0.14670296430732002,0.44501718213058417,,,1018,1045
235,235,5,1,18,1,2,2,1027,1027,111,23,96,application,0.16371748336358136,0.44609106529209624,,,1138,1050
236,236,5,1,18,1,2,3,1147,1027,19,18,96,to,0.17490925589836662,0.44501718213058417,,,1166,1045
237,237,5,1,18,1,2,4,1174,1027,31,18,96,the,0.17990018148820328,0.44501718213058417,,,1205,1045
238,238,5,1,18,1,2,5,1214,1027,112,23,96,application,0.19207501512401695,0.44609106529209624,,,1326,1050
239,239,5,1,18,1,2,6,1336,1027,108,18,96,mentioned,0.2102238354506957,0.44501718213058417,,,1444,1045
240,240,4,1,18,1,3,0,923,1059,209,19,-1,,0.15539927404718692,0.45897766323024053,,,1132,1078
241,241,5,1,18,1,3,1,923,1059,59,19,93,under,0.1440562613430127,0.45897766323024053,,,982,1078
242,242,5,1,18,1,3,2,991,1059,45,19,91,INID,0.15328191167574107,0.45897766323024053,,,1036,1078
243,243,5,1,18,1,3,3,1044,1059,50,19,96,code,0.16167574107683,0.45897766323024053,,,1094,1078
244,244,5,1,18,1,3,4,1103,1059,29,19,96,62.,0.16901088929219601,0.45897766323024053,,,1132,1078
245,245,2,1,19,0,0,0,224,1177,1243,4,-1,,0.1278735632183908,0.5064432989690721,,,1467,1181
246,246,3,1,19,1,0,0,224,1177,1243,4,-1,,0.1278735632183908,0.5064432989690721,,,1467,1181
247,247,4,1,19,1,1,0,224,1177,1243,4,-1,,0.1278735632183908,0.5064432989690721,,,1467,1181
248,248,5,1,19,1,1,1,224,1177,1243,4,95, ,0.1278735632183908,0.5064432989690721,,,1467,1181
249,249,2,1,20,0,0,0,225,1198,1154,133,-1,,0.12129461584996976,0.5431701030927835,,,1379,1331
250,250,3,1,20,1,0,0,225,1198,1154,133,-1,,0.12129461584996976,0.5431701030927835,,,1379,1331
251,251,4,1,20,1,1,0,225,1198,1154,26,-1,,0.12129461584996976,0.5201890034364262,,,1379,1224
252,252,5,1,20,1,1,1,225,1198,45,26,87,(54),0.037431941923774956,0.5201890034364262,,,270,1224
253,253,5,1,20,1,1,2,316,1198,112,21,87,METHOD,0.056261343012704176,0.5191151202749141,title_line_1,METHOD,428,1219
254,254,5,1,20,1,1,3,437,1198,56,20,96,AND,0.07032667876588022,0.5189003436426117,title_line_1,AND,493,1218
255,255,5,1,20,1,1,4,503,1198,106,21,96,SYSTEM,0.08408953418027829,0.5191151202749141,title_line_1,SYSTEM,609,1219
256,256,5,1,20,1,1,5,620,1198,54,21,95,FOR,0.09785238959467635,0.5191151202749141,title_line_1,FOR,674,1219
257,257,5,1,20,1,1,6,684,1198,182,21,93,DETERMINING,0.11721113127646703,0.5191151202749141,title_line_1,DETERMINING,866,1219
258,258,5,1,20,1,1,7,877,1198,204,21,90,INTRA-SESSION,0.14806412583182094,0.5191151202749141,title_line_1,INTRA-SESSION,1081,1219
259,259,5,1,20,1,1,8,1093,1198,86,20,96,EVENT,0.17180883242589232,0.5189003436426117,title_line_1,EVENT,1179,1218
260,260,5,1,20,1,1,9,1188,1198,191,21,95,CORRELATION,0.1941167574107683,0.5191151202749141,title_line_1,CORRELATION,1379,1219
261,261,4,1,20,1,2,0,315,1230,715,21,-1,,0.10170901391409558,0.532860824742268,,,1030,1251
262,262,5,1,20,1,2,1,315,1230,112,21,96,ACROSS,0.056110102843315184,0.532860824742268,,,427,1251
263,263,5,1,20,1,2,2,438,1230,134,21,95,NETWORK,0.07637628554143981,0.532860824742268,,,572,1251
264,264,5,1,20,1,2,3,580,1230,129,21,95,ADDRESS,0.09747428917120388,0.532860824742268,,,709,1251
265,265,5,1,20,1,2,4,718,1230,187,21,95,TRANSLATION,0.12273139745916516,0.532860824742268,,,905,1251
266,266,5,1,20,1,2,5,917,1230,113,21,96,DEVICES,0.1472323049001815,0.532860824742268,,,1030,1251
267,267,4,1,20,1,3,0,225,1304,582,27,-1,,0.0780399274047187,0.5659364261168385,,,807,1331
268,268,5,1,20,1,3,1,225,1304,45,27,91,(57),0.037431941923774956,0.5659364261168385,,,270,1331
269,269,5,1,20,1,3,2,315,1306,15,19,0,An,0.04877495462794918,0.5650773195876289,,,330,1325
270,270,5,1,20,1,3,3,332,1306,151,19,52,intra-session,0.06163036902601331,0.5650773195876289,,,483,1325
271,271,5,1,20,1,3,4,492,1307,70,18,96,network,0.07970356926799758,0.5652920962199313,,,562,1325
272,272,5,1,20,1,3,5,564,1306,126,19,95,correlation,0.09482758620689655,0.5650773195876289,,,690,1325
273,273,5,1,20,1,3,6,698,1307,73,22,93,system,0.11108590441621295,0.5661512027491409,,,771,1329
274,274,5,1,20,1,3,7,780,1311,27,14,92,re-,0.12000907441016334,0.5661512027491409,,,807,1325
275,275,2,1,21,0,0,0,224,1339,583,412,-1,,0.0779643073200242,0.663659793814433,,,807,1751
276,276,3,1,21,1,0,0,224,1339,583,412,-1,,0.0779643073200242,0.663659793814433,,,807,1751
277,277,4,1,21,1,1,0,225,1339,581,23,-1,,0.0779643073200242,0.5801116838487973,,,806,1362
278,278,5,1,21,1,1,1,225,1339,66,18,92,ceives,0.03901996370235935,0.5790378006872853,,,291,1357
279,279,5,1,21,1,1,2,299,1344,11,13,96,a,0.046052631578947366,0.5801116838487973,,,310,1357
280,280,5,1,21,1,1,3,318,1340,71,17,96,stream,0.05346339987900786,0.5792525773195877,,,389,1357
281,281,5,1,21,1,1,4,397,1339,20,18,96,of,0.061554748941318814,0.5790378006872853,,,417,1357
282,282,5,1,21,1,1,5,424,1339,82,18,96,network,0.07032667876588022,0.5790378006872853,,,506,1357
283,283,5,1,21,1,1,6,513,1340,69,17,96,events,0.08280399274047187,0.5792525773195877,,,582,1357
284,284,5,1,21,1,1,7,589,1339,38,18,96,and,0.09195402298850575,0.5790378006872853,,,627,1357
285,285,5,1,21,1,1,8,635,1339,45,18,96,then,0.09944041137326073,0.5790378006872853,,,680,1357
286,286,5,1,21,1,1,9,688,1344,60,18,96,group,0.10859044162129462,0.5811855670103093,,,748,1362
287,287,5,1,21,1,1,10,755,1339,51,18,96,them,0.11804295220810647,0.5790378006872853,,,806,1357
288,288,4,1,21,1,2,0,226,1372,581,23,-1,,0.07811554748941318,0.594286941580756,,,807,1395
289,289,5,1,21,1,2,1,226,1372,36,19,96,into,0.03690260133091349,0.5934278350515464,,,262,1391
290,290,5,1,21,1,2,2,269,1372,86,19,92,different,0.047186932849364795,0.5934278350515464,,,355,1391
291,291,5,1,21,1,2,3,363,1372,82,19,96,network,0.06110102843315184,0.5934278350515464,,,445,1391
292,292,5,1,21,1,2,4,452,1372,78,19,96,session,0.07425892316999395,0.5934278350515464,,,530,1391
293,293,5,1,21,1,2,5,539,1372,101,23,96,according,0.08915607985480943,0.594286941580756,,,640,1395
294,294,5,1,21,1,2,6,649,1373,18,18,97,to,0.09951603145795523,0.5936426116838488,,,667,1391
295,295,5,1,21,1,2,7,675,1372,49,19,96,each,0.10579249848759831,0.5934278350515464,,,724,1391
296,296,5,1,21,1,2,8,734,1372,73,19,0,event's,0.11653055051421658,0.5934278350515464,,,807,1391
297,297,4,1,21,1,3,0,225,1405,582,23,-1,,0.0780399274047187,0.6084621993127147,,,807,1428
298,298,5,1,21,1,3,1,225,1406,57,17,96,event,0.03833938294010889,0.6076030927835051,,,282,1423
299,299,5,1,21,1,3,2,295,1406,118,22,96,parameters,0.05353901996370236,0.6086769759450171,,,413,1428
300,300,5,1,21,1,3,3,424,1405,38,18,96,and,0.06699939503932244,0.6073883161512027,,,462,1423
301,301,5,1,21,1,3,4,475,1405,31,18,96,the,0.07418330308529945,0.6073883161512027,,,506,1423
302,302,5,1,21,1,3,5,519,1405,149,23,96,corresponding,0.0897610405323654,0.6084621993127147,,,668,1428
303,303,5,1,21,1,3,6,681,1405,82,18,93,network,0.10919540229885058,0.6073883161512027,,,763,1423
304,304,5,1,21,1,3,7,774,1405,33,18,92,ad-,0.11955535390199637,0.6073883161512027,,,807,1423
305,305,4,1,21,1,4,0,225,1438,582,23,-1,,0.0780399274047187,0.6226374570446735,,,807,1461
306,306,5,1,21,1,4,1,225,1438,57,18,95,dress,0.03833938294010889,0.6215635738831615,,,282,1456
307,307,5,1,21,1,4,2,295,1438,109,18,95,translation,0.052858439201451904,0.6215635738831615,,,404,1456
308,308,5,1,21,1,4,3,418,1438,62,23,96,(NAT),0.06790683605565638,0.6226374570446735,,,480,1461
309,309,5,1,21,1,4,4,496,1438,121,18,96,information.,0.08416515426497277,0.6215635738831615,,,617,1456
310,310,5,1,21,1,4,5,631,1438,28,18,96,An,0.09754990925589836,0.6215635738831615,,,659,1456
311,311,5,1,21,1,4,6,673,1439,58,17,96,event,0.10617059891107078,0.6217783505154639,,,731,1456
312,312,5,1,21,1,4,7,746,1438,15,18,96,in,0.11395946763460375,0.6215635738831615,,,761,1456
313,313,5,1,21,1,4,8,775,1438,32,18,96,the,0.11963097398669087,0.6215635738831615,,,807,1456
314,314,4,1,21,1,5,0,225,1470,582,23,-1,,0.0780399274047187,0.6363831615120275,,,807,1493
315,315,5,1,21,1,5,1,225,1471,51,18,96,stream,0.03788566243194193,0.6357388316151202,,,276,1489
316,316,5,1,21,1,5,2,279,1470,40,19,93,is,0.04522081064730792,0.6355240549828178,,,319,1489
317,317,5,1,21,1,5,3,324,1470,39,19,93,first,0.05195099818511797,0.6355240549828178,,,363,1489
318,318,5,1,21,1,5,4,369,1470,89,19,96,matched,0.06253781004234725,0.6355240549828178,,,458,1489
319,319,5,1,21,1,5,5,465,1470,76,23,96,against,0.07607380520266183,0.6363831615120275,,,541,1493
320,320,5,1,21,1,5,6,547,1475,38,18,96,any,0.08560193587416817,0.6374570446735395,,,585,1493
321,321,5,1,21,1,5,7,590,1470,79,23,96,existing,0.09520568663036903,0.6363831615120275,,,669,1493
322,322,5,1,21,1,5,8,676,1470,85,22,96,"session,",0.10866606170598911,0.636168384879725,,,761,1492
323,323,5,1,21,1,5,9,769,1470,38,19,96,and,0.1191772534785239,0.6355240549828178,,,807,1489
324,324,4,1,21,1,6,0,225,1503,582,23,-1,,0.0780399274047187,0.6505584192439863,,,807,1526
325,325,5,1,21,1,6,1,225,1503,44,18,96,then,0.03735632183908046,0.6494845360824743,,,269,1521
326,326,5,1,21,1,6,2,278,1503,120,23,96,categorized,0.051119177253478525,0.6505584192439863,,,398,1526
327,327,5,1,21,1,6,3,408,1503,54,23,96,using,0.06578947368421052,0.6505584192439863,,,462,1526
328,328,5,1,21,1,6,4,470,1503,32,18,96,the,0.073502722323049,0.6494845360824743,,,502,1521
329,329,5,1,21,1,6,5,511,1503,115,18,96,information,0.08598003629764066,0.6494845360824743,,,626,1521
330,330,5,1,21,1,6,6,634,1503,60,18,96,about,0.10042347247428918,0.6494845360824743,,,694,1521
331,331,5,1,21,1,6,7,700,1508,12,13,96,a,0.10677555958862674,0.6505584192439863,,,712,1521
332,332,5,1,21,1,6,8,721,1503,46,18,93,NAT,0.11252268602540835,0.6494845360824743,,,767,1521
333,333,5,1,21,1,6,9,774,1503,33,18,92,de-,0.11955535390199637,0.6494845360824743,,,807,1521
334,334,4,1,21,1,7,0,225,1536,581,23,-1,,0.0779643073200242,0.664733676975945,,,806,1559
335,335,5,1,21,1,7,1,225,1536,41,18,96,vice,0.03712946158499698,0.663659793814433,,,266,1554
336,336,5,1,21,1,7,2,276,1536,40,18,96,that,0.04476709013914096,0.663659793814433,,,316,1554
337,337,5,1,21,1,7,3,325,1536,102,18,95,translates,0.056866303690260134,0.663659793814433,,,427,1554
338,338,5,1,21,1,7,4,437,1540,12,14,96,a,0.06699939503932244,0.6645189003436426,,,449,1554
339,339,5,1,21,1,7,5,461,1540,94,19,95,message,0.07683000604960677,0.6655927835051546,,,555,1559
340,340,5,1,21,1,7,6,565,1536,32,18,96,the,0.08787053841500303,0.663659793814433,,,597,1554
341,341,5,1,21,1,7,7,607,1540,50,14,96,event,0.0955837870538415,0.6645189003436426,,,657,1554
342,342,5,1,21,1,7,8,658,1536,32,18,96,is,0.10193587416817906,0.663659793814433,,,690,1554
343,343,5,1,21,1,7,9,700,1536,71,18,96,related,0.11123714458560194,0.663659793814433,,,771,1554
344,344,5,1,21,1,7,10,782,1536,24,18,96,to.,0.12008469449485784,0.663659793814433,,,806,1554
345,345,4,1,21,1,8,0,226,1569,581,23,-1,,0.07811554748941318,0.6789089347079038,,,807,1592
346,346,5,1,21,1,8,1,226,1569,72,23,96,"Finally,",0.039624924379915306,0.6789089347079038,,,298,1592
347,347,5,1,21,1,8,2,306,1570,18,17,92,at,0.04764065335753176,0.6780498281786942,,,324,1587
348,348,5,1,21,1,8,3,330,1574,11,13,92,a,0.05074107683000605,0.6789089347079038,,,341,1587
349,349,5,1,21,1,8,4,349,1569,110,23,96,predefined,0.06110102843315184,0.6789089347079038,,,459,1592
350,350,5,1,21,1,8,5,466,1569,49,22,96,"time,",0.07418330308529945,0.6786941580756014,,,515,1591
351,351,5,1,21,1,8,6,523,1574,11,13,95,a,0.07993042952208107,0.6789089347079038,,,534,1587
352,352,5,1,21,1,8,7,541,1569,121,23,95,categorized,0.09097096188747732,0.6789089347079038,,,662,1592
353,353,5,1,21,1,8,8,668,1574,51,13,96,event,0.10488505747126436,0.6789089347079038,,,719,1587
354,354,5,1,21,1,8,9,720,1569,28,18,93,is,0.11101028433151845,0.6778350515463918,,,748,1587
355,355,5,1,21,1,8,10,755,1574,52,18,92,proc-,0.11811857229280097,0.6799828178694158,,,807,1592
356,356,4,1,21,1,9,0,225,1602,582,23,-1,,0.0780399274047187,0.6930841924398625,,,807,1625
357,357,5,1,21,1,9,1,225,1606,48,14,96,essed,0.03765880217785844,0.6928694158075601,,,273,1620
358,358,5,1,21,1,9,2,275,1602,37,18,96,to,0.04438898971566848,0.6920103092783505,,,312,1620
359,359,5,1,21,1,9,3,320,1602,72,23,96,identify,0.05384150030248034,0.6930841924398625,,,392,1625
360,360,5,1,21,1,9,4,399,1602,54,18,96,other,0.06442831215970962,0.6920103092783505,,,453,1620
361,361,5,1,21,1,9,5,459,1602,121,23,96,categorized,0.07856926799758016,0.6930841924398625,,,580,1625
362,362,5,1,21,1,9,6,586,1602,69,18,96,events,0.09384452510586812,0.6920103092783505,,,655,1620
363,363,5,1,21,1,9,7,663,1602,15,18,96,in,0.1014065335753176,0.6920103092783505,,,678,1620
364,364,5,1,21,1,9,8,686,1602,121,18,96,accordance,0.11290078644888082,0.6920103092783505,,,807,1620
365,365,4,1,21,1,10,0,224,1634,583,23,-1,,0.0779643073200242,0.7068298969072165,,,807,1657
366,366,5,1,21,1,10,1,224,1634,41,19,96,with,0.036978221415607984,0.7059707903780069,,,265,1653
367,367,5,1,21,1,10,2,274,1639,11,14,96,a,0.04227162734422263,0.7070446735395189,,,285,1653
368,368,5,1,21,1,10,3,295,1634,46,19,96,NAT,0.04809437386569873,0.7059707903780069,,,341,1653
369,369,5,1,21,1,10,4,350,1639,80,18,96,message,0.05898366606170599,0.7079037800687286,,,430,1657
370,370,5,1,21,1,10,5,433,1639,40,14,96,or,0.06851179673321234,0.7070446735395189,,,473,1653
371,371,5,1,21,1,10,6,481,1639,25,14,95,an,0.07463702359346643,0.7070446735395189,,,506,1653
372,372,5,1,21,1,10,7,514,1634,63,23,96,expiry,0.08250151240169389,0.7068298969072165,,,577,1657
373,373,5,1,21,1,10,8,585,1634,53,19,96,timer,0.09248336358136722,0.7059707903780069,,,638,1653
374,374,5,1,21,1,10,9,646,1634,111,19,96,associated,0.10609497882637628,0.7059707903780069,,,757,1653
375,375,5,1,21,1,10,10,765,1634,42,19,96,with,0.11887477313974591,0.7059707903780069,,,807,1653
376,376,4,1,21,1,11,0,225,1667,582,23,-1,,0.0780399274047187,0.7210051546391752,,,807,1690
377,377,5,1,21,1,11,1,225,1667,31,18,96,the,0.03637326073805203,0.7199312714776632,,,256,1685
378,378,5,1,21,1,11,2,268,1667,121,23,96,categorized,0.049682395644283124,0.7210051546391752,,,389,1690
379,379,5,1,21,1,11,3,401,1668,62,20,96,"event,",0.06533575317604355,0.7207903780068728,,,463,1688
380,380,5,1,21,1,11,4,476,1667,37,18,96,and,0.07478826376285541,0.7199312714776632,,,513,1685
381,381,5,1,21,1,11,5,524,1667,33,18,96,the,0.08174531155474894,0.7199312714776632,,,557,1685
382,382,5,1,21,1,11,6,568,1667,121,23,96,categorized,0.09505444646098003,0.7210051546391752,,,689,1690
383,383,5,1,21,1,11,7,701,1668,57,17,96,event,0.110329703569268,0.7201460481099656,,,758,1685
384,384,5,1,21,1,11,8,769,1667,38,18,96,and,0.1191772534785239,0.7199312714776632,,,807,1685
385,385,4,1,21,1,12,0,226,1700,581,23,-1,,0.07811554748941318,0.7351804123711341,,,807,1723
386,386,5,1,21,1,12,1,226,1700,92,18,96,identified,0.0411373260738052,0.7341065292096219,,,318,1718
387,387,5,1,21,1,12,2,327,1700,54,18,96,other,0.05353901996370236,0.7341065292096219,,,381,1718
388,388,5,1,21,1,12,3,389,1700,120,23,96,categorized,0.06790683605565638,0.7351804123711341,,,509,1723
389,389,5,1,21,1,12,4,518,1700,69,18,96,events,0.08356019358741681,0.7341065292096219,,,587,1718
390,390,5,1,21,1,12,5,595,1704,33,14,96,are,0.09248336358136722,0.7349656357388317,,,628,1718
391,391,5,1,21,1,12,6,636,1700,86,23,96,grouped,0.10269207501512402,0.7351804123711341,,,722,1723
392,392,5,1,21,1,12,7,732,1700,35,18,95,into,0.1133545069570478,0.7341065292096219,,,767,1718
393,393,5,1,21,1,12,8,775,1700,32,18,96,the,0.11963097398669087,0.7341065292096219,,,807,1718
394,394,4,1,21,1,13,0,225,1732,240,19,-1,,0.052177858439201454,0.7480670103092784,,,465,1751
395,395,5,1,21,1,13,1,225,1737,57,14,95,same,0.03833938294010889,0.7491408934707904,,,282,1751
396,396,5,1,21,1,13,2,291,1732,81,19,96,network,0.05013611615245009,0.7480670103092784,,,372,1751
397,397,5,1,21,1,13,3,381,1732,84,19,96,session.,0.06397459165154265,0.7480670103092784,,,465,1751
398,398,2,1,22,0,0,0,893,1334,569,612,-1,,0.1780852994555354,0.7044673539518901,,,1462,1946
399,399,3,1,22,1,0,0,893,1334,569,612,-1,,0.1780852994555354,0.7044673539518901,,,1462,1946
400,400,4,1,22,1,1,0,893,1334,569,612,-1,,0.1780852994555354,0.7044673539518901,,,1462,1946
401,401,5,1,22,1,1,1,893,1334,569,612,95, ,0.1780852994555354,0.7044673539518901,,,1462,1946
402,402,2,1,23,0,0,0,997,1562,5,396,-1,,0.1511645493042952,0.7560137457044673,,,1002,1958
403,403,3,1,23,1,0,0,997,1562,5,396,-1,,0.1511645493042952,0.7560137457044673,,,1002,1958
404,404,4,1,23,1,1,0,997,1562,5,396,-1,,0.1511645493042952,0.7560137457044673,,,1002,1958
405,405,5,1,23,1,1,1,997,1562,5,396,95, ,0.1511645493042952,0.7560137457044673,,,1002,1958
406,406,2,1,24,0,0,0,997,1562,5,396,-1,,0.1511645493042952,0.7560137457044673,,,1002,1958
407,407,3,1,24,1,0,0,997,1562,5,396,-1,,0.1511645493042952,0.7560137457044673,,,1002,1958
408,408,4,1,24,1,1,0,997,1562,5,396,-1,,0.1511645493042952,0.7560137457044673,,,1002,1958
409,409,5,1,24,1,1,1,997,1562,5,396,95, ,0.1511645493042952,0.7560137457044673,,,1002,1958
410,410,2,1,25,0,0,0,1160,2078,56,24,-1,,0.17967332123411978,0.897766323024055,,,1216,2102
411,411,3,1,25,1,0,0,1160,2078,56,24,-1,,0.17967332123411978,0.897766323024055,,,1216,2102
412,412,4,1,25,1,1,0,1160,2078,56,24,-1,,0.17967332123411978,0.897766323024055,,,1216,2102
413,413,5,1,25,1,1,1,1160,2078,38,24,94,Fig.,0.17831215970961886,0.897766323024055,,,1198,2102
414,414,5,1,25,1,1,2,1209,2079,7,18,95,1,0.18337870538415002,0.8969072164948454,,,1216,2097
415,415,2,1,26,0,0,0,716,2270,259,16,-1,,0.1278735632183908,0.9785223367697594,,,975,2286
416,416,3,1,26,1,0,0,716,2270,259,16,-1,,0.1278735632183908,0.9785223367697594,,,975,2286
417,417,4,1,26,1,1,0,716,2270,259,16,-1,,0.1278735632183908,0.9785223367697594,,,975,2286
418,418,5,1,26,1,1,1,716,2270,49,12,96,Printed,0.11199334543254688,0.9776632302405498,,,765,2282
419,419,5,1,26,1,1,2,771,2270,15,16,96,by,0.1177404718693285,0.9785223367697594,,,786,2286
420,420,5,1,26,1,1,3,792,2270,45,14,96,"Jouve,",0.12318511796733213,0.9780927835051546,,,837,2284
421,421,5,1,26,1,1,4,843,2270,41,12,96,75001,0.13059588626739263,0.9776632302405498,,,884,2282
422,422,5,1,26,1,1,5,893,2270,46,12,96,PARIS,0.1385359951603146,0.9776632302405498,,,939,2282
423,423,5,1,26,1,1,6,945,2270,30,16,95,(FR),0.14519056261343014,0.9785223367697594,,,975,2286
