,Unnamed: 0,level,page_num,block_num,par_num,line_num,word_num,left,top,width,height,conf,text,x,y,label,target,right,bottom
0,0,1,1,0,0,0,0,0,0,1653,2328,-1,,0.125,0.5,,,1653,2328
1,1,2,1,1,0,0,0,144,1905,31,328,-1,,0.02412280701754386,0.8887457044673539,,,175,2233
2,2,3,1,1,1,0,0,144,1905,31,328,-1,,0.02412280701754386,0.8887457044673539,,,175,2233
3,3,4,1,1,1,1,0,144,1905,31,328,-1,,0.02412280701754386,0.8887457044673539,,,175,2233
4,4,5,1,1,1,1,1,144,2179,30,54,95,EP,0.024047186932849365,0.947594501718213,number,EP,174,2233
5,5,5,1,1,1,1,2,144,2142,31,21,95,3,0.02412280701754386,0.9246134020618557,number,3,175,2163
6,6,5,1,1,1,1,3,144,2055,31,71,94,399,0.02412280701754386,0.8979810996563574,number,399,175,2126
7,7,5,1,1,1,1,4,144,1969,30,70,92,747,0.024047186932849365,0.8608247422680413,number,747,174,2039
8,8,5,1,1,1,1,5,144,1905,30,50,88,A1,0.024047186932849365,0.8290378006872853,number,A2,174,1955
9,9,2,1,2,0,0,0,429,153,88,28,-1,,0.07153660012099214,0.07173539518900343,,,517,181
10,10,3,1,2,1,0,0,429,153,88,28,-1,,0.07153660012099214,0.07173539518900343,,,517,181
11,11,4,1,2,1,1,0,429,153,88,16,-1,,0.07153660012099214,0.06915807560137457,,,517,169
12,12,5,1,2,1,1,1,429,153,88,16,84,Europaisches,0.07153660012099214,0.06915807560137457,,,517,169
13,13,4,1,2,1,2,0,429,170,71,11,-1,,0.07025105868118572,0.07538659793814433,,,500,181
14,14,5,1,2,1,2,1,429,170,71,11,96,Patentamt,0.07025105868118572,0.07538659793814433,,,500,181
15,15,2,1,3,0,0,0,221,136,334,150,-1,,0.05868118572292801,0.09063573883161512,,,555,286
16,16,3,1,3,1,0,0,221,136,334,150,-1,,0.05868118572292801,0.09063573883161512,,,555,286
17,17,4,1,3,1,1,0,221,136,334,150,-1,,0.05868118572292801,0.09063573883161512,,,555,286
18,18,5,1,3,1,1,1,221,136,334,150,95, ,0.05868118572292801,0.09063573883161512,,,555,286
19,19,2,1,4,0,0,0,224,664,1243,2,-1,,0.1278735632183908,0.2856529209621993,,,1467,666
20,20,3,1,4,1,0,0,224,664,1243,2,-1,,0.1278735632183908,0.2856529209621993,,,1467,666
21,21,4,1,4,1,1,0,224,664,1243,2,-1,,0.1278735632183908,0.2856529209621993,,,1467,666
22,22,5,1,4,1,1,1,224,664,1243,2,95, ,0.1278735632183908,0.2856529209621993,,,1467,666
23,23,2,1,5,0,0,0,227,328,1,605,-1,,0.03440713853599516,0.2708333333333333,,,228,933
24,24,3,1,5,1,0,0,227,328,1,605,-1,,0.03440713853599516,0.2708333333333333,,,228,933
25,25,4,1,5,1,1,0,227,328,1,605,-1,,0.03440713853599516,0.2708333333333333,,,228,933
26,26,5,1,5,1,1,1,227,328,1,605,95, ,0.03440713853599516,0.2708333333333333,,,228,933
27,27,2,1,6,0,0,0,225,196,1235,1199,-1,,0.12741984271022383,0.34170962199312716,,,1460,1395
28,28,3,1,6,1,0,0,225,196,1235,1199,-1,,0.12741984271022383,0.34170962199312716,,,1460,1395
29,29,4,1,6,1,1,0,429,196,89,28,-1,,0.07161222020568662,0.09020618556701031,,,518,224
30,30,5,1,6,1,1,1,429,196,38,28,66,patent,0.0677555958862674,0.09020618556701031,,,467,224
31,31,5,1,6,1,1,2,467,199,51,25,36,Otice,0.07448578342407744,0.09085051546391752,,,518,224
32,32,4,1,6,1,2,0,429,239,1031,44,-1,,0.14284633998790078,0.11211340206185567,,,1460,283
33,33,5,1,6,1,2,1,429,239,109,28,38,sence,0.07312462189957653,0.10867697594501718,,,538,267
34,34,5,1,6,1,2,2,1002,256,44,27,44,a1),0.15486993345432548,0.11576460481099657,,,1046,283
35,35,5,1,6,1,2,3,0,0,1653,2328,28,~~,0.125,0.5,,,1653,2328
36,36,5,1,6,1,2,4,1146,245,52,32,76,EP,0.17725347852389595,0.11211340206185567,,,1198,277
37,37,5,1,6,1,2,5,1214,245,185,32,81,3399747,0.19759528130671505,0.11211340206185567,,,1399,277
38,38,5,1,6,1,2,6,1413,245,47,32,81,A1,0.21725650332728372,0.11211340206185567,,,1460,277
39,39,4,1,6,1,3,0,236,319,878,31,-1,,0.10208711433756806,0.14368556701030927,,,1114,350
40,40,5,1,6,1,3,1,236,324,34,26,96,12),0.0382637628554144,0.14475945017182132,,,270,350
41,41,5,1,6,1,3,2,577,319,156,26,96,EUROPEAN,0.09906231094978826,0.14261168384879724,,,733,345
42,42,5,1,6,1,3,3,735,320,156,24,96,PATENT,0.12295825771324864,0.14261168384879724,,,891,344
43,43,5,1,6,1,3,4,901,319,213,26,96,APPLICATION,0.15237447065940715,0.14261168384879724,,,1114,345
44,44,4,1,6,1,4,0,234,395,754,26,-1,,0.09240774349667272,0.17525773195876287,,,988,421
45,45,5,1,6,1,4,1,234,395,36,26,96,43),0.038112522686025406,0.17525773195876287,,,270,421
46,46,5,1,6,1,4,2,286,397,48,18,96,Date,0.04688445251058681,0.17439862542955326,,,334,415
47,47,5,1,6,1,4,3,342,397,20,18,96,of,0.05323653962492438,0.17439862542955326,,,362,415
48,48,5,1,6,1,4,4,370,397,117,23,96,publication:,0.0648064125831821,0.17547250859106528,,,487,420
49,49,5,1,6,1,4,5,862,395,44,26,67,(51),0.1336963097398669,0.17525773195876287,,,906,421
50,50,5,1,6,1,4,6,923,397,25,18,93,Int,0.1414851784633999,0.17439862542955326,,,948,415
51,51,5,1,6,1,4,7,955,397,33,18,65,Cl:,0.14692982456140352,0.17439862542955326,,,988,415
52,52,4,1,6,1,5,0,286,425,1119,23,-1,,0.1278735632183908,0.1875,,,1405,448
53,53,5,1,6,1,5,1,286,430,117,18,95,07.11.2018,0.052102238354506954,0.18857388316151202,publication_date,07.11.2018,403,448
54,54,5,1,6,1,5,2,426,430,84,18,95,Bulletin,0.07078039927404718,0.18857388316151202,,,510,448
55,55,5,1,6,1,5,3,519,430,84,18,95,2018/45,0.08484573502722323,0.18857388316151202,,,603,448
56,56,5,1,6,1,5,4,922,428,61,18,7,HOAN,0.1440562613430127,0.1877147766323024,,,983,446
57,57,5,1,6,1,5,5,992,428,70,18,91,19/119,0.15532365396249243,0.1877147766323024,class_international,19/119,1062,446
58,58,5,1,6,1,5,6,1067,425,67,16,76,(2014.07),0.16643980641258319,0.18599656357388317,,,1134,441
59,59,5,1,6,1,5,7,1193,428,61,18,58,HO4N,0.1850423472474289,0.1877147766323024,,,1254,446
60,60,5,1,6,1,5,8,1263,428,58,18,93,19/176,0.19540229885057472,0.1877147766323024,,,1321,446
61,61,5,1,6,1,5,9,1322,425,83,21,76,(2014.91),0.20621597096188748,0.1870704467353952,,,1405,446
62,62,4,1,6,1,6,0,922,455,483,21,-1,,0.17596793708408953,0.19995704467353953,,,1405,476
63,63,5,1,6,1,6,1,922,458,61,18,71,HO4N,0.1440562613430127,0.20060137457044674,,,983,476
64,64,5,1,6,1,6,2,992,458,43,18,89,19/46,0.15328191167574107,0.20060137457044674,,,1035,476
65,65,5,1,6,1,6,3,1037,455,84,21,73,(2014.07),0.1631881427707199,0.19995704467353953,,,1121,476
66,66,5,1,6,1,6,4,1193,458,61,18,90,HO4N,0.1850423472474289,0.20060137457044674,,,1254,476
67,67,5,1,6,1,6,5,1263,458,70,18,89,191573,0.19630973986690864,0.20060137457044674,,,1333,476
68,68,5,1,6,1,6,6,1338,455,67,16,63,(2014.01),0.2074258923169994,0.19888316151202748,,,1405,471
69,69,4,1,6,1,7,0,234,486,1158,33,-1,,0.12295825771324864,0.21585051546391754,,,1392,519
70,70,5,1,6,1,7,1,234,493,36,26,95,21),0.038112522686025406,0.21735395189003437,,,270,519
71,71,5,1,6,1,7,2,285,495,115,23,95,Application,0.051799758015728975,0.21756872852233677,,,400,518
72,72,5,1,6,1,7,3,410,495,83,18,93,number:,0.06828493647912885,0.21649484536082475,,,493,513
73,73,5,1,6,1,7,4,505,495,122,18,92,18178788.8,0.08560193587416817,0.21649484536082475,application_number,18178788.8,627,513
74,74,5,1,6,1,7,5,922,488,61,19,51,HO4N,0.1440562613430127,0.21370274914089346,class_international,H04N,983,507
75,75,5,1,6,1,7,6,992,488,70,19,82,191137,0.15532365396249243,0.21370274914089346,,,1062,507
76,76,5,1,6,1,7,7,1067,486,67,15,58,201401),0.16643980641258319,0.21198453608247422,,,1134,501
77,77,5,1,6,1,7,8,1193,488,61,19,92,HOAN,0.1850423472474289,0.21370274914089346,,,1254,507
78,78,5,1,6,1,7,9,1263,488,58,19,68,19117,0.19540229885057472,0.21370274914089346,,,1321,507
79,79,5,1,6,1,7,10,1325,486,67,15,68,2014-09,0.20545977011494254,0.21198453608247422,,,1392,501
80,80,4,1,6,1,8,0,922,516,483,21,-1,,0.17596793708408953,0.226159793814433,,,1405,537
81,81,5,1,6,1,8,1,922,519,61,18,65,HO4N,0.1440562613430127,0.2268041237113402,,,983,537
82,82,5,1,6,1,8,2,992,519,44,18,64,19/51,0.15335753176043557,0.2268041237113402,,,1036,537
83,83,5,1,6,1,8,3,1038,516,83,21,88,(2014.07),0.16326376285541438,0.226159793814433,,,1121,537
84,84,5,1,6,1,8,4,1193,519,61,18,78,HOAN,0.1850423472474289,0.2268041237113402,,,1254,537
85,85,5,1,6,1,8,5,1263,519,70,18,82,19/196,0.19630973986690864,0.2268041237113402,,,1333,537
86,86,5,1,6,1,8,6,1338,516,67,16,74,(2014.97),0.2074258923169994,0.22508591065292097,,,1405,532
87,87,4,1,6,1,9,0,376,547,1029,22,-1,,0.13467937084089535,0.23969072164948454,,,1405,569
88,88,5,1,6,1,9,1,376,561,46,8,35,ling:,0.0603448275862069,0.2426975945017182,,,422,569
89,89,5,1,6,1,9,2,922,550,61,18,85,HO4N,0.1440562613430127,0.24012027491408935,,,983,568
90,90,5,1,6,1,9,3,992,550,70,18,94,19/109,0.15532365396249243,0.24012027491408935,,,1062,568
91,91,5,1,6,1,9,4,1067,547,67,16,76,(2014.01),0.16643980641258319,0.23840206185567012,,,1134,563
92,92,5,1,6,1,9,5,1193,550,61,18,89,HOAN,0.1850423472474289,0.24012027491408935,,,1254,568
93,93,5,1,6,1,9,6,1263,550,70,18,71,19/463,0.19630973986690864,0.24012027491408935,,,1333,568
94,94,5,1,6,1,9,7,1338,547,67,16,82,(2014.01),0.2074258923169994,0.23840206185567012,,,1405,563
95,95,4,1,6,1,10,0,234,559,1171,40,-1,,0.12394131881427707,0.24871134020618557,,,1405,599
96,96,5,1,6,1,10,1,234,559,36,26,96,22),0.038112522686025406,0.24570446735395188,,,270,585
97,97,5,1,6,1,10,2,286,561,35,18,96,Date,0.04590139140955838,0.24484536082474226,,,321,579
98,98,5,1,6,1,10,3,323,566,31,13,96,of,0.05119479733817302,0.24591924398625428,,,354,579
99,99,5,1,6,1,10,4,355,561,67,23,96,filing:,0.058756805807622506,0.24591924398625428,,,422,584
100,100,5,1,6,1,10,5,433,561,117,18,96,12.09.2002,0.07433454325468844,0.24484536082474226,filing_date,12.09.2002,550,579
101,101,5,1,6,1,10,6,922,580,61,19,84,HOAN,0.1440562613430127,0.25322164948453607,,,983,599
102,102,5,1,6,1,10,7,992,580,58,19,44,19/57,0.1544162129461585,0.25322164948453607,,,1050,599
103,103,5,1,6,1,10,8,1054,578,67,15,44,(201401,0.16447368421052633,0.25150343642611683,,,1121,593
104,104,5,1,6,1,10,9,1193,580,61,19,90,HOAN,0.1850423472474289,0.25322164948453607,,,1254,599
105,105,5,1,6,1,10,10,1263,580,71,19,0,191577,0.19638535995160314,0.25322164948453607,,,1334,599
106,106,5,1,6,1,10,11,1338,578,67,15,0,(201401),0.2074258923169994,0.25150343642611683,,,1405,593
107,107,4,1,6,1,11,0,922,609,199,21,-1,,0.15449183303085298,0.2661082474226804,,,1121,630
108,108,5,1,6,1,11,1,922,611,61,19,86,HO4N,0.1440562613430127,0.2665378006872852,,,983,630
109,109,5,1,6,1,11,2,992,611,44,19,75,19161,0.15335753176043557,0.2665378006872852,,,1036,630
110,110,5,1,6,1,11,3,1038,609,83,21,70,(2014.07),0.16326376285541438,0.2661082474226804,,,1121,630
111,111,4,1,6,1,12,0,234,681,854,27,-1,,0.0999697519661222,0.29832474226804123,,,1088,708
112,112,5,1,6,1,12,1,234,681,36,27,96,84),0.038112522686025406,0.29832474226804123,,,270,708
113,113,5,1,6,1,12,2,286,683,118,23,96,Designated,0.052177858439201454,0.29832474226804123,,,404,706
114,114,5,1,6,1,12,3,413,683,119,23,96,Contracting,0.07146098003629764,0.29832474226804123,,,532,706
115,115,5,1,6,1,12,4,542,683,71,19,96,States:,0.08734119782214156,0.2974656357388316,,,613,702
116,116,5,1,6,1,12,5,898,689,7,7,3,¢,0.13634301270417423,0.2974656357388316,,,905,696
117,117,5,1,6,1,12,6,922,683,137,22,82,"SEKIGUCHI,",0.14980338777979432,0.2981099656357388,,,1059,705
118,118,5,1,6,1,12,7,1068,683,20,19,91,S.,0.1630369026013309,0.2974656357388316,,,1088,702
119,119,4,1,6,1,13,0,286,716,870,23,-1,,0.10904416212946158,0.3125,,,1156,739
120,120,5,1,6,1,13,1,286,716,102,18,78,DEGBIT,0.05096793708408953,0.311426116838488,,,388,734
121,121,5,1,6,1,13,2,922,716,75,23,96,"Tokyo,",0.14511494252873564,0.3125,,,997,739
122,122,5,1,6,1,13,3,1007,716,97,18,96,100-6150,0.15963399879007864,0.311426116838488,,,1104,734
123,123,5,1,6,1,13,4,1113,716,43,23,96,(JP),0.17158197217180884,0.3125,,,1156,739
124,124,4,1,6,1,14,0,898,749,206,21,-1,,0.1513914095583787,0.32624570446735396,,,1104,770
125,125,5,1,6,1,14,1,898,754,7,8,38,«,0.13634301270417423,0.32560137457044674,,,905,762
126,126,5,1,6,1,14,2,921,749,146,18,93,"YAMAGUCHI,",0.15033272837265577,0.32560137457044674,,,1067,767
127,127,5,1,6,1,14,3,1070,749,34,21,89,H.,0.16439806412583183,0.32624570446735396,,,1104,770
128,128,4,1,6,1,15,0,234,780,922,26,-1,,0.10511191772534785,0.34063573883161513,,,1156,806
129,129,5,1,6,1,15,1,234,780,36,26,95,30),0.038112522686025406,0.34063573883161513,,,270,806
130,130,5,1,6,1,15,2,286,782,77,23,96,Priority:,0.04907743496672716,0.34085051546391754,,,363,805
131,131,5,1,6,1,15,3,385,782,114,18,95,14.09.2001,0.06684815486993345,0.3397766323024055,priority_date_eu,14.09.2001,499,800
132,132,5,1,6,1,15,4,519,782,27,18,95,JP,0.08053539019963703,0.3397766323024055,,,546,800
133,133,5,1,6,1,15,5,555,782,130,18,95,2001279266,0.09376890502117362,0.3397766323024055,,,685,800
134,134,5,1,6,1,15,6,922,782,75,23,96,"Tokyo,",0.14511494252873564,0.34085051546391754,,,997,805
135,135,5,1,6,1,15,7,1007,782,97,18,96,100-6150,0.15963399879007864,0.3397766323024055,,,1104,800
136,136,5,1,6,1,15,8,1113,782,43,23,90,(JP),0.17158197217180884,0.34085051546391754,,,1156,805
137,137,4,1,6,1,16,0,383,815,640,22,-1,,0.10632183908045977,0.3548109965635739,,,1023,837
138,138,5,1,6,1,16,1,383,815,116,18,96,08.11.2001,0.06669691470054447,0.3539518900343643,,,499,833
139,139,5,1,6,1,16,2,519,815,27,18,96,JP,0.08053539019963703,0.3539518900343643,,,546,833
140,140,5,1,6,1,16,3,554,815,131,18,95,2001343540,0.09369328493647913,0.3539518900343643,,,685,833
141,141,5,1,6,1,16,4,898,820,7,8,25,¢,0.13634301270417423,0.3539518900343643,,,905,828
142,142,5,1,6,1,16,5,922,815,72,22,92,"OGIRI,",0.14488808227465214,0.3548109965635739,,,994,837
143,143,5,1,6,1,16,6,1002,815,21,18,81,Y.,0.1531306715063521,0.3539518900343643,,,1023,833
144,144,4,1,6,1,17,0,385,847,771,23,-1,,0.11653055051421658,0.36877147766323026,,,1156,870
145,145,5,1,6,1,17,1,385,847,116,19,91,10.01.2002,0.06699939503932244,0.36791237113402064,,,501,866
146,146,5,1,6,1,17,2,519,847,27,19,95,JP,0.08053539019963703,0.36791237113402064,,,546,866
147,147,5,1,6,1,17,3,555,847,131,19,96,2002002944,0.09384452510586812,0.36791237113402064,,,686,866
148,148,5,1,6,1,17,4,922,847,75,23,96,"Tokyo,",0.14511494252873564,0.36877147766323026,,,997,870
149,149,5,1,6,1,17,5,1007,847,97,19,96,100-6150,0.15963399879007864,0.36791237113402064,,,1104,866
150,150,5,1,6,1,17,6,1113,847,43,23,96,(JP),0.17158197217180884,0.36877147766323026,,,1156,870
151,151,4,1,6,1,18,0,898,880,150,22,-1,,0.147156684815487,0.38273195876288657,,,1048,902
152,152,5,1,6,1,18,1,898,885,7,8,64,«,0.13634301270417423,0.38187285223367695,,,905,893
153,153,5,1,6,1,18,2,921,880,98,22,92,"ADACHI,",0.14670296430732002,0.38273195876288657,,,1019,902
154,154,5,1,6,1,18,3,1028,880,20,18,91,S.,0.1569872958257713,0.38187285223367695,,,1048,898
155,155,4,1,6,1,19,0,234,911,922,26,-1,,0.10511191772534785,0.39690721649484534,,,1156,937
156,156,5,1,6,1,19,1,234,911,36,26,94,62),0.038112522686025406,0.39690721649484534,,,270,937
157,157,5,1,6,1,19,2,286,913,107,18,96,Document,0.05134603750756201,0.3960481099656357,,,393,931
158,158,5,1,6,1,19,3,402,913,105,23,94,number(s),0.06873865698729582,0.39712199312714774,,,507,936
159,159,5,1,6,1,19,4,516,913,20,18,96,of,0.07955232909860858,0.3960481099656357,,,536,931
160,160,5,1,6,1,19,5,542,913,32,18,96,the,0.08439201451905626,0.3960481099656357,,,574,931
161,161,5,1,6,1,19,6,582,913,66,18,96,earlier,0.09301270417422867,0.3960481099656357,,,648,931
162,162,5,1,6,1,19,7,655,913,140,23,96,application(s),0.10964912280701754,0.39712199312714774,,,795,936
163,163,5,1,6,1,19,8,805,913,16,18,96,in,0.12295825771324864,0.3960481099656357,,,821,931
164,164,5,1,6,1,19,9,922,913,75,23,96,"Tokyo,",0.14511494252873564,0.39712199312714774,,,997,936
165,165,5,1,6,1,19,10,1007,913,97,18,96,100-6150,0.15963399879007864,0.3960481099656357,,,1104,931
166,166,5,1,6,1,19,11,1113,913,43,23,96,(JP),0.17158197217180884,0.39712199312714774,,,1156,936
167,167,4,1,6,1,20,0,286,945,816,22,-1,,0.10496067755595886,0.4106529209621993,,,1102,967
168,168,5,1,6,1,20,1,286,945,109,19,96,accordance,0.051497277676950996,0.4100085910652921,,,395,964
169,169,5,1,6,1,20,2,395,945,60,19,96,with,0.06427707199032062,0.4100085910652921,,,455,964
170,170,5,1,6,1,20,3,464,945,35,19,96,Art.,0.07282214156079855,0.4100085910652921,,,499,964
171,171,5,1,6,1,20,4,508,945,25,19,96,76,0.07872050816696914,0.4100085910652921,,,533,964
172,172,5,1,6,1,20,5,542,945,52,19,96,EPC:,0.08590441621294616,0.4100085910652921,,,594,964
173,173,5,1,6,1,20,6,898,951,7,7,24,«,0.13634301270417423,0.4100085910652921,,,905,958
174,174,5,1,6,1,20,7,923,945,146,22,93,"KOBAYASHI,",0.15063520871143377,0.4106529209621993,,,1069,967
175,175,5,1,6,1,20,8,1079,945,23,19,91,M.,0.16492740471869327,0.4100085910652921,,,1102,964
176,176,4,1,6,1,21,0,286,979,870,23,-1,,0.10904416212946158,0.4254725085910653,,,1156,1002
177,177,5,1,6,1,21,1,286,979,124,18,91,14183129.7,0.05263157894736842,0.42439862542955326,,,410,997
178,178,5,1,6,1,21,2,417,979,7,18,86,/,0.06359649122807018,0.42439862542955326,,,424,997
179,179,5,1,6,1,21,3,432,979,11,18,87,2,0.066167574107683,0.42439862542955326,,,443,997
180,180,5,1,6,1,21,4,452,979,37,18,87,819,0.07115849969751967,0.42439862542955326,,,489,997
181,181,5,1,6,1,21,5,498,979,35,18,96,411,0.0779643073200242,0.42439862542955326,,,533,997
182,182,5,1,6,1,21,6,922,979,75,23,96,"Tokyo,",0.14511494252873564,0.4254725085910653,,,997,1002
183,183,5,1,6,1,21,7,1007,979,97,18,95,100-6150,0.15963399879007864,0.42439862542955326,,,1104,997
184,184,5,1,6,1,21,8,1113,979,43,23,96,(JP),0.17158197217180884,0.4254725085910653,,,1156,1002
185,185,4,1,6,1,22,0,286,1011,250,19,-1,,0.06215970961887477,0.4383591065292096,,,536,1030
186,186,5,1,6,1,22,1,286,1011,124,19,75,09162925.3,0.05263157894736842,0.4383591065292096,,,410,1030
187,187,5,1,6,1,22,2,417,1011,7,19,75,/,0.06359649122807018,0.4383591065292096,,,424,1030
188,188,5,1,6,1,22,3,432,1011,11,19,95,2,0.066167574107683,0.4383591065292096,,,443,1030
189,189,5,1,6,1,22,4,452,1011,37,19,95,099,0.07115849969751967,0.4383591065292096,,,489,1030
190,190,5,1,6,1,22,5,498,1011,38,19,96,228,0.07819116757410768,0.4383591065292096,,,536,1030
191,191,4,1,6,1,23,0,286,1042,1145,26,-1,,0.12983968542044766,0.4531786941580756,,,1431,1068
192,192,5,1,6,1,23,1,286,1044,138,18,89,02765514.1/,0.05369026013309135,0.452319587628866,,,424,1062
193,193,5,1,6,1,23,2,433,1044,53,18,84,1351,0.06949485783424078,0.452319587628866,,,486,1062
194,194,5,1,6,1,23,3,498,1044,38,18,90,510,0.07819116757410768,0.452319587628866,,,536,1062
195,195,5,1,6,1,23,4,862,1042,44,26,95,(74),0.1336963097398669,0.4531786941580756,,,906,1068
196,196,5,1,6,1,23,5,923,1044,163,23,93,Representative:,0.15192075015124018,0.453393470790378,,,1086,1067
197,197,5,1,6,1,23,6,1094,1044,87,23,93,"Viering,",0.1720356926799758,0.453393470790378,representative_line_1_eu,"Viering,",1181,1067
198,198,5,1,6,1,23,7,1190,1044,126,18,92,Jentschura,0.18950393224440412,0.452319587628866,representative_line_1_eu,Jentschura,1316,1062
199,199,5,1,6,1,23,8,1324,1044,15,18,93,&,0.2013762855414398,0.452319587628866,representative_line_1_eu,&,1339,1062
200,200,5,1,6,1,23,9,1349,1044,82,18,96,Partner,0.2102238354506957,0.452319587628866,representative_line_1_eu,Partner,1431,1062
201,201,4,1,6,1,24,0,922,1077,51,18,-1,,0.14330006049606775,0.46649484536082475,,,973,1095
202,202,5,1,6,1,24,1,922,1077,51,18,92,mbB,0.14330006049606775,0.46649484536082475,,,973,1095
203,203,4,1,6,1,25,0,225,1107,1000,27,-1,,0.10964912280701754,0.48131443298969073,,,1225,1134
204,204,5,1,6,1,25,1,225,1107,45,27,96,(71),0.037431941923774956,0.48131443298969073,,,270,1134
205,205,5,1,6,1,25,2,285,1109,103,23,96,Applicant:,0.05089231699939504,0.48131443298969073,,,388,1132
206,206,5,1,6,1,25,3,397,1109,45,19,96,NTT,0.06344525105868118,0.4804553264604811,applicant_line_1,NTT,442,1128
207,207,5,1,6,1,25,4,451,1109,107,19,95,"DOCOMO,",0.07630066545674531,0.4804553264604811,applicant_line_1,"DOCOMO,",558,1128
208,208,5,1,6,1,25,5,561,1109,58,22,94,INC.,0.08923169993950393,0.48109965635738833,applicant_line_1,INC.,619,1131
209,209,5,1,6,1,25,6,923,1109,78,19,92,Patent-,0.1454930429522081,0.4804553264604811,,,1001,1128
210,210,5,1,6,1,25,7,1010,1109,41,19,93,und,0.1558529945553539,0.4804553264604811,,,1051,1128
211,211,5,1,6,1,25,8,1061,1109,164,19,85,Rechtsanwalte,0.17286751361161526,0.4804553264604811,,,1225,1128
212,212,4,1,6,1,26,0,286,1142,809,23,-1,,0.1044313369630974,0.4954896907216495,,,1095,1165
213,213,5,1,6,1,26,1,286,1142,133,23,96,"Chiyoda-ku,",0.053312159709618875,0.4954896907216495,,,419,1165
214,214,5,1,6,1,26,2,921,1142,37,18,92,Am,0.14209013914095583,0.4944158075601375,,,958,1160
215,215,5,1,6,1,26,3,968,1142,107,18,91,Brauhaus,0.15449183303085298,0.4944158075601375,,,1075,1160
216,216,5,1,6,1,26,4,1084,1142,11,18,90,8,0.1647761645493043,0.4944158075601375,,,1095,1160
217,217,4,1,6,1,27,0,285,1175,859,24,-1,,0.10806110102843315,0.5098797250859106,,,1144,1199
218,218,5,1,6,1,27,1,285,1175,69,24,96,Tokyo,0.048321234119782216,0.5098797250859106,,,354,1199
219,219,5,1,6,1,27,2,363,1175,99,19,96,100-6150,0.06238656987295826,0.5088058419243986,,,462,1194
220,220,5,1,6,1,27,3,470,1175,43,24,96,(JP),0.07433454325468844,0.5098797250859106,,,513,1199
221,221,5,1,6,1,27,4,922,1175,64,19,96,01099,0.1442831215970962,0.5088058419243986,,,986,1194
222,222,5,1,6,1,27,5,996,1175,92,19,96,Dresden,0.15759225650332728,0.5088058419243986,,,1088,1194
223,223,5,1,6,1,27,6,1097,1175,47,24,96,(DE),0.169464609800363,0.5098797250859106,,,1144,1199
224,224,4,1,6,1,28,0,225,1239,736,26,-1,,0.0896854204476709,0.5378006872852233,,,961,1265
225,225,5,1,6,1,28,1,225,1239,45,26,96,(72),0.037431941923774956,0.5378006872852233,,,270,1265
226,226,5,1,6,1,28,2,286,1241,102,18,96,Inventors:,0.05096793708408953,0.5369415807560137,,,388,1259
227,227,5,1,6,1,28,3,862,1241,99,18,96,Remarks:,0.13785541439806412,0.5369415807560137,,,961,1259
228,228,4,1,6,1,29,0,262,1274,1137,23,-1,,0.12560496067755597,0.5521907216494846,,,1399,1297
229,229,5,1,6,1,29,1,262,1279,7,8,43,+,0.04015426497277677,0.5511168384879725,,,269,1287
230,230,5,1,6,1,29,2,286,1274,65,18,90,"KATO,",0.048169993950393224,0.5511168384879725,inventor_line_1,"KATO,",351,1292
231,231,5,1,6,1,29,3,354,1274,32,22,87,S.,0.0559588626739262,0.5519759450171822,inventor_line_1,S.,386,1296
232,232,5,1,6,1,29,4,922,1274,43,18,96,This,0.1426950998185118,0.5511168384879725,,,965,1292
233,233,5,1,6,1,29,5,974,1274,111,23,96,application,0.15570175438596492,0.5521907216494846,,,1085,1297
234,234,5,1,6,1,29,6,1093,1278,42,14,96,was,0.16848154869933454,0.5519759450171822,,,1135,1292
235,235,5,1,6,1,29,7,1142,1274,43,18,96,filed,0.17596793708408953,0.5511168384879725,,,1185,1292
236,236,5,1,6,1,29,8,1193,1278,25,14,95,on,0.1823200241984271,0.5519759450171822,,,1218,1292
237,237,5,1,6,1,29,9,1226,1274,121,18,96,20-06-2018,0.19457047791893528,0.5511168384879725,,,1347,1292
238,238,5,1,6,1,29,10,1355,1278,24,14,95,as,0.20674531155474893,0.5519759450171822,,,1379,1292
239,239,5,1,6,1,29,11,1388,1278,11,14,95,a,0.21075317604355717,0.5519759450171822,,,1399,1292
240,240,4,1,6,1,30,0,285,1306,1159,23,-1,,0.1307471264367816,0.5659364261168385,,,1444,1329
241,241,5,1,6,1,30,1,285,1306,75,23,96,"Tokyo,",0.04877495462794918,0.5659364261168385,,,360,1329
242,242,5,1,6,1,30,2,370,1306,98,19,96,100-6150,0.0633696309739867,0.5650773195876289,,,468,1325
243,243,5,1,6,1,30,3,477,1306,43,23,96,(JP),0.07539322444041137,0.5659364261168385,,,520,1329
244,244,5,1,6,1,30,4,922,1306,96,19,96,divisional,0.14670296430732002,0.5650773195876289,,,1018,1325
245,245,5,1,6,1,30,5,1026,1306,112,23,96,application,0.16364186327888688,0.5659364261168385,,,1138,1329
246,246,5,1,6,1,30,6,1147,1307,19,18,96,to,0.17490925589836662,0.5652920962199313,,,1166,1325
247,247,5,1,6,1,30,7,1174,1306,31,19,96,the,0.17990018148820328,0.5650773195876289,,,1205,1325
248,248,5,1,6,1,30,8,1214,1306,112,23,95,application,0.19207501512401695,0.5659364261168385,,,1326,1329
249,249,5,1,6,1,30,9,1336,1306,108,19,96,mentioned,0.2102238354506957,0.5650773195876289,,,1444,1325
250,250,4,1,6,1,31,0,262,1339,870,22,-1,,0.10541439806412584,0.5798969072164949,,,1132,1361
251,251,5,1,6,1,31,1,262,1344,7,8,46,+,0.04015426497277677,0.5790378006872853,,,269,1352
252,252,5,1,6,1,31,2,286,1339,70,22,93,"ETOH,",0.048548094373865695,0.5798969072164949,,,356,1361
253,253,5,1,6,1,31,3,366,1339,24,18,90,M.,0.05716878402903811,0.5790378006872853,,,390,1357
254,254,5,1,6,1,31,4,923,1339,59,18,93,under,0.1440562613430127,0.5790378006872853,,,982,1357
255,255,5,1,6,1,31,5,991,1339,45,18,92,INID,0.15328191167574107,0.5790378006872853,,,1036,1357
256,256,5,1,6,1,31,6,1044,1339,50,18,96,code,0.16167574107683,0.5790378006872853,,,1094,1357
257,257,5,1,6,1,31,7,1103,1339,29,18,96,62.,0.16901088929219601,0.5790378006872853,,,1132,1357
258,258,4,1,6,1,32,0,285,1372,235,23,-1,,0.060874168179068364,0.594286941580756,,,520,1395
259,259,5,1,6,1,32,1,285,1372,75,23,96,"Tokyo,",0.04877495462794918,0.594286941580756,,,360,1395
260,260,5,1,6,1,32,2,370,1372,98,19,96,100-6150,0.0633696309739867,0.5934278350515464,,,468,1391
261,261,5,1,6,1,32,3,477,1372,43,23,96,(JP),0.07539322444041137,0.594286941580756,,,520,1395
262,262,2,1,7,0,0,0,845,664,2,763,-1,,0.1279491833030853,0.4490979381443299,,,847,1427
263,263,3,1,7,1,0,0,845,664,2,763,-1,,0.1279491833030853,0.4490979381443299,,,847,1427
264,264,4,1,7,1,1,0,845,664,2,763,-1,,0.1279491833030853,0.4490979381443299,,,847,1427
265,265,5,1,7,1,1,1,845,664,2,763,95, ,0.1279491833030853,0.4490979381443299,,,847,1427
266,266,2,1,8,0,0,0,224,1425,1243,2,-1,,0.1278735632183908,0.6125429553264605,,,1467,1427
267,267,3,1,8,1,0,0,224,1425,1243,2,-1,,0.1278735632183908,0.6125429553264605,,,1467,1427
268,268,4,1,8,1,1,0,224,1425,1243,2,-1,,0.1278735632183908,0.6125429553264605,,,1467,1427
269,269,5,1,8,1,1,1,224,1425,1243,2,95, ,0.1278735632183908,0.6125429553264605,,,1467,1427
270,270,2,1,9,0,0,0,225,1444,354,27,-1,,0.060798548094373864,0.626073883161512,,,579,1471
271,271,3,1,9,1,0,0,225,1444,354,27,-1,,0.060798548094373864,0.626073883161512,,,579,1471
272,272,4,1,9,1,1,0,225,1444,354,27,-1,,0.060798548094373864,0.626073883161512,,,579,1471
273,273,5,1,9,1,1,1,225,1444,45,27,87,(54),0.037431941923774956,0.626073883161512,,,270,1471
274,274,5,1,9,1,1,2,0,0,1653,2328,68,|,0.125,0.5,,,1653,2328
275,275,5,1,9,1,1,3,316,1444,140,21,94,DECODING,0.05837870538415003,0.6247852233676976,title_line_1,DECODING,456,1465
276,276,5,1,9,1,1,4,467,1444,112,21,96,METHOD,0.07909860859044163,0.6247852233676976,title_line_1,METHOD,579,1465
277,277,2,1,10,0,0,0,225,1518,45,27,-1,,0.037431941923774956,0.657860824742268,,,270,1545
278,278,3,1,10,1,0,0,225,1518,45,27,-1,,0.037431941923774956,0.657860824742268,,,270,1545
279,279,4,1,10,1,1,0,225,1518,45,27,-1,,0.037431941923774956,0.657860824742268,,,270,1545
280,280,5,1,10,1,1,1,225,1518,45,27,94,(57),0.037431941923774956,0.657860824742268,,,270,1545
281,281,2,1,11,0,0,0,315,1520,1152,23,-1,,0.13475499092558985,0.657860824742268,,,1467,1543
282,282,3,1,11,1,0,0,315,1520,1152,23,-1,,0.13475499092558985,0.657860824742268,,,1467,1543
283,283,4,1,11,1,1,0,315,1520,1152,23,-1,,0.13475499092558985,0.657860824742268,,,1467,1543
284,284,5,1,11,1,1,1,315,1520,15,19,35,A,0.04877495462794918,0.6570017182130584,,,330,1539
285,285,5,1,11,1,1,2,337,1520,67,23,35,coding,0.05603448275862069,0.657860824742268,,,404,1543
286,286,5,1,11,1,1,3,413,1520,76,19,96,method,0.06820931639443437,0.6570017182130584,,,489,1539
287,287,5,1,11,1,1,4,496,1520,20,19,96,of,0.0765275257108288,0.6570017182130584,,,516,1539
288,288,5,1,11,1,1,5,522,1520,111,23,96,performing,0.08734119782214156,0.657860824742268,,,633,1543
289,289,5,1,11,1,1,6,641,1520,132,23,96,compression,0.10692679975801572,0.657860824742268,,,773,1543
290,290,5,1,11,1,1,7,781,1520,68,23,96,coding,0.12326073805202661,0.657860824742268,,,849,1543
291,291,5,1,11,1,1,8,856,1520,20,19,96,of,0.1309739866908651,0.6570017182130584,,,876,1539
292,292,5,1,11,1,1,9,882,1525,11,14,96,a,0.13422565033272837,0.6580756013745704,,,893,1539
293,293,5,1,11,1,1,10,901,1520,73,23,96,moving,0.14178765880217786,0.657860824742268,,,974,1543
294,294,5,1,11,1,1,11,983,1520,69,23,97,picture,0.15388687235329704,0.657860824742268,,,1052,1543
295,295,5,1,11,1,1,12,1059,1520,24,23,96,by,0.161978221415608,0.657860824742268,,,1083,1543
296,296,5,1,11,1,1,13,1090,1520,68,19,95,motion,0.16999395039322443,0.6570017182130584,,,1158,1539
297,297,5,1,11,1,1,14,1166,1520,141,23,96,compensated,0.1870084694494858,0.657860824742268,,,1307,1543
298,298,5,1,11,1,1,15,1315,1520,100,23,96,prediction,0.20644283121597096,0.657860824742268,,,1415,1543
299,299,5,1,11,1,1,16,1424,1525,43,18,96,may,0.21861766485178463,0.6589347079037801,,,1467,1543
300,300,2,1,12,0,0,0,224,1553,1242,154,-1,,0.1277979431336963,0.7001718213058419,,,1466,1707
301,301,3,1,12,1,0,0,224,1553,1242,154,-1,,0.1277979431336963,0.7001718213058419,,,1466,1707
302,302,4,1,12,1,1,0,225,1553,1241,23,-1,,0.1278735632183908,0.6720360824742269,,,1466,1576
303,303,5,1,12,1,1,1,225,1553,101,23,96,comprise:,0.041666666666666664,0.6720360824742269,,,326,1576
304,304,5,1,12,1,1,2,333,1558,11,13,96,a,0.05119479733817302,0.6720360824742269,,,344,1571
305,305,5,1,12,1,1,3,350,1553,141,23,96,compensated,0.06359649122807018,0.6720360824742269,,,491,1576
306,306,5,1,12,1,1,4,499,1553,100,23,96,prediction,0.08303085299455536,0.6720360824742269,,,599,1576
307,307,5,1,12,1,1,5,605,1554,31,17,96,step,0.09384452510586812,0.6711769759450171,,,636,1571
308,308,5,1,12,1,1,6,639,1553,36,23,96,of,0.09936479128856625,0.6720360824742269,,,675,1576
309,309,5,1,12,1,1,7,680,1553,111,23,96,performing,0.11123714458560194,0.6720360824742269,,,791,1576
310,310,5,1,12,1,1,8,797,1553,32,18,96,the,0.12295825771324864,0.6709621993127147,,,829,1571
311,311,5,1,12,1,1,9,836,1553,68,18,96,motion,0.13157894736842105,0.6709621993127147,,,904,1571
312,312,5,1,12,1,1,10,911,1554,128,22,96,compensated,0.14745916515426497,0.6722508591065293,,,1039,1576
313,313,5,1,12,1,1,11,1040,1553,119,23,96,prediction,0.16628856624319419,0.6720360824742269,,,1159,1576
314,314,5,1,12,1,1,12,1165,1553,54,18,96,while,0.18027828191167575,0.6709621993127147,,,1219,1571
315,315,5,1,12,1,1,13,1224,1553,92,23,96,selecting,0.19207501512401695,0.6720360824742269,,,1316,1576
316,316,5,1,12,1,1,14,1323,1558,38,13,96,one,0.2029643073200242,0.6720360824742269,,,1361,1571
317,317,5,1,12,1,1,15,1367,1553,99,18,96,reference,0.21423169993950394,0.6709621993127147,,,1466,1571
318,318,4,1,12,1,2,0,224,1586,1242,23,-1,,0.1277979431336963,0.6862113402061856,,,1466,1609
319,319,5,1,12,1,2,1,224,1586,60,18,96,frame,0.038415003024803385,0.6851374570446735,,,284,1604
320,320,5,1,12,1,2,2,293,1586,32,18,96,out,0.04673321234119782,0.6851374570446735,,,325,1604
321,321,5,1,12,1,2,3,332,1586,21,18,96,of,0.051799758015728975,0.6851374570446735,,,353,1604
322,322,5,1,12,1,2,4,360,1590,11,14,96,a,0.05527828191167574,0.6859965635738832,,,371,1604
323,323,5,1,12,1,2,5,381,1586,80,23,96,plurality,0.06367211131276466,0.6862113402061856,,,461,1609
324,324,5,1,12,1,2,6,469,1586,20,18,96,of,0.07244404113732607,0.6851374570446735,,,489,1604
325,325,5,1,12,1,2,7,496,1586,99,18,96,reference,0.08250151240169389,0.6851374570446735,,,595,1604
326,326,5,1,12,1,2,8,603,1586,72,18,96,frames,0.09664246823956443,0.6851374570446735,,,675,1604
327,327,5,1,12,1,2,9,684,1586,83,18,97,retained,0.10972474289171204,0.6851374570446735,,,767,1604
328,328,5,1,12,1,2,10,776,1586,27,18,96,for,0.11940411373260738,0.6851374570446735,,,803,1604
329,329,5,1,12,1,2,11,811,1586,32,18,96,the,0.1250756200846945,0.6851374570446735,,,843,1604
330,330,5,1,12,1,2,12,852,1586,69,18,96,motion,0.13407441016333937,0.6851374570446735,,,921,1604
331,331,5,1,12,1,2,13,930,1586,141,23,96,compensated,0.1513157894736842,0.6862113402061856,,,1071,1609
332,332,5,1,12,1,2,14,1081,1586,106,23,96,"prediction,",0.17150635208711434,0.6862113402061856,,,1187,1609
333,333,5,1,12,1,2,15,1198,1586,15,18,96,in,0.1823200241984271,0.6851374570446735,,,1213,1604
334,334,5,1,12,1,2,16,1222,1590,12,14,96,a,0.18572292800967938,0.6859965635738832,,,1234,1604
335,335,5,1,12,1,2,17,1244,1586,36,18,96,unit,0.190865093768905,0.6851374570446735,,,1280,1604
336,336,5,1,12,1,2,18,1288,1586,104,23,96,consisting,0.2026618269812462,0.6862113402061856,,,1392,1609
337,337,5,1,12,1,2,19,1401,1586,20,18,97,of,0.2133998790078645,0.6851374570446735,,,1421,1604
338,338,5,1,12,1,2,20,1427,1590,39,14,96,one,0.21876890502117363,0.6859965635738832,,,1466,1604
339,339,4,1,12,1,3,0,225,1619,1240,23,-1,,0.1277979431336963,0.7003865979381443,,,1465,1642
340,340,5,1,12,1,3,1,225,1624,20,13,96,or,0.035541439806412584,0.7003865979381443,,,245,1637
341,341,5,1,12,1,3,2,255,1624,52,13,96,more,0.04249848759830611,0.7003865979381443,,,307,1637
342,342,5,1,12,1,3,3,317,1619,75,18,96,second,0.053614640048396854,0.6993127147766323,,,392,1637
343,343,5,1,12,1,3,4,404,1619,65,18,96,blocks,0.06601633393829401,0.6993127147766323,,,469,1637
344,344,5,1,12,1,3,5,478,1619,90,18,94,obtained,0.07909860859044163,0.6993127147766323,,,568,1637
345,345,5,1,12,1,3,6,580,1619,22,23,93,by,0.08938294010889292,0.7003865979381443,,,602,1642
346,346,5,1,12,1,3,7,612,1619,125,23,92,sub-dividing,0.10201149425287356,0.7003865979381443,,,737,1642
347,347,5,1,12,1,3,8,748,1624,38,13,96,each,0.11600120992135511,0.7003865979381443,,,786,1637
348,348,5,1,12,1,3,9,787,1619,32,18,96,of,0.12144585601935874,0.6993127147766323,,,819,1637
349,349,5,1,12,1,3,10,820,1619,54,18,97,first,0.1281004234724743,0.6993127147766323,,,874,1637
350,350,5,1,12,1,3,11,884,1619,65,18,96,blocks,0.13861161524500906,0.6993127147766323,,,949,1637
351,351,5,1,12,1,3,12,959,1619,88,23,96,resulting,0.15169388989715668,0.7003865979381443,,,1047,1642
352,352,5,1,12,1,3,13,1057,1619,46,18,96,from,0.16333938294010888,0.6993127147766323,,,1103,1637
353,353,5,1,12,1,3,14,1114,1619,77,18,96,division,0.17430429522081065,0.6993127147766323,,,1191,1637
354,354,5,1,12,1,3,15,1202,1619,20,18,96,of,0.18330308529945555,0.6993127147766323,,,1222,1637
355,355,5,1,12,1,3,16,1230,1624,11,13,96,a,0.1868572292800968,0.7003865979381443,,,1241,1637
356,356,5,1,12,1,3,17,1251,1619,60,18,96,frame,0.19373865698729584,0.6993127147766323,,,1311,1637
357,357,5,1,12,1,3,18,1321,1619,20,18,96,of,0.2013006654567453,0.6993127147766323,,,1341,1637
358,358,5,1,12,1,3,19,1349,1619,32,18,96,the,0.20644283121597096,0.6993127147766323,,,1381,1637
359,359,5,1,12,1,3,20,1392,1619,73,23,96,moving,0.2160465819721718,0.7003865979381443,,,1465,1642
360,360,4,1,12,1,4,0,226,1652,1240,23,-1,,0.1279491833030853,0.7145618556701031,,,1466,1675
361,361,5,1,12,1,4,1,226,1652,74,23,96,picture;,0.03977616454930429,0.7145618556701031,,,300,1675
362,362,5,1,12,1,4,2,307,1652,37,18,92,and,0.04922867513611615,0.7134879725085911,,,344,1670
363,363,5,1,12,1,4,3,351,1652,116,18,92,areference,0.06185722928009679,0.7134879725085911,,,467,1670
364,364,5,1,12,1,4,4,471,1652,46,18,95,frame,0.07471264367816093,0.7134879725085911,,,517,1670
365,365,5,1,12,1,4,5,519,1652,133,18,95,information,0.08855111917725347,0.7134879725085911,,,652,1670
366,366,5,1,12,1,4,6,659,1652,67,23,94,coding,0.10473381730187538,0.7145618556701031,,,726,1675
367,367,5,1,12,1,4,7,733,1652,43,23,97,step,0.11411070780399274,0.7145618556701031,,,776,1675
368,368,5,1,12,1,4,8,781,1652,20,18,97,of,0.11963097398669087,0.7134879725085911,,,801,1670
369,369,5,1,12,1,4,9,805,1652,102,23,96,outputting,0.1294615849969752,0.7145618556701031,,,907,1675
370,370,5,1,12,1,4,10,915,1652,114,18,93,information,0.147005444646098,0.7134879725085911,,,1029,1670
371,371,5,1,12,1,4,11,1036,1652,74,18,91,abouta,0.16228070175438597,0.7134879725085911,,,1110,1670
372,372,5,1,12,1,4,12,1116,1652,92,18,96,selection,0.17574107683000606,0.7134879725085911,,,1208,1670
373,373,5,1,12,1,4,13,1214,1652,86,18,95,situation,0.19010889292196007,0.7134879725085911,,,1300,1670
374,374,5,1,12,1,4,14,1306,1652,20,18,96,of,0.19903206291591047,0.7134879725085911,,,1326,1670
375,375,5,1,12,1,4,15,1330,1652,31,18,95,the,0.20349364791288566,0.7134879725085911,,,1361,1670
376,376,5,1,12,1,4,16,1367,1652,99,18,95,reference,0.21423169993950394,0.7134879725085911,,,1466,1670
377,377,4,1,12,1,5,0,224,1684,829,23,-1,,0.09656684815486993,0.728307560137457,,,1053,1707
378,378,5,1,12,1,5,1,224,1684,60,19,95,frame,0.038415003024803385,0.7274484536082474,,,284,1703
379,379,5,1,12,1,5,2,292,1684,27,19,96,for,0.04620387174833636,0.7274484536082474,,,319,1703
380,380,5,1,12,1,5,3,327,1684,41,19,96,said,0.052555958862673925,0.7274484536082474,,,368,1703
381,381,5,1,12,1,5,4,377,1689,39,14,96,one,0.05996672716273442,0.7285223367697594,,,416,1703
382,382,5,1,12,1,5,5,424,1689,20,14,95,or,0.06563823351482154,0.7285223367697594,,,444,1703
383,383,5,1,12,1,5,6,453,1689,51,14,96,more,0.07236842105263158,0.7285223367697594,,,504,1703
384,384,5,1,12,1,5,7,513,1689,61,14,96,second,0.08219903206291591,0.7285223367697594,,,574,1703
385,385,5,1,12,1,5,8,577,1684,85,19,96,blocks,0.09369328493647913,0.7274484536082474,,,662,1703
386,386,5,1,12,1,5,9,672,1684,15,19,96,in,0.1027676950998185,0.7274484536082474,,,687,1703
387,387,5,1,12,1,5,10,696,1689,11,14,96,a,0.10609497882637628,0.7285223367697594,,,707,1703
388,388,5,1,12,1,5,11,717,1684,118,23,96,multiplexed,0.11736237144585603,0.728307560137457,,,835,1707
389,389,5,1,12,1,5,12,843,1684,46,19,96,form,0.1309739866908651,0.7274484536082474,,,889,1703
390,390,5,1,12,1,5,13,897,1689,25,14,95,on,0.13755293405928615,0.7285223367697594,,,922,1703
391,391,5,1,12,1,5,14,931,1689,11,14,95,a,0.14163641863278886,0.7285223367697594,,,942,1703
392,392,5,1,12,1,5,15,952,1684,101,19,96,bitstream.,0.15161826981246218,0.7274484536082474,,,1053,1703
393,393,2,1,13,0,0,0,691,1751,218,72,-1,,0.12099213551119177,0.7676116838487973,,,909,1823
394,394,3,1,13,1,0,0,691,1751,218,72,-1,,0.12099213551119177,0.7676116838487973,,,909,1823
395,395,4,1,13,1,1,0,691,1751,218,72,-1,,0.12099213551119177,0.7676116838487973,,,909,1823
396,396,5,1,13,1,1,1,691,1751,218,72,89,Fig.6A,0.12099213551119177,0.7676116838487973,,,909,1823
397,397,2,1,14,0,0,0,610,2020,356,85,-1,,0.1191772534785239,0.8859536082474226,,,966,2105
398,398,3,1,14,1,0,0,610,2020,356,85,-1,,0.1191772534785239,0.8859536082474226,,,966,2105
399,399,4,1,14,1,1,0,610,2020,42,33,-1,,0.0954325468844525,0.8747852233676976,,,652,2053
400,400,5,1,14,1,1,1,610,2020,42,33,70,Gl,0.0954325468844525,0.8747852233676976,,,652,2053
401,401,4,1,14,1,2,0,851,2077,115,28,-1,,0.13740169388989715,0.8981958762886598,,,966,2105
402,402,5,1,14,1,2,1,851,2077,115,28,91,MODEO,0.13740169388989715,0.8981958762886598,,,966,2105
403,403,2,1,15,0,0,0,716,2264,749,23,-1,,0.16492740471869327,0.9774484536082474,,,1465,2287
404,404,3,1,15,1,0,0,716,2264,749,23,-1,,0.16492740471869327,0.9774484536082474,,,1465,2287
405,405,4,1,15,1,1,0,716,2264,749,23,-1,,0.16492740471869327,0.9774484536082474,,,1465,2287
406,406,5,1,15,1,1,1,716,2270,49,12,96,Printed,0.11199334543254688,0.9776632302405498,,,765,2282
407,407,5,1,15,1,1,2,771,2270,15,16,96,by,0.1177404718693285,0.9785223367697594,,,786,2286
408,408,5,1,15,1,1,3,792,2270,45,14,96,"Jouve,",0.12318511796733213,0.9780927835051546,,,837,2284
409,409,5,1,15,1,1,4,843,2270,41,12,96,75001,0.13059588626739263,0.9776632302405498,,,884,2282
410,410,5,1,15,1,1,5,893,2270,46,12,96,PARIS,0.1385359951603146,0.9776632302405498,,,939,2282
411,411,5,1,15,1,1,6,945,2270,30,16,96,(FR),0.14519056261343014,0.9785223367697594,,,975,2286
412,412,5,1,15,1,1,7,1273,2264,67,23,96,(Cont.,0.19759528130671505,0.9774484536082474,,,1340,2287
413,413,5,1,15,1,1,8,1350,2265,46,17,95,next,0.20765275257108287,0.9765893470790378,,,1396,2282
414,414,5,1,15,1,1,9,1405,2264,60,23,96,page),0.21702964307320025,0.9774484536082474,,,1465,2287
