,Unnamed: 0,level,page_num,block_num,par_num,line_num,word_num,left,top,width,height,conf,text,x,y,label,target,right,bottom
0,0,1,1,0,0,0,0,0,0,1653,2328,-1,,0.125,0.5,,,1653,2328
1,1,2,1,1,0,0,0,144,1905,31,328,-1,,0.02412280701754386,0.8887457044673539,,,175,2233
2,2,3,1,1,1,0,0,144,1905,31,328,-1,,0.02412280701754386,0.8887457044673539,,,175,2233
3,3,4,1,1,1,1,0,144,1905,31,328,-1,,0.02412280701754386,0.8887457044673539,,,175,2233
4,4,5,1,1,1,1,1,144,2179,30,54,96,EP,0.024047186932849365,0.947594501718213,,,174,2233
5,5,5,1,1,1,1,2,144,2142,31,21,94,3,0.02412280701754386,0.9246134020618557,,,175,2163
6,6,5,1,1,1,1,3,144,2055,31,71,94,399,0.02412280701754386,0.8979810996563574,,,175,2126
7,7,5,1,1,1,1,4,144,1969,30,70,91,712,0.024047186932849365,0.8608247422680413,,,174,2039
8,8,5,1,1,1,1,5,144,1905,30,50,89,A1,0.024047186932849365,0.8290378006872853,,,174,1955
9,9,2,1,2,0,0,0,429,153,88,28,-1,,0.07153660012099214,0.07173539518900343,,,517,181
10,10,3,1,2,1,0,0,429,153,88,28,-1,,0.07153660012099214,0.07173539518900343,,,517,181
11,11,4,1,2,1,1,0,429,153,88,16,-1,,0.07153660012099214,0.06915807560137457,,,517,169
12,12,5,1,2,1,1,1,429,153,88,16,84,Europaisches,0.07153660012099214,0.06915807560137457,,,517,169
13,13,4,1,2,1,2,0,429,170,71,11,-1,,0.07025105868118572,0.07538659793814433,,,500,181
14,14,5,1,2,1,2,1,429,170,71,11,96,Patentamt,0.07025105868118572,0.07538659793814433,,,500,181
15,15,2,1,3,0,0,0,429,196,89,28,-1,,0.07161222020568662,0.09020618556701031,,,518,224
16,16,3,1,3,1,0,0,429,196,89,28,-1,,0.07161222020568662,0.09020618556701031,,,518,224
17,17,4,1,3,1,1,0,429,196,63,15,-1,,0.06964609800362977,0.08741408934707903,,,492,211
18,18,5,1,3,1,1,1,429,196,63,15,95,European,0.06964609800362977,0.08741408934707903,,,492,211
19,19,4,1,3,1,2,0,429,212,89,12,-1,,0.07161222020568662,0.0936426116838488,,,518,224
20,20,5,1,3,1,2,1,429,213,43,11,96,Patent,0.06813369630973987,0.0938573883161512,,,472,224
21,21,5,1,3,1,2,2,478,212,40,12,90,Office,0.07531760435571688,0.0936426116838488,,,518,224
22,22,2,1,4,0,0,0,429,239,109,28,-1,,0.07312462189957653,0.10867697594501718,,,538,267
23,23,3,1,4,1,0,0,429,239,109,28,-1,,0.07312462189957653,0.10867697594501718,,,538,267
24,24,4,1,4,1,1,0,429,239,109,15,-1,,0.07312462189957653,0.10588487972508591,,,538,254
25,25,5,1,4,1,1,1,429,239,40,12,93,Office,0.06790683605565638,0.1052405498281787,,,469,251
26,26,5,1,4,1,1,2,474,239,64,15,93,europ√©en,0.0765275257108288,0.10588487972508591,,,538,254
27,27,4,1,4,1,2,0,429,255,77,12,-1,,0.0707047791893527,0.11211340206185567,,,506,267
28,28,5,1,4,1,2,1,429,255,22,12,95,des,0.06654567453115548,0.11211340206185567,,,451,267
29,29,5,1,4,1,2,2,457,255,49,12,82,brevets,0.07282214156079855,0.11211340206185567,,,506,267
30,30,2,1,5,0,0,0,281,136,274,150,-1,,0.06321839080459771,0.09063573883161512,,,555,286
31,31,3,1,5,1,0,0,281,136,274,150,-1,,0.06321839080459771,0.09063573883161512,,,555,286
32,32,4,1,5,1,1,0,281,136,274,150,-1,,0.06321839080459771,0.09063573883161512,,,555,286
33,33,5,1,5,1,1,1,281,136,274,150,95, ,0.06321839080459771,0.09063573883161512,,,555,286
34,34,2,1,6,0,0,0,225,324,45,26,-1,,0.037431941923774956,0.14475945017182132,,,270,350
35,35,3,1,6,1,0,0,225,324,45,26,-1,,0.037431941923774956,0.14475945017182132,,,270,350
36,36,4,1,6,1,1,0,225,324,45,26,-1,,0.037431941923774956,0.14475945017182132,,,270,350
37,37,5,1,6,1,1,1,225,324,45,26,96,(12),0.037431941923774956,0.14475945017182132,,,270,350
38,38,2,1,7,0,0,0,225,395,378,53,-1,,0.06261343012704174,0.18105670103092783,,,603,448
39,39,3,1,7,1,0,0,225,395,378,53,-1,,0.06261343012704174,0.18105670103092783,,,603,448
40,40,4,1,7,1,1,0,225,395,262,26,-1,,0.05384150030248034,0.17525773195876287,,,487,421
41,41,5,1,7,1,1,1,225,395,45,26,95,(43),0.037431941923774956,0.17525773195876287,,,270,421
42,42,5,1,7,1,1,2,286,397,48,18,95,Date,0.04688445251058681,0.17439862542955326,,,334,415
43,43,5,1,7,1,1,3,342,397,20,18,96,of,0.05323653962492438,0.17439862542955326,,,362,415
44,44,5,1,7,1,1,4,370,397,117,23,96,publication:,0.0648064125831821,0.17547250859106528,,,487,420
45,45,4,1,7,1,2,0,286,430,317,18,-1,,0.06722625529340592,0.18857388316151202,,,603,448
46,46,5,1,7,1,2,1,286,430,117,18,96,07.11.2018,0.052102238354506954,0.18857388316151202,publication_date,07.11.2018,403,448
47,47,5,1,7,1,2,2,426,430,84,18,95,Bulletin,0.07078039927404718,0.18857388316151202,,,510,448
48,48,5,1,7,1,2,3,519,430,84,18,95,2018/45,0.08484573502722323,0.18857388316151202,,,603,448
49,49,2,1,8,0,0,0,225,493,402,26,-1,,0.06442831215970962,0.21735395189003437,,,627,519
50,50,3,1,8,1,0,0,225,493,402,26,-1,,0.06442831215970962,0.21735395189003437,,,627,519
51,51,4,1,8,1,1,0,225,493,402,26,-1,,0.06442831215970962,0.21735395189003437,,,627,519
52,52,5,1,8,1,1,1,225,493,45,26,95,(21),0.037431941923774956,0.21735395189003437,,,270,519
53,53,5,1,8,1,1,2,285,495,115,23,96,Application,0.051799758015728975,0.21756872852233677,,,400,518
54,54,5,1,8,1,1,3,410,495,83,18,93,number:,0.06828493647912885,0.21649484536082475,,,493,513
55,55,5,1,8,1,1,4,505,495,122,18,91,18180234.9,0.08560193587416817,0.21649484536082475,application_number,18180234.9,627,513
56,56,2,1,9,0,0,0,225,559,325,26,-1,,0.05860556563823351,0.24570446735395188,,,550,585
57,57,3,1,9,1,0,0,225,559,325,26,-1,,0.05860556563823351,0.24570446735395188,,,550,585
58,58,4,1,9,1,1,0,225,559,325,26,-1,,0.05860556563823351,0.24570446735395188,,,550,585
59,59,5,1,9,1,1,1,225,559,45,26,96,(22),0.037431941923774956,0.24570446735395188,,,270,585
60,60,5,1,9,1,1,2,286,561,48,18,96,Date,0.04688445251058681,0.24484536082474226,,,334,579
61,61,5,1,9,1,1,3,342,566,12,13,96,of,0.05263157894736842,0.24591924398625428,,,354,579
62,62,5,1,9,1,1,4,355,561,67,23,96,filing:,0.058756805807622506,0.24591924398625428,,,422,584
63,63,5,1,9,1,1,5,432,561,118,18,96,05.02.2015,0.07425892316999395,0.24484536082474226,filing_date,05.02.2015,550,579
64,64,2,1,10,0,0,0,1002,245,458,38,-1,,0.18617664851784635,0.1134020618556701,,,1460,283
65,65,3,1,10,1,0,0,1002,245,458,38,-1,,0.18617664851784635,0.1134020618556701,,,1460,283
66,66,4,1,10,1,1,0,1002,245,458,38,-1,,0.18617664851784635,0.1134020618556701,,,1460,283
67,67,5,1,10,1,1,1,1002,256,44,27,74,(11),0.15486993345432548,0.11576460481099657,,,1046,283
68,68,5,1,10,1,1,2,1146,245,52,32,96,EP,0.17725347852389595,0.11211340206185567,number,EP,1198,277
69,69,5,1,10,1,1,3,1214,245,20,32,93,3,0.1851179673321234,0.11211340206185567,number,3,1234,277
70,70,5,1,10,1,1,4,1249,245,68,32,92,399,0.1940411373260738,0.11211340206185567,number,399,1317,277
71,71,5,1,10,1,1,5,1332,245,67,32,91,712,0.20651845130066546,0.11211340206185567,number,712,1399,277
72,72,5,1,10,1,1,6,1413,245,47,32,87,A1,0.21725650332728372,0.11211340206185567,number,A1,1460,277
73,73,2,1,11,0,0,0,577,319,537,26,-1,,0.1278735632183908,0.14261168384879724,,,1114,345
74,74,3,1,11,1,0,0,577,319,537,26,-1,,0.1278735632183908,0.14261168384879724,,,1114,345
75,75,4,1,11,1,1,0,577,319,537,26,-1,,0.1278735632183908,0.14261168384879724,,,1114,345
76,76,5,1,11,1,1,1,577,319,156,26,95,EUROPEAN,0.09906231094978826,0.14261168384879724,,,733,345
77,77,5,1,11,1,1,2,735,320,135,24,95,PATENT,0.12137023593466424,0.14261168384879724,,,870,344
78,78,5,1,11,1,1,3,873,319,241,26,96,APPLICATION,0.1502571082879613,0.14261168384879724,,,1114,345
79,79,2,1,12,0,0,0,862,395,126,26,-1,,0.13989715668481548,0.17525773195876287,,,988,421
80,80,3,1,12,1,0,0,862,395,126,26,-1,,0.13989715668481548,0.17525773195876287,,,988,421
81,81,4,1,12,1,1,0,862,395,126,26,-1,,0.13989715668481548,0.17525773195876287,,,988,421
82,82,5,1,12,1,1,1,862,395,44,26,67,(51),0.1336963097398669,0.17525773195876287,,,906,421
83,83,5,1,12,1,1,2,923,397,25,18,93,Int,0.1414851784633999,0.17439862542955326,,,948,415
84,84,5,1,12,1,1,3,955,397,33,18,65,Cl:,0.14692982456140352,0.17439862542955326,,,988,415
85,85,2,1,13,0,0,0,922,425,454,21,-1,,0.17377495462794917,0.1870704467353952,,,1376,446
86,86,3,1,13,1,0,0,922,425,454,21,-1,,0.17377495462794917,0.1870704467353952,,,1376,446
87,87,4,1,13,1,1,0,922,425,454,21,-1,,0.17377495462794917,0.1870704467353952,,,1376,446
88,88,5,1,13,1,1,1,922,428,57,18,75,HO4L,0.14375378100423472,0.1877147766323024,class_international,H04L,979,446
89,89,5,1,13,1,1,2,987,428,59,18,94,27134,0.15373563218390804,0.1877147766323024,class_international,27/34,1046,446
90,90,5,1,13,1,1,3,1051,425,67,16,85,(2006.01),0.16401996370235936,0.18599656357388317,,,1118,441
91,91,5,1,13,1,1,4,1193,428,57,18,84,HO4L,0.18473986690865093,0.1877147766323024,,,1250,446
92,92,5,1,13,1,1,5,1260,428,44,18,91,1100,0.1938898971566848,0.1877147766323024,,,1304,446
93,93,5,1,13,1,1,6,1309,425,67,16,80,(2006.07),0.20303992740471868,0.18599656357388317,,,1376,441
94,94,2,1,14,0,0,0,224,613,1243,4,-1,,0.1278735632183908,0.26417525773195877,,,1467,617
95,95,3,1,14,1,0,0,224,613,1243,4,-1,,0.1278735632183908,0.26417525773195877,,,1467,617
96,96,4,1,14,1,1,0,224,613,1243,4,-1,,0.1278735632183908,0.26417525773195877,,,1467,617
97,97,5,1,14,1,1,1,224,613,1243,4,95, ,0.1278735632183908,0.26417525773195877,,,1467,617
98,98,2,1,15,0,0,0,225,631,599,119,-1,,0.07932546884452511,0.296606529209622,,,824,750
99,99,3,1,15,1,0,0,225,631,599,119,-1,,0.07932546884452511,0.296606529209622,,,824,750
100,100,4,1,15,1,1,0,225,631,388,27,-1,,0.0633696309739867,0.2768470790378007,,,613,658
101,101,5,1,15,1,1,1,225,631,45,27,96,(84),0.037431941923774956,0.2768470790378007,,,270,658
102,102,5,1,15,1,1,2,286,633,118,23,96,Designated,0.052177858439201454,0.2768470790378007,,,404,656
103,103,5,1,15,1,1,3,413,633,119,23,96,Contracting,0.07146098003629764,0.2768470790378007,,,532,656
104,104,5,1,15,1,1,4,542,633,71,19,96,States:,0.08734119782214156,0.2759879725085911,,,613,652
105,105,4,1,15,1,2,0,285,666,537,18,-1,,0.08371143375680581,0.28994845360824745,,,822,684
106,106,5,1,15,1,2,1,285,666,31,18,94,AL,0.04544767090139141,0.28994845360824745,,,316,684
107,107,5,1,15,1,2,2,323,666,31,18,94,AT,0.05119479733817302,0.28994845360824745,,,354,684
108,108,5,1,15,1,2,3,363,666,30,18,96,BE,0.05716878402903811,0.28994845360824745,,,393,684
109,109,5,1,15,1,2,4,403,666,32,18,96,BG,0.0633696309739867,0.28994845360824745,,,435,684
110,110,5,1,15,1,2,5,445,666,31,18,96,CH,0.06964609800362977,0.28994845360824745,,,476,684
111,111,5,1,15,1,2,6,486,666,32,18,95,CY,0.07592256503327284,0.28994845360824745,,,518,684
112,112,5,1,15,1,2,7,526,666,30,18,93,CZ,0.08182093163944344,0.28994845360824745,,,556,684
113,113,5,1,15,1,2,8,565,666,30,18,93,DE,0.08771929824561403,0.28994845360824745,,,595,684
114,114,5,1,15,1,2,9,605,666,32,18,95,DK,0.09392014519056262,0.28994845360824745,,,637,684
115,115,5,1,15,1,2,10,646,666,29,18,95,EE,0.0998941318814277,0.28994845360824745,,,675,684
116,116,5,1,15,1,2,11,684,666,29,18,93,ES,0.10564125831820932,0.28994845360824745,,,713,684
117,117,5,1,15,1,2,12,723,666,57,18,90,FIFR,0.11365698729582577,0.28994845360824745,,,780,684
118,118,5,1,15,1,2,13,788,666,34,18,95,GB,0.12174833635813673,0.28994845360824745,,,822,684
119,119,4,1,15,1,3,0,285,699,539,18,-1,,0.0838626739261948,0.30412371134020616,,,824,717
120,120,5,1,15,1,3,1,285,699,297,18,83,GRHRHUIEISITLILTLU,0.06556261343012704,0.30412371134020616,,,582,717
121,121,5,1,15,1,3,2,591,699,28,18,85,LV,0.09150030248033877,0.30412371134020616,,,619,717
122,122,5,1,15,1,3,3,627,699,35,18,85,MC,0.09747428917120388,0.30412371134020616,,,662,717
123,123,5,1,15,1,3,4,670,699,35,18,94,MK,0.10397761645493044,0.30412371134020616,,,705,717
124,124,5,1,15,1,3,5,713,699,32,18,91,MT,0.11025408348457351,0.30412371134020616,,,745,717
125,125,5,1,15,1,3,6,753,699,29,18,49,NL,0.11607683000604961,0.30412371134020616,,,782,717
126,126,5,1,15,1,3,7,791,699,33,18,49,NO,0.1221264367816092,0.30412371134020616,,,824,717
127,127,4,1,15,1,4,0,286,732,336,18,-1,,0.06866303690260134,0.31829896907216493,,,622,750
128,128,5,1,15,1,4,1,286,732,28,18,93,PL,0.045372050816696916,0.31829896907216493,,,314,750
129,129,5,1,15,1,4,2,323,732,29,18,92,PT,0.05104355716878403,0.31829896907216493,,,352,750
130,130,5,1,15,1,4,3,360,732,58,18,92,RORS,0.058832425892317,0.31829896907216493,,,418,750
131,131,5,1,15,1,4,4,420,732,52,18,92,SE,0.06745311554748941,0.31829896907216493,,,472,750
132,132,5,1,15,1,4,5,480,732,20,18,95,SI,0.07410768300060495,0.31829896907216493,,,500,750
133,133,5,1,15,1,4,6,510,732,31,18,93,SK,0.0794767090139141,0.31829896907216493,,,541,750
134,134,5,1,15,1,4,7,550,732,72,18,90,SMTR,0.08862673926194797,0.31829896907216493,,,622,750
135,135,2,1,16,0,0,0,225,795,513,53,-1,,0.07282214156079855,0.35287800687285226,,,738,848
136,136,3,1,16,1,0,0,225,795,513,53,-1,,0.07282214156079855,0.35287800687285226,,,738,848
137,137,4,1,16,1,1,0,225,795,513,27,-1,,0.07282214156079855,0.3472938144329897,,,738,822
138,138,5,1,16,1,1,1,225,795,45,27,96,(30),0.037431941923774956,0.3472938144329897,,,270,822
139,139,5,1,16,1,1,2,286,797,77,23,96,Priority:,0.04907743496672716,0.3472938144329897,,,363,820
140,140,5,1,16,1,1,3,383,797,119,19,96,05.02.2014,0.06692377495462795,0.34643470790378006,priority_date_eu,05.02.2014,502,816
141,141,5,1,16,1,1,4,520,797,30,19,96,US,0.0809134906231095,0.34643470790378006,,,550,816
142,142,5,1,16,1,1,5,559,797,157,19,93,201461936029,0.09641560798548095,0.34643470790378006,,,716,816
143,143,5,1,16,1,1,6,725,797,13,19,93,P,0.11063218390804598,0.34643470790378006,,,738,816
144,144,4,1,16,1,2,0,383,830,355,18,-1,,0.08477011494252873,0.3603951890034364,,,738,848
145,145,5,1,16,1,2,1,383,830,119,18,91,28.02.2014,0.06692377495462795,0.3603951890034364,,,502,848
146,146,5,1,16,1,2,2,520,830,30,18,96,US,0.0809134906231095,0.3603951890034364,,,550,848
147,147,5,1,16,1,2,3,559,830,157,18,93,201461945868,0.09641560798548095,0.3603951890034364,,,716,848
148,148,5,1,16,1,2,4,725,830,13,18,90,P,0.11063218390804598,0.3603951890034364,,,738,848
149,149,2,1,17,0,0,0,225,893,596,87,-1,,0.07909860859044163,0.4022766323024055,,,821,980
150,150,3,1,17,1,0,0,225,893,596,87,-1,,0.07909860859044163,0.4022766323024055,,,821,980
151,151,4,1,17,1,1,0,225,893,596,27,-1,,0.07909860859044163,0.3893900343642612,,,821,920
152,152,5,1,17,1,1,1,225,893,45,27,96,(62),0.037431941923774956,0.3893900343642612,,,270,920
153,153,5,1,17,1,1,2,286,895,107,19,96,Document,0.05134603750756201,0.38853092783505155,,,393,914
154,154,5,1,17,1,1,3,402,895,105,23,95,number(s),0.06873865698729582,0.3893900343642612,,,507,918
155,155,5,1,17,1,1,4,516,895,20,19,96,of,0.07955232909860858,0.38853092783505155,,,536,914
156,156,5,1,17,1,1,5,542,895,32,19,96,the,0.08439201451905626,0.38853092783505155,,,574,914
157,157,5,1,17,1,1,6,582,895,66,19,96,earlier,0.09301270417422867,0.38853092783505155,,,648,914
158,158,5,1,17,1,1,7,655,895,140,23,95,application(s),0.10964912280701754,0.3893900343642612,,,795,918
159,159,5,1,17,1,1,8,805,895,16,19,96,in,0.12295825771324864,0.38853092783505155,,,821,914
160,160,4,1,17,1,2,0,286,929,308,18,-1,,0.06654567453115548,0.4029209621993127,,,594,947
161,161,5,1,17,1,2,1,286,929,121,18,96,accordance,0.05240471869328494,0.4029209621993127,,,407,947
162,162,5,1,17,1,2,2,415,929,40,18,96,with,0.06578947368421052,0.4029209621993127,,,455,947
163,163,5,1,17,1,2,3,464,929,35,18,95,Art.,0.07282214156079855,0.4029209621993127,,,499,947
164,164,5,1,17,1,2,4,508,929,25,18,95,76,0.07872050816696914,0.4029209621993127,,,533,947
165,165,5,1,17,1,2,5,542,929,52,18,96,EPC:,0.08590441621294616,0.4029209621993127,,,594,947
166,166,4,1,17,1,3,0,286,961,250,19,-1,,0.06215970961887477,0.4168814432989691,,,536,980
167,167,5,1,17,1,3,1,286,961,124,19,54,15746125.2,0.05263157894736842,0.4168814432989691,,,410,980
168,168,5,1,17,1,3,2,417,961,7,19,54,/,0.06359649122807018,0.4168814432989691,,,424,980
169,169,5,1,17,1,3,3,432,961,11,19,80,3,0.066167574107683,0.4168814432989691,,,443,980
170,170,5,1,17,1,3,4,452,961,37,19,80,075,0.07115849969751967,0.4168814432989691,,,489,980
171,171,5,1,17,1,3,5,499,961,37,19,94,125,0.07826678765880218,0.4168814432989691,,,536,980
172,172,2,1,18,0,0,0,225,1025,515,57,-1,,0.07297338173018754,0.4525343642611684,,,740,1082
173,173,3,1,18,1,0,0,225,1025,515,57,-1,,0.07297338173018754,0.4525343642611684,,,740,1082
174,174,4,1,18,1,1,0,225,1025,515,26,-1,,0.07297338173018754,0.44587628865979384,,,740,1051
175,175,5,1,18,1,1,1,225,1025,45,26,96,(71),0.037431941923774956,0.44587628865979384,,,270,1051
176,176,5,1,18,1,1,2,285,1027,103,23,96,Applicant:,0.05089231699939504,0.44609106529209624,,,388,1050
177,177,5,1,18,1,1,3,397,1027,105,23,96,Samsung,0.06798245614035088,0.44609106529209624,applicant_line_1,Samsung,502,1050
178,178,5,1,18,1,1,4,512,1027,126,18,93,Electronics,0.08696309739866909,0.44501718213058417,applicant_line_1,Electronics,638,1045
179,179,5,1,18,1,1,5,647,1027,42,21,92,"Co.,",0.10102843315184513,0.44566151202749144,applicant_line_1,"Co.,",689,1048
180,180,5,1,18,1,1,6,699,1027,41,18,96,Ltd.,0.1088173018753781,0.44501718213058417,applicant_line_1,Ltd.,740,1045
181,181,4,1,18,1,2,0,286,1059,274,23,-1,,0.06397459165154265,0.45983676975945015,,,560,1082
182,182,5,1,18,1,2,1,286,1059,145,23,95,Gyeonggi-do,0.05421960072595281,0.45983676975945015,,,431,1082
183,183,5,1,18,1,2,2,441,1059,63,19,96,16677,0.07146098003629764,0.45897766323024053,,,504,1078
184,184,5,1,18,1,2,3,512,1059,48,23,96,(KR),0.08106473079249849,0.45983676975945015,,,560,1082
185,185,2,1,19,0,0,0,225,1123,356,91,-1,,0.06094978826376286,0.5019329896907216,,,581,1214
186,186,3,1,19,1,0,0,225,1123,356,91,-1,,0.06094978826376286,0.5019329896907216,,,581,1214
187,187,4,1,19,1,1,0,225,1123,163,27,-1,,0.046355111917725345,0.4881872852233677,,,388,1150
188,188,5,1,19,1,1,1,225,1123,45,27,93,(72),0.037431941923774956,0.4881872852233677,,,270,1150
189,189,5,1,19,1,1,2,287,1125,101,19,93,Inventors:,0.05104355716878403,0.48732817869415807,,,388,1144
190,190,4,1,19,1,2,0,262,1158,190,22,-1,,0.053992740471869326,0.502147766323024,,,452,1180
191,191,5,1,19,1,2,1,262,1163,7,8,56,+,0.04015426497277677,0.5012886597938144,,,269,1171
192,192,5,1,19,1,2,2,286,1158,86,18,93,"MYUNG,",0.04975801572897762,0.5012886597938144,inventor_line_1,"MYUNG,",372,1176
193,193,5,1,19,1,2,3,375,1158,77,22,92,Se-ho,0.06253781004234725,0.502147766323024,inventor_line_1,Se-ho,452,1180
194,194,4,1,19,1,3,0,285,1191,296,23,-1,,0.06548699334543255,0.5165378006872853,,,581,1214
195,195,5,1,19,1,3,1,285,1191,86,18,96,446-987,0.049606775559588624,0.5154639175257731,,,371,1209
196,196,5,1,19,1,3,2,379,1191,146,23,96,Gyeonggi-do,0.06836055656382335,0.5165378006872853,,,525,1214
197,197,5,1,19,1,3,3,534,1191,47,23,96,(KR),0.08431639443436177,0.5165378006872853,,,581,1214
198,198,2,1,20,0,0,0,844,614,4,632,-1,,0.1279491833030853,0.39948453608247425,,,848,1246
199,199,3,1,20,1,0,0,844,614,4,632,-1,,0.1279491833030853,0.39948453608247425,,,848,1246
200,200,4,1,20,1,1,0,844,614,4,632,-1,,0.1279491833030853,0.39948453608247425,,,848,1246
201,201,5,1,20,1,1,1,844,614,4,632,95, ,0.1279491833030853,0.39948453608247425,,,848,1246
202,202,2,1,21,0,0,0,898,633,418,253,-1,,0.16742286751361163,0.32624570446735396,,,1316,886
203,203,3,1,21,1,0,0,898,633,418,253,-1,,0.16742286751361163,0.32624570446735396,,,1316,886
204,204,4,1,21,1,1,0,898,633,306,22,-1,,0.1589534180278282,0.2766323024054983,,,1204,655
205,205,5,1,21,1,1,1,898,639,7,7,66,¬´,0.13634301270417423,0.2759879725085911,,,905,646
206,206,5,1,21,1,1,2,923,633,156,19,92,"MOUHOUCHE,",0.1513914095583787,0.2759879725085911,,,1079,652
207,207,5,1,21,1,1,3,1082,633,122,22,92,Belkacem,0.17286751361161526,0.2766323024054983,,,1204,655
208,208,4,1,21,1,2,0,922,666,267,23,-1,,0.15963399879007864,0.29102233676975947,,,1189,689
209,209,5,1,21,1,2,1,922,666,89,22,93,"Staines,",0.14617362371445855,0.29080756013745707,,,1011,688
210,210,5,1,21,1,2,2,1020,666,62,18,92,TW19,0.1589534180278282,0.28994845360824745,,,1082,684
211,211,5,1,21,1,2,3,1090,666,40,18,92,7EJ,0.16787658802177857,0.28994845360824745,,,1130,684
212,212,5,1,21,1,2,4,1140,666,49,23,95,(GB),0.17611917725347853,0.29102233676975947,,,1189,689
213,213,4,1,21,1,3,0,898,699,337,23,-1,,0.16129764065335753,0.30519759450171824,,,1235,722
214,214,5,1,21,1,3,1,898,704,7,8,41,¬´,0.13634301270417423,0.30412371134020616,,,905,712
215,215,5,1,21,1,3,2,923,699,94,18,92,"LOBETE,",0.14670296430732002,0.30412371134020616,,,1017,717
216,216,5,1,21,1,3,3,1019,699,138,23,91,Ansorregui,0.1645493042952208,0.30519759450171824,,,1157,722
217,217,5,1,21,1,3,4,1167,699,68,18,96,Daniel,0.18163944343617666,0.30412371134020616,,,1235,717
218,218,4,1,21,1,4,0,922,732,394,23,-1,,0.1692377495462795,0.31937285223367695,,,1316,755
219,219,5,1,21,1,4,1,922,732,89,22,96,"Staines,",0.14617362371445855,0.31915807560137455,,,1011,754
220,220,5,1,21,1,4,2,1021,732,113,18,92,Middlesex,0.1629612825166364,0.31829896907216493,,,1134,750
221,221,5,1,21,1,4,3,1142,732,62,18,92,TW18,0.17740471869328495,0.31829896907216493,,,1204,750
222,222,5,1,21,1,4,4,1212,732,46,20,92,2EQ,0.1867816091954023,0.31872852233676974,,,1258,752
223,223,5,1,21,1,4,5,1267,732,49,23,96,(GB),0.19532667876588022,0.31937285223367695,,,1316,755
224,224,4,1,21,1,5,0,898,765,226,23,-1,,0.1529038112522686,0.3335481099656357,,,1124,788
225,225,5,1,21,1,5,1,898,770,7,8,62,¬´,0.13634301270417423,0.3324742268041237,,,905,778
226,226,5,1,21,1,5,2,923,765,47,21,93,"KIM,",0.14314882032667878,0.3331185567010309,,,970,786
227,227,5,1,21,1,5,3,980,765,144,23,92,Kyung-joong,0.15910465819721717,0.3335481099656357,,,1124,788
228,228,4,1,21,1,6,0,924,797,212,23,-1,,0.1557773744706594,0.3472938144329897,,,1136,820
229,229,5,1,21,1,6,1,924,797,83,19,96,152-778,0.14602238354506958,0.34643470790378006,,,1007,816
230,230,5,1,21,1,6,2,1016,797,63,19,96,Seoul,0.15842407743496673,0.34643470790378006,,,1079,816
231,231,5,1,21,1,6,3,1088,797,48,23,96,(KR),0.16817906836055657,0.3472938144329897,,,1136,820
232,232,4,1,21,1,7,0,898,830,214,23,-1,,0.15199637023593465,0.36146907216494845,,,1112,853
233,233,5,1,21,1,7,1,898,835,7,8,79,¬´,0.13634301270417423,0.3603951890034364,,,905,843
234,234,5,1,21,1,7,2,922,830,81,18,91,"JEONG,",0.1455686630369026,0.3603951890034364,,,1003,848
235,235,5,1,21,1,7,3,1006,830,106,23,91,Hong-sil,0.1601633393829401,0.36146907216494845,,,1112,853
236,236,4,1,21,1,8,0,922,863,296,23,-1,,0.161826981246219,0.3756443298969072,,,1218,886
237,237,5,1,21,1,8,1,922,863,83,18,96,443-751,0.14571990320629158,0.3745704467353952,,,1005,881
238,238,5,1,21,1,8,2,1015,863,146,23,96,Gyeonggi-do,0.1645493042952208,0.3756443298969072,,,1161,886
239,239,5,1,21,1,8,3,1170,863,48,23,96,(KR),0.18058076225045372,0.3756443298969072,,,1218,886
240,240,2,1,22,0,0,0,862,927,490,90,-1,,0.16742286751361163,0.4175257731958763,,,1352,1017
241,241,3,1,22,1,0,0,862,927,490,90,-1,,0.16742286751361163,0.4175257731958763,,,1352,1017
242,242,4,1,22,1,1,0,862,927,490,26,-1,,0.16742286751361163,0.40378006872852235,,,1352,953
243,243,5,1,22,1,1,1,862,927,44,26,95,(74),0.1336963097398669,0.40378006872852235,,,906,953
244,244,5,1,22,1,1,2,923,929,163,23,96,Representative:,0.15192075015124018,0.40399484536082475,,,1086,952
245,245,5,1,22,1,1,3,1094,929,116,23,96,Appleyard,0.17422867513611615,0.40399484536082475,representative_line_1_eu,Appleyard,1210,952
246,246,5,1,22,1,1,4,1220,929,51,18,96,Lees,0.18836963097398668,0.4029209621993127,representative_line_1_eu,Lees,1271,947
247,247,5,1,22,1,1,5,1281,929,20,18,96,IP,0.19525105868118572,0.4029209621993127,representative_line_1_eu,IP,1301,947
248,248,5,1,22,1,1,6,1310,929,42,18,96,LLP,0.2013006654567453,0.4029209621993127,representative_line_1_eu,LLP,1352,947
249,249,4,1,22,1,2,0,923,961,155,19,-1,,0.1513157894736842,0.4168814432989691,,,1078,980
250,250,5,1,22,1,2,1,923,961,23,19,96,15,0.1413339382940109,0.4168814432989691,,,946,980
251,251,5,1,22,1,2,2,955,961,58,19,96,Clare,0.14882032667876588,0.4168814432989691,,,1013,980
252,252,5,1,22,1,2,3,1022,961,56,19,96,Road,0.1588021778584392,0.4168814432989691,,,1078,980
253,253,4,1,22,1,3,0,923,994,239,23,-1,,0.15766787658802178,0.4319158075601375,,,1162,1017
254,254,5,1,22,1,3,1,923,994,76,18,90,Halifax,0.1453418027828191,0.43084192439862545,,,999,1012
255,255,5,1,22,1,3,2,1008,994,41,18,86,HX1,0.15555051421657592,0.43084192439862545,,,1049,1012
256,256,5,1,22,1,3,3,1060,994,46,18,86,2HY,0.16379310344827586,0.43084192439862545,,,1106,1012
257,257,5,1,22,1,3,4,1113,994,49,23,95,(GB),0.1720356926799758,0.4319158075601375,,,1162,1017
258,258,2,1,23,0,0,0,862,1059,99,19,-1,,0.13785541439806412,0.45897766323024053,,,961,1078
259,259,3,1,23,1,0,0,862,1059,99,19,-1,,0.13785541439806412,0.45897766323024053,,,961,1078
260,260,4,1,23,1,1,0,862,1059,99,19,-1,,0.13785541439806412,0.45897766323024053,,,961,1078
261,261,5,1,23,1,1,1,862,1059,99,19,96,Remarks:,0.13785541439806412,0.45897766323024053,,,961,1078
262,262,2,1,24,0,0,0,922,1092,522,84,-1,,0.17891712038717483,0.48711340206185566,,,1444,1176
263,263,3,1,24,1,0,0,922,1092,522,84,-1,,0.17891712038717483,0.48711340206185566,,,1444,1176
264,264,4,1,24,1,1,0,922,1092,477,23,-1,,0.17551421657592256,0.4740120274914089,,,1399,1115
265,265,5,1,24,1,1,1,922,1092,43,18,96,This,0.1426950998185118,0.4729381443298969,,,965,1110
266,266,5,1,24,1,1,2,973,1092,112,23,96,application,0.15562613430127042,0.4740120274914089,,,1085,1115
267,267,5,1,24,1,1,3,1093,1097,42,13,96,was,0.16848154869933454,0.4740120274914089,,,1135,1110
268,268,5,1,24,1,1,4,1142,1092,43,18,96,filed,0.17596793708408953,0.4729381443298969,,,1185,1110
269,269,5,1,24,1,1,5,1193,1097,25,13,96,on,0.1823200241984271,0.4740120274914089,,,1218,1110
270,270,5,1,24,1,1,6,1226,1092,121,18,96,27-06-2018,0.19457047791893528,0.4729381443298969,,,1347,1110
271,271,5,1,24,1,1,7,1355,1097,24,13,95,as,0.20674531155474893,0.4740120274914089,,,1379,1110
272,272,5,1,24,1,1,8,1388,1097,11,13,95,a,0.21075317604355717,0.4740120274914089,,,1399,1110
273,273,4,1,24,1,2,0,922,1125,522,23,-1,,0.17891712038717483,0.4881872852233677,,,1444,1148
274,274,5,1,24,1,2,1,922,1125,96,19,96,divisional,0.14670296430732002,0.48732817869415807,,,1018,1144
275,275,5,1,24,1,2,2,1026,1125,112,23,96,application,0.16364186327888688,0.4881872852233677,,,1138,1148
276,276,5,1,24,1,2,3,1147,1126,19,18,96,to,0.17490925589836662,0.48754295532646047,,,1166,1144
277,277,5,1,24,1,2,4,1174,1125,31,19,96,the,0.17990018148820328,0.48732817869415807,,,1205,1144
278,278,5,1,24,1,2,5,1214,1125,112,23,96,application,0.19207501512401695,0.4881872852233677,,,1326,1148
279,279,5,1,24,1,2,6,1336,1125,108,19,96,mentioned,0.2102238354506957,0.48732817869415807,,,1444,1144
280,280,4,1,24,1,3,0,923,1158,209,18,-1,,0.15539927404718692,0.5012886597938144,,,1132,1176
281,281,5,1,24,1,3,1,923,1158,50,18,92,under,0.14337568058076225,0.5012886597938144,,,973,1176
282,282,5,1,24,1,3,2,975,1158,61,18,76,INID,0.15207199032062915,0.5012886597938144,,,1036,1176
283,283,5,1,24,1,3,3,1044,1158,50,18,96,code,0.16167574107683,0.5012886597938144,,,1094,1176
284,284,5,1,24,1,3,4,1103,1158,29,18,96,62.,0.16901088929219601,0.5012886597938144,,,1132,1176
285,285,2,1,25,0,0,0,224,1243,1243,4,-1,,0.1278735632183908,0.5347938144329897,,,1467,1247
286,286,3,1,25,1,0,0,224,1243,1243,4,-1,,0.1278735632183908,0.5347938144329897,,,1467,1247
287,287,4,1,25,1,1,0,224,1243,1243,4,-1,,0.1278735632183908,0.5347938144329897,,,1467,1247
288,288,5,1,25,1,1,1,224,1243,1243,4,95, ,0.1278735632183908,0.5347938144329897,,,1467,1247
289,289,2,1,26,0,0,0,225,1263,45,26,-1,,0.037431941923774956,0.5481099656357389,,,270,1289
290,290,3,1,26,1,0,0,225,1263,45,26,-1,,0.037431941923774956,0.5481099656357389,,,270,1289
291,291,4,1,26,1,1,0,225,1263,45,26,-1,,0.037431941923774956,0.5481099656357389,,,270,1289
292,292,5,1,26,1,1,1,225,1263,45,26,96,(54),0.037431941923774956,0.5481099656357389,,,270,1289
293,293,2,1,27,0,0,0,224,1337,583,156,-1,,0.0779643073200242,0.6078178694158075,,,807,1493
294,294,3,1,27,1,0,0,224,1337,583,156,-1,,0.0779643073200242,0.6078178694158075,,,807,1493
295,295,4,1,27,1,1,0,225,1337,582,26,-1,,0.0780399274047187,0.5798969072164949,,,807,1363
296,296,5,1,27,1,1,1,225,1337,45,26,82,(57),0.037431941923774956,0.5798969072164949,,,270,1363
297,297,5,1,27,1,1,2,0,0,1653,2328,14,‚Äî,0.125,0.5,,,1653,2328
298,298,5,1,27,1,1,3,315,1339,141,23,87,Atransmitting,0.058303085299455534,0.5801116838487973,,,456,1362
299,299,5,1,27,1,1,4,462,1340,92,22,96,apparatus,0.07683000604960677,0.5803264604810997,,,554,1362
300,300,5,1,27,1,1,5,556,1339,32,18,92,is,0.08650937689050212,0.5790378006872853,,,588,1357
301,301,5,1,27,1,1,6,593,1339,103,18,92,disclosed.,0.09747428917120388,0.5790378006872853,,,696,1357
302,302,5,1,27,1,1,7,702,1339,40,18,93,The,0.10919540229885058,0.5790378006872853,,,742,1357
303,303,5,1,27,1,1,8,748,1340,59,17,92,trans-,0.1175892316999395,0.5792525773195877,,,807,1357
304,304,4,1,27,1,2,0,226,1372,581,23,-1,,0.07811554748941318,0.594286941580756,,,807,1395
305,305,5,1,27,1,2,1,226,1372,67,23,91,mitting,0.03924682395644283,0.594286941580756,,,293,1395
306,306,5,1,27,1,2,2,301,1373,105,22,96,apparatus,0.05346339987900786,0.5945017182130584,,,406,1395
307,307,5,1,27,1,2,3,415,1372,85,19,96,includes,0.0691923774954628,0.5934278350515464,,,500,1391
308,308,5,1,27,1,2,4,508,1377,24,14,96,an,0.07864488808227466,0.5945017182130584,,,532,1391
309,309,5,1,27,1,2,5,541,1372,77,19,96,encoder,0.08764367816091954,0.5934278350515464,,,618,1391
310,310,5,1,27,1,2,6,620,1373,32,18,96,to,0.09618874773139746,0.5936426116838488,,,652,1391
311,311,5,1,27,1,2,7,661,1372,79,23,93,perform,0.1059437386569873,0.594286941580756,,,740,1395
312,312,5,1,27,1,2,8,749,1372,58,19,92,chan-,0.117664851784634,0.5934278350515464,,,807,1391
313,313,4,1,27,1,3,0,226,1405,581,23,-1,,0.07811554748941318,0.6084621993127147,,,807,1428
314,314,5,1,27,1,3,1,226,1405,29,18,96,nel,0.03637326073805203,0.6073883161512027,,,255,1423
315,315,5,1,27,1,3,2,264,1405,95,23,96,encoding,0.047111312764670295,0.6084621993127147,,,359,1428
316,316,5,1,27,1,3,3,368,1405,41,18,97,with,0.058756805807622506,0.6073883161512027,,,409,1423
317,317,5,1,27,1,3,4,420,1406,77,22,96,respect,0.06934361766485178,0.6086769759450171,,,497,1428
318,318,5,1,27,1,3,5,505,1406,19,17,96,to,0.07781306715063521,0.6076030927835051,,,524,1423
319,319,5,1,27,1,3,6,535,1405,34,18,96,bits,0.08348457350272233,0.6073883161512027,,,569,1423
320,320,5,1,27,1,3,7,578,1405,38,18,96,and,0.09029038112522686,0.6073883161512027,,,616,1423
321,321,5,1,27,1,3,8,626,1406,93,22,96,generate,0.10170901391409558,0.6086769759450171,,,719,1428
322,322,5,1,27,1,3,9,728,1410,11,13,92,a,0.11093466424682395,0.6084621993127147,,,739,1423
323,323,5,1,27,1,3,10,749,1405,58,18,92,code-,0.117664851784634,0.6073883161512027,,,807,1423
324,324,4,1,27,1,4,0,224,1438,583,21,-1,,0.0779643073200242,0.6222079037800687,,,807,1459
325,325,5,1,27,1,4,1,224,1438,56,21,96,"word,",0.038112522686025406,0.6222079037800687,,,280,1459
326,326,5,1,27,1,4,2,292,1442,24,14,96,an,0.04597701149425287,0.6224226804123711,,,316,1456
327,327,5,1,27,1,4,3,328,1438,100,18,96,interleaver,0.05716878402903811,0.6215635738831615,,,428,1456
328,328,5,1,27,1,4,4,431,1438,34,18,96,to,0.0677555958862674,0.6215635738831615,,,465,1456
329,329,5,1,27,1,4,5,476,1438,101,18,96,interleave,0.07962794918330308,0.6215635738831615,,,577,1456
330,330,5,1,27,1,4,6,587,1438,31,18,96,the,0.0911222020568663,0.6215635738831615,,,618,1456
331,331,5,1,27,1,4,7,629,1438,107,21,96,"codeword,",0.10322141560798548,0.6222079037800687,,,736,1459
332,332,5,1,27,1,4,8,748,1438,37,18,95,and,0.11592558983666061,0.6215635738831615,,,785,1456
333,333,5,1,27,1,4,9,796,1442,11,14,95,a,0.12121899576527526,0.6224226804123711,,,807,1456
334,334,4,1,27,1,5,0,226,1470,581,23,-1,,0.07811554748941318,0.6363831615120275,,,807,1493
335,335,5,1,27,1,5,1,226,1470,104,19,96,modulator,0.04204476709013914,0.6355240549828178,,,330,1489
336,336,5,1,27,1,5,2,345,1471,18,18,96,to,0.05353901996370236,0.6357388316151202,,,363,1489
337,337,5,1,27,1,5,3,380,1475,44,18,96,map,0.060798548094373864,0.6374570446735395,,,424,1493
338,338,5,1,27,1,5,4,439,1470,32,19,96,the,0.06881427707199032,0.6355240549828178,,,471,1489
339,339,5,1,27,1,5,5,487,1470,114,19,96,interleaved,0.0822746521476104,0.6355240549828178,,,601,1489
340,340,5,1,27,1,5,6,618,1470,101,19,96,codeword,0.10110405323653962,0.6355240549828178,,,719,1489
341,341,5,1,27,1,5,7,735,1471,45,18,96,onto,0.11456442831215971,0.6357388316151202,,,780,1489
342,342,5,1,27,1,5,8,796,1475,11,14,96,a,0.12121899576527526,0.6365979381443299,,,807,1489
343,343,2,1,28,0,0,0,316,1263,825,21,-1,,0.11017846339987901,0.5470360824742269,,,1141,1284
344,344,3,1,28,1,0,0,316,1263,825,21,-1,,0.11017846339987901,0.5470360824742269,,,1141,1284
345,345,4,1,28,1,1,0,316,1263,825,21,-1,,0.11017846339987901,0.5470360824742269,,,1141,1284
346,346,5,1,28,1,1,1,316,1263,142,21,96,RECEIVING,0.05852994555353902,0.5470360824742269,title_line_1,RECEIVING,458,1284
347,347,5,1,28,1,1,2,468,1263,164,21,96,APPARATUS,0.08318209316394434,0.5470360824742269,title_line_1,APPARATUS,632,1284
348,348,5,1,28,1,1,3,641,1264,56,19,96,AND,0.10117967332123412,0.5470360824742269,title_line_1,AND,697,1283
349,349,5,1,28,1,1,4,707,1263,176,21,96,MODULATION,0.12023593466424683,0.5470360824742269,title_line_1,MODULATION,883,1284
350,350,5,1,28,1,1,5,895,1263,112,21,96,METHOD,0.14382940108892922,0.5470360824742269,title_line_1,METHOD,1007,1284
351,351,5,1,28,1,1,6,1016,1263,125,21,96,THEREOF,0.1631125226860254,0.5470360824742269,title_line_1,THEREOF,1141,1284
352,352,2,1,29,0,0,0,884,1339,582,117,-1,,0.17770719903206292,0.6003006872852233,,,1466,1456
353,353,3,1,29,1,0,0,884,1339,582,117,-1,,0.17770719903206292,0.6003006872852233,,,1466,1456
354,354,4,1,29,1,1,0,885,1339,580,23,-1,,0.17770719903206292,0.5801116838487973,,,1465,1362
355,355,5,1,29,1,1,1,885,1339,124,18,95,non-uniform,0.14322444041137325,0.5790378006872853,,,1009,1357
356,356,5,1,29,1,1,2,1026,1339,130,18,95,constellation,0.16500302480338777,0.5790378006872853,,,1156,1357
357,357,5,1,29,1,1,3,1172,1339,101,23,96,according,0.18489110707803993,0.5801116838487973,,,1273,1362
358,358,5,1,29,1,1,4,1290,1340,18,17,96,to,0.19646098003629764,0.5792525773195877,,,1308,1357
359,359,5,1,29,1,1,5,1324,1344,11,13,96,a,0.20107380520266183,0.5801116838487973,,,1335,1357
360,360,5,1,29,1,1,6,1352,1339,113,18,94,modulation,0.213021778584392,0.5790378006872853,,,1465,1357
361,361,4,1,29,1,2,0,884,1372,581,23,-1,,0.17763157894736842,0.594286941580756,,,1465,1395
362,362,5,1,29,1,2,1,884,1372,82,19,96,"scheme,",0.13989715668481548,0.5934278350515464,,,966,1391
363,363,5,1,29,1,2,2,969,1377,35,17,95,and,0.14919842710223835,0.5951460481099656,,,1004,1394
364,364,5,1,29,1,2,3,1006,1372,51,19,95,the,0.1560042347247429,0.5934278350515464,,,1057,1391
365,365,5,1,29,1,2,4,1065,1372,130,19,96,constellation,0.17090139140955837,0.5934278350515464,,,1195,1391
366,366,5,1,29,1,2,5,1204,1377,30,14,96,may,0.18436176648517846,0.5945017182130584,,,1234,1391
367,367,5,1,29,1,2,6,1236,1372,92,23,96,include,0.1938898971566848,0.594286941580756,,,1328,1395
368,368,5,1,29,1,2,7,1336,1372,129,19,96,constellation,0.2118118572292801,0.5934278350515464,,,1465,1391
369,369,4,1,29,1,3,0,885,1405,581,23,-1,,0.17778281911675742,0.6084621993127147,,,1466,1428
370,370,5,1,29,1,3,1,885,1405,61,23,96,points,0.1384603750756201,0.6084621993127147,,,946,1428
371,371,5,1,29,1,3,2,954,1405,76,18,96,defined,0.1500302480338778,0.6073883161512027,,,1030,1423
372,372,5,1,29,1,3,3,1040,1405,62,18,96,based,0.161978221415608,0.6073883161512027,,,1102,1423
373,373,5,1,29,1,3,4,1110,1410,25,13,96,on,0.16976709013914096,0.6084621993127147,,,1135,1423
374,374,5,1,29,1,3,5,1144,1405,75,18,96,various,0.17869026013309136,0.6073883161512027,,,1219,1423
375,375,5,1,29,1,3,6,1227,1405,63,18,96,tables,0.19033575317604357,0.6073883161512027,,,1290,1423
376,376,5,1,29,1,3,7,1299,1405,100,23,96,according,0.20402298850574713,0.6084621993127147,,,1399,1428
377,377,5,1,29,1,3,8,1408,1406,18,17,96,to,0.21430732002419842,0.6076030927835051,,,1426,1423
378,378,5,1,29,1,3,9,1434,1405,32,18,96,the,0.21929824561403508,0.6073883161512027,,,1466,1423
379,379,4,1,29,1,4,0,885,1438,210,18,-1,,0.14972776769509982,0.6215635738831615,,,1095,1456
380,380,5,1,29,1,4,1,885,1438,114,18,96,modulation,0.1424682395644283,0.6215635738831615,,,999,1456
381,381,5,1,29,1,4,2,1008,1438,87,18,95,scheme.,0.1590290381125227,0.6215635738831615,,,1095,1456
382,382,2,1,30,0,0,0,573,1761,636,2,-1,,0.13475499092558985,0.756872852233677,,,1209,1763
383,383,3,1,30,1,0,0,573,1761,636,2,-1,,0.13475499092558985,0.756872852233677,,,1209,1763
384,384,4,1,30,1,1,0,573,1761,636,2,-1,,0.13475499092558985,0.756872852233677,,,1209,1763
385,385,5,1,30,1,1,1,573,1761,636,2,95, ,0.13475499092558985,0.756872852233677,,,1209,1763
386,386,2,1,31,0,0,0,424,1551,760,256,-1,,0.12159709618874773,0.7212199312714777,,,1184,1807
387,387,3,1,31,1,0,0,424,1551,760,256,-1,,0.12159709618874773,0.7212199312714777,,,1184,1807
388,388,4,1,31,1,1,0,424,1551,124,28,-1,,0.073502722323049,0.6722508591065293,,,548,1579
389,389,5,1,31,1,1,1,424,1551,80,28,96,[Figure,0.07017543859649122,0.6722508591065293,,,504,1579
390,390,5,1,31,1,1,2,512,1551,36,24,96,36],0.08015728977616456,0.6713917525773195,,,548,1575
391,391,4,1,31,1,2,0,885,1598,56,30,-1,,0.13808227465214762,0.6928694158075601,,,941,1628
392,392,5,1,31,1,2,1,885,1598,56,30,90,3600,0.13808227465214762,0.6928694158075601,,,941,1628
393,393,4,1,31,1,3,0,634,1692,519,69,-1,,0.13513309134906232,0.7416237113402062,,,1153,1761
394,394,5,1,31,1,3,1,634,1692,35,69,0,o,0.0985329703569268,0.7416237113402062,,,669,1761
395,395,5,1,31,1,3,2,675,1692,12,23,95,0,0.10299455535390199,0.7317439862542955,,,687,1715
396,396,5,1,31,1,3,3,871,1692,52,69,18,on,0.13566243194192376,0.7416237113402062,,,923,1761
397,397,5,1,31,1,3,4,1101,1692,52,69,22,on,0.1704476709013914,0.7416237113402062,,,1153,1761
398,398,4,1,31,1,4,0,581,1784,603,23,-1,,0.13346944948578343,0.7712628865979382,,,1184,1807
399,399,5,1,31,1,4,1,581,1784,168,23,65,DEMODULATOR,0.10057471264367816,0.7712628865979382,,,749,1807
400,400,5,1,31,1,4,2,815,1785,177,22,41,DEINTERLEAVER|,0.1366454930429522,0.7714776632302406,,,992,1807
401,401,5,1,31,1,4,3,1080,1784,104,23,96,DECODER,0.17120387174833634,0.7712628865979382,,,1184,1807
402,402,2,1,32,0,0,0,716,2270,259,16,-1,,0.1278735632183908,0.9785223367697594,,,975,2286
403,403,3,1,32,1,0,0,716,2270,259,16,-1,,0.1278735632183908,0.9785223367697594,,,975,2286
404,404,4,1,32,1,1,0,716,2270,259,16,-1,,0.1278735632183908,0.9785223367697594,,,975,2286
405,405,5,1,32,1,1,1,716,2270,49,12,96,Printed,0.11199334543254688,0.9776632302405498,,,765,2282
406,406,5,1,32,1,1,2,771,2270,15,16,96,by,0.1177404718693285,0.9785223367697594,,,786,2286
407,407,5,1,32,1,1,3,792,2270,45,14,96,"Jouve,",0.12318511796733213,0.9780927835051546,,,837,2284
408,408,5,1,32,1,1,4,843,2270,41,12,96,75001,0.13059588626739263,0.9776632302405498,,,884,2282
409,409,5,1,32,1,1,5,893,2270,46,12,96,PARIS,0.1385359951603146,0.9776632302405498,,,939,2282
410,410,5,1,32,1,1,6,945,2270,30,16,95,(FR),0.14519056261343014,0.9785223367697594,,,975,2286
