,Unnamed: 0,level,page_num,block_num,par_num,line_num,word_num,left,top,width,height,conf,text,x,y,label,target,right,bottom
0,0,1,1,0,0,0,0,0,0,1653,2328,-1,,0.125,0.5,,,1653,2328
1,1,2,1,1,0,0,0,144,1905,31,328,-1,,0.02412280701754386,0.8887457044673539,,,175,2233
2,2,3,1,1,1,0,0,144,1905,31,328,-1,,0.02412280701754386,0.8887457044673539,,,175,2233
3,3,4,1,1,1,1,0,144,1905,31,328,-1,,0.02412280701754386,0.8887457044673539,,,175,2233
4,4,5,1,1,1,1,1,144,2179,30,54,95,EP,0.024047186932849365,0.947594501718213,,,174,2233
5,5,5,1,1,1,1,2,144,2142,31,21,95,3,0.02412280701754386,0.9246134020618557,,,175,2163
6,6,5,1,1,1,1,3,144,2061,31,65,95,401,0.02412280701754386,0.8992697594501718,,,175,2126
7,7,5,1,1,1,1,4,144,1969,31,70,90,322,0.02412280701754386,0.8608247422680413,,,175,2039
8,8,5,1,1,1,1,5,144,1905,30,50,89,A1,0.024047186932849365,0.8290378006872853,,,174,1955
9,9,2,1,2,0,0,0,225,147,292,26,-1,,0.056110102843315184,0.06872852233676977,,,517,173
10,10,3,1,2,1,0,0,225,147,292,26,-1,,0.056110102843315184,0.06872852233676977,,,517,173
11,11,4,1,2,1,1,0,225,147,292,26,-1,,0.056110102843315184,0.06872852233676977,,,517,173
12,12,5,1,2,1,1,1,225,147,45,26,96,(19),0.037431941923774956,0.06872852233676977,,,270,173
13,13,5,1,2,1,1,2,429,153,88,16,82,Europaisches,0.07153660012099214,0.06915807560137457,,,517,169
14,14,2,1,3,0,0,0,429,170,71,11,-1,,0.07025105868118572,0.07538659793814433,,,500,181
15,15,3,1,3,1,0,0,429,170,71,11,-1,,0.07025105868118572,0.07538659793814433,,,500,181
16,16,4,1,3,1,1,0,429,170,71,11,-1,,0.07025105868118572,0.07538659793814433,,,500,181
17,17,5,1,3,1,1,1,429,170,71,11,94,Patentamt,0.07025105868118572,0.07538659793814433,,,500,181
18,18,2,1,4,0,0,0,429,196,89,28,-1,,0.07161222020568662,0.09020618556701031,,,518,224
19,19,3,1,4,1,0,0,429,196,89,28,-1,,0.07161222020568662,0.09020618556701031,,,518,224
20,20,4,1,4,1,1,0,429,196,63,15,-1,,0.06964609800362977,0.08741408934707903,,,492,211
21,21,5,1,4,1,1,1,429,196,63,15,95,European,0.06964609800362977,0.08741408934707903,,,492,211
22,22,4,1,4,1,2,0,429,212,89,12,-1,,0.07161222020568662,0.0936426116838488,,,518,224
23,23,5,1,4,1,2,1,429,213,43,11,96,Patent,0.06813369630973987,0.0938573883161512,,,472,224
24,24,5,1,4,1,2,2,478,212,40,12,90,Office,0.07531760435571688,0.0936426116838488,,,518,224
25,25,2,1,5,0,0,0,429,239,109,28,-1,,0.07312462189957653,0.10867697594501718,,,538,267
26,26,3,1,5,1,0,0,429,239,109,28,-1,,0.07312462189957653,0.10867697594501718,,,538,267
27,27,4,1,5,1,1,0,429,239,109,15,-1,,0.07312462189957653,0.10588487972508591,,,538,254
28,28,5,1,5,1,1,1,429,239,40,12,93,Office,0.06790683605565638,0.1052405498281787,,,469,251
29,29,5,1,5,1,1,2,474,239,64,15,93,europ√©en,0.0765275257108288,0.10588487972508591,,,538,254
30,30,4,1,5,1,2,0,429,255,77,12,-1,,0.0707047791893527,0.11211340206185567,,,506,267
31,31,5,1,5,1,2,1,429,255,22,12,95,des,0.06654567453115548,0.11211340206185567,,,451,267
32,32,5,1,5,1,2,2,457,255,49,12,82,brevets,0.07282214156079855,0.11211340206185567,,,506,267
33,33,2,1,6,0,0,0,281,136,274,150,-1,,0.06321839080459771,0.09063573883161512,,,555,286
34,34,3,1,6,1,0,0,281,136,274,150,-1,,0.06321839080459771,0.09063573883161512,,,555,286
35,35,4,1,6,1,1,0,281,136,274,150,-1,,0.06321839080459771,0.09063573883161512,,,555,286
36,36,5,1,6,1,1,1,281,136,274,150,95, ,0.06321839080459771,0.09063573883161512,,,555,286
37,37,2,1,7,0,0,0,1002,245,458,38,-1,,0.18617664851784635,0.1134020618556701,,,1460,283
38,38,3,1,7,1,0,0,1002,245,458,38,-1,,0.18617664851784635,0.1134020618556701,,,1460,283
39,39,4,1,7,1,1,0,1002,245,458,38,-1,,0.18617664851784635,0.1134020618556701,,,1460,283
40,40,5,1,7,1,1,1,1002,256,44,27,74,(11),0.15486993345432548,0.11576460481099657,,,1046,283
41,41,5,1,7,1,1,2,1146,245,52,32,95,EP,0.17725347852389595,0.11211340206185567,number,EP,1198,277
42,42,5,1,7,1,1,3,1214,245,20,32,95,3,0.1851179673321234,0.11211340206185567,number,3,1234,277
43,43,5,1,7,1,1,4,1248,245,64,32,95,401,0.19358741681790684,0.11211340206185567,number,401,1312,277
44,44,5,1,7,1,1,5,1332,245,67,32,91,322,0.20651845130066546,0.11211340206185567,number,322,1399,277
45,45,5,1,7,1,1,6,1413,245,47,32,86,A1,0.21725650332728372,0.11211340206185567,number,A1,1460,277
46,46,2,1,8,0,0,0,225,319,889,31,-1,,0.10125529340592862,0.14368556701030927,,,1114,350
47,47,3,1,8,1,0,0,225,319,889,31,-1,,0.10125529340592862,0.14368556701030927,,,1114,350
48,48,4,1,8,1,1,0,225,319,889,31,-1,,0.10125529340592862,0.14368556701030927,,,1114,350
49,49,5,1,8,1,1,1,225,324,45,26,95,(12),0.037431941923774956,0.14475945017182132,,,270,350
50,50,5,1,8,1,1,2,577,319,156,26,95,EUROPEAN,0.09906231094978826,0.14261168384879724,,,733,345
51,51,5,1,8,1,1,3,735,320,135,24,95,PATENT,0.12137023593466424,0.14261168384879724,,,870,344
52,52,5,1,8,1,1,4,873,319,241,26,96,APPLICATION,0.1502571082879613,0.14261168384879724,,,1114,345
53,53,2,1,9,0,0,0,225,395,378,53,-1,,0.06261343012704174,0.18105670103092783,,,603,448
54,54,3,1,9,1,0,0,225,395,378,53,-1,,0.06261343012704174,0.18105670103092783,,,603,448
55,55,4,1,9,1,1,0,225,395,262,26,-1,,0.05384150030248034,0.17525773195876287,,,487,421
56,56,5,1,9,1,1,1,225,395,45,26,95,(43),0.037431941923774956,0.17525773195876287,,,270,421
57,57,5,1,9,1,1,2,286,397,48,18,95,Date,0.04688445251058681,0.17439862542955326,,,334,415
58,58,5,1,9,1,1,3,342,397,20,18,96,of,0.05323653962492438,0.17439862542955326,,,362,415
59,59,5,1,9,1,1,4,370,397,117,23,96,publication:,0.0648064125831821,0.17547250859106528,,,487,420
60,60,4,1,9,1,2,0,287,430,316,18,-1,,0.06730187537810042,0.18857388316151202,,,603,448
61,61,5,1,9,1,2,1,287,430,116,18,95,14.11.2018,0.052177858439201454,0.18857388316151202,publication_date,14.11.2018,403,448
62,62,5,1,9,1,2,2,426,430,84,18,95,Bulletin,0.07078039927404718,0.18857388316151202,,,510,448
63,63,5,1,9,1,2,3,519,430,84,18,96,2018/46,0.08484573502722323,0.18857388316151202,,,603,448
64,64,2,1,10,0,0,0,225,493,403,26,-1,,0.06450393224440411,0.21735395189003437,,,628,519
65,65,3,1,10,1,0,0,225,493,403,26,-1,,0.06450393224440411,0.21735395189003437,,,628,519
66,66,4,1,10,1,1,0,225,493,403,26,-1,,0.06450393224440411,0.21735395189003437,,,628,519
67,67,5,1,10,1,1,1,225,493,45,26,96,(21),0.037431941923774956,0.21735395189003437,,,270,519
68,68,5,1,10,1,1,2,285,495,115,23,96,Application,0.051799758015728975,0.21756872852233677,,,400,518
69,69,5,1,10,1,1,3,410,495,83,18,93,number:,0.06828493647912885,0.21649484536082475,,,493,513
70,70,5,1,10,1,1,4,505,495,123,18,84,18180953.4,0.08567755595886267,0.21649484536082475,application_number,18180953.4,628,513
71,71,2,1,11,0,0,0,225,559,325,26,-1,,0.05860556563823351,0.24570446735395188,,,550,585
72,72,3,1,11,1,0,0,225,559,325,26,-1,,0.05860556563823351,0.24570446735395188,,,550,585
73,73,4,1,11,1,1,0,225,559,325,26,-1,,0.05860556563823351,0.24570446735395188,,,550,585
74,74,5,1,11,1,1,1,225,559,45,26,96,(22),0.037431941923774956,0.24570446735395188,,,270,585
75,75,5,1,11,1,1,2,286,561,48,18,96,Date,0.04688445251058681,0.24484536082474226,,,334,579
76,76,5,1,11,1,1,3,342,566,12,13,96,of,0.05263157894736842,0.24591924398625428,,,354,579
77,77,5,1,11,1,1,4,355,561,67,23,96,filing:,0.058756805807622506,0.24591924398625428,,,422,584
78,78,5,1,11,1,1,5,432,561,118,18,96,02.04.2012,0.07425892316999395,0.24484536082474226,filing_date,02.04.2012,550,579
79,79,2,1,12,0,0,0,862,395,256,81,-1,,0.14972776769509982,0.1870704467353952,,,1118,476
80,80,3,1,12,1,0,0,862,395,256,81,-1,,0.14972776769509982,0.1870704467353952,,,1118,476
81,81,4,1,12,1,1,0,862,395,126,26,-1,,0.13989715668481548,0.17525773195876287,,,988,421
82,82,5,1,12,1,1,1,862,395,44,26,67,(51),0.1336963097398669,0.17525773195876287,,,906,421
83,83,5,1,12,1,1,2,923,397,25,18,93,Int,0.1414851784633999,0.17439862542955326,,,948,415
84,84,5,1,12,1,1,3,955,397,33,18,65,Cl:,0.14692982456140352,0.17439862542955326,,,988,415
85,85,4,1,12,1,2,0,923,425,186,21,-1,,0.15366001209921354,0.1870704467353952,,,1109,446
86,86,5,1,12,1,2,1,923,428,60,18,66,C07G,0.1441318814277072,0.1877147766323024,class_international,C07G,983,446
87,87,5,1,12,1,2,2,993,428,44,18,87,1100,0.15350877192982457,0.1877147766323024,class_international,1/00,1037,446
88,88,5,1,12,1,2,3,1042,425,67,16,79,(2017.07),0.16265880217785844,0.18599656357388317,,,1109,441
89,89,4,1,12,1,3,0,923,455,195,21,-1,,0.154340592861464,0.19995704467353953,,,1118,476
90,90,5,1,12,1,3,1,923,458,56,18,56,COBL,0.14382940108892922,0.20060137457044674,,,979,476
91,91,5,1,12,1,3,2,988,458,58,18,86,97/00,0.15381125226860254,0.20060137457044674,,,1046,476
92,92,5,1,12,1,3,3,1051,455,67,16,84,(2006.07),0.16401996370235936,0.19888316151202748,,,1118,471
93,93,2,1,13,0,0,0,1195,425,184,21,-1,,0.19464609800362975,0.1870704467353952,,,1379,446
94,94,3,1,13,1,0,0,1195,425,184,21,-1,,0.19464609800362975,0.1870704467353952,,,1379,446
95,95,4,1,13,1,1,0,1195,425,184,21,-1,,0.19464609800362975,0.1870704467353952,,,1379,446
96,96,5,1,13,1,1,1,1195,428,59,18,55,CO8H,0.1851935874168179,0.1877147766323024,,,1254,446
97,97,5,1,13,1,1,2,1262,428,45,18,74,7/00,0.19426799758015728,0.1877147766323024,,,1307,446
98,98,5,1,13,1,1,3,1312,425,67,16,78,(2011.01),0.20349364791288566,0.18599656357388317,,,1379,441
99,99,2,1,14,0,0,0,224,612,1243,6,-1,,0.1278735632183908,0.26417525773195877,,,1467,618
100,100,3,1,14,1,0,0,224,612,1243,6,-1,,0.1278735632183908,0.26417525773195877,,,1467,618
101,101,4,1,14,1,1,0,224,612,1243,6,-1,,0.1278735632183908,0.26417525773195877,,,1467,618
102,102,5,1,14,1,1,1,224,612,1243,6,95, ,0.1278735632183908,0.26417525773195877,,,1467,618
103,103,2,1,15,0,0,0,225,631,599,119,-1,,0.07932546884452511,0.296606529209622,,,824,750
104,104,3,1,15,1,0,0,225,631,599,119,-1,,0.07932546884452511,0.296606529209622,,,824,750
105,105,4,1,15,1,1,0,225,631,388,27,-1,,0.0633696309739867,0.2768470790378007,,,613,658
106,106,5,1,15,1,1,1,225,631,45,27,96,(84),0.037431941923774956,0.2768470790378007,,,270,658
107,107,5,1,15,1,1,2,286,633,118,23,96,Designated,0.052177858439201454,0.2768470790378007,,,404,656
108,108,5,1,15,1,1,3,413,633,119,23,96,Contracting,0.07146098003629764,0.2768470790378007,,,532,656
109,109,5,1,15,1,1,4,542,633,71,19,96,States:,0.08734119782214156,0.2759879725085911,,,613,652
110,110,4,1,15,1,2,0,285,666,537,18,-1,,0.08371143375680581,0.28994845360824745,,,822,684
111,111,5,1,15,1,2,1,285,666,31,18,94,AL,0.04544767090139141,0.28994845360824745,,,316,684
112,112,5,1,15,1,2,2,323,666,31,18,94,AT,0.05119479733817302,0.28994845360824745,,,354,684
113,113,5,1,15,1,2,3,363,666,30,18,96,BE,0.05716878402903811,0.28994845360824745,,,393,684
114,114,5,1,15,1,2,4,403,666,32,18,96,BG,0.0633696309739867,0.28994845360824745,,,435,684
115,115,5,1,15,1,2,5,445,666,31,18,96,CH,0.06964609800362977,0.28994845360824745,,,476,684
116,116,5,1,15,1,2,6,486,666,32,18,95,CY,0.07592256503327284,0.28994845360824745,,,518,684
117,117,5,1,15,1,2,7,526,666,30,18,93,CZ,0.08182093163944344,0.28994845360824745,,,556,684
118,118,5,1,15,1,2,8,565,666,30,18,93,DE,0.08771929824561403,0.28994845360824745,,,595,684
119,119,5,1,15,1,2,9,605,666,32,18,95,DK,0.09392014519056262,0.28994845360824745,,,637,684
120,120,5,1,15,1,2,10,646,666,29,18,95,EE,0.0998941318814277,0.28994845360824745,,,675,684
121,121,5,1,15,1,2,11,684,666,29,18,93,ES,0.10564125831820932,0.28994845360824745,,,713,684
122,122,5,1,15,1,2,12,723,666,57,18,90,FIFR,0.11365698729582577,0.28994845360824745,,,780,684
123,123,5,1,15,1,2,13,788,666,34,18,95,GB,0.12174833635813673,0.28994845360824745,,,822,684
124,124,4,1,15,1,3,0,285,699,539,18,-1,,0.0838626739261948,0.30412371134020616,,,824,717
125,125,5,1,15,1,3,1,285,699,297,18,83,GRHRHUIEISITLILTLU,0.06556261343012704,0.30412371134020616,,,582,717
126,126,5,1,15,1,3,2,591,699,28,18,85,LV,0.09150030248033877,0.30412371134020616,,,619,717
127,127,5,1,15,1,3,3,627,699,35,18,85,MC,0.09747428917120388,0.30412371134020616,,,662,717
128,128,5,1,15,1,3,4,670,699,35,18,94,MK,0.10397761645493044,0.30412371134020616,,,705,717
129,129,5,1,15,1,3,5,713,699,32,18,91,MT,0.11025408348457351,0.30412371134020616,,,745,717
130,130,5,1,15,1,3,6,753,699,29,18,49,NL,0.11607683000604961,0.30412371134020616,,,782,717
131,131,5,1,15,1,3,7,791,699,33,18,49,NO,0.1221264367816092,0.30412371134020616,,,824,717
132,132,4,1,15,1,4,0,286,732,336,18,-1,,0.06866303690260134,0.31829896907216493,,,622,750
133,133,5,1,15,1,4,1,286,732,28,18,93,PL,0.045372050816696916,0.31829896907216493,,,314,750
134,134,5,1,15,1,4,2,323,732,29,18,92,PT,0.05104355716878403,0.31829896907216493,,,352,750
135,135,5,1,15,1,4,3,360,732,58,18,92,RORS,0.058832425892317,0.31829896907216493,,,418,750
136,136,5,1,15,1,4,4,420,732,52,18,92,SE,0.06745311554748941,0.31829896907216493,,,472,750
137,137,5,1,15,1,4,5,480,732,20,18,95,SI,0.07410768300060495,0.31829896907216493,,,500,750
138,138,5,1,15,1,4,6,510,732,31,18,93,SK,0.0794767090139141,0.31829896907216493,,,541,750
139,139,5,1,15,1,4,7,550,732,72,18,90,SMTR,0.08862673926194797,0.31829896907216493,,,622,750
140,140,2,1,16,0,0,0,225,795,513,53,-1,,0.07282214156079855,0.35287800687285226,,,738,848
141,141,3,1,16,1,0,0,225,795,513,53,-1,,0.07282214156079855,0.35287800687285226,,,738,848
142,142,4,1,16,1,1,0,225,795,513,27,-1,,0.07282214156079855,0.3472938144329897,,,738,822
143,143,5,1,16,1,1,1,225,795,45,27,96,(30),0.037431941923774956,0.3472938144329897,,,270,822
144,144,5,1,16,1,1,2,286,797,77,23,96,Priority:,0.04907743496672716,0.3472938144329897,,,363,820
145,145,5,1,16,1,1,3,383,797,116,19,96,07.04.2011,0.06669691470054447,0.34643470790378006,,,499,816
146,146,5,1,16,1,1,4,520,797,30,19,96,US,0.0809134906231095,0.34643470790378006,,,550,816
147,147,5,1,16,1,1,5,559,797,158,19,89,201161473134,0.09649122807017543,0.34643470790378006,,,717,816
148,148,5,1,16,1,1,6,725,797,13,19,89,P,0.11063218390804598,0.34643470790378006,,,738,816
149,149,4,1,16,1,2,0,383,830,355,18,-1,,0.08477011494252873,0.3603951890034364,,,738,848
150,150,5,1,16,1,2,1,383,830,116,18,96,07.05.2011,0.06669691470054447,0.3603951890034364,,,499,848
151,151,5,1,16,1,2,2,520,830,30,18,95,US,0.0809134906231095,0.3603951890034364,,,550,848
152,152,5,1,16,1,2,3,559,830,157,18,93,201161483663,0.09641560798548095,0.3603951890034364,,,716,848
153,153,5,1,16,1,2,4,725,830,13,18,92,P,0.11063218390804598,0.3603951890034364,,,738,848
154,154,2,1,17,0,0,0,225,893,596,87,-1,,0.07909860859044163,0.4022766323024055,,,821,980
155,155,3,1,17,1,0,0,225,893,596,87,-1,,0.07909860859044163,0.4022766323024055,,,821,980
156,156,4,1,17,1,1,0,225,893,596,27,-1,,0.07909860859044163,0.3893900343642612,,,821,920
157,157,5,1,17,1,1,1,225,893,45,27,96,(62),0.037431941923774956,0.3893900343642612,,,270,920
158,158,5,1,17,1,1,2,286,895,107,19,96,Document,0.05134603750756201,0.38853092783505155,,,393,914
159,159,5,1,17,1,1,3,402,895,105,23,95,number(s),0.06873865698729582,0.3893900343642612,,,507,918
160,160,5,1,17,1,1,4,516,895,20,19,96,of,0.07955232909860858,0.38853092783505155,,,536,914
161,161,5,1,17,1,1,5,542,895,32,19,96,the,0.08439201451905626,0.38853092783505155,,,574,914
162,162,5,1,17,1,1,6,582,895,66,19,96,earlier,0.09301270417422867,0.38853092783505155,,,648,914
163,163,5,1,17,1,1,7,655,895,140,23,95,application(s),0.10964912280701754,0.3893900343642612,,,795,918
164,164,5,1,17,1,1,8,805,895,16,19,96,in,0.12295825771324864,0.38853092783505155,,,821,914
165,165,4,1,17,1,2,0,286,929,308,18,-1,,0.06654567453115548,0.4029209621993127,,,594,947
166,166,5,1,17,1,2,1,286,929,121,18,96,accordance,0.05240471869328494,0.4029209621993127,,,407,947
167,167,5,1,17,1,2,2,415,929,40,18,96,with,0.06578947368421052,0.4029209621993127,,,455,947
168,168,5,1,17,1,2,3,464,929,35,18,95,Art.,0.07282214156079855,0.4029209621993127,,,499,947
169,169,5,1,17,1,2,4,508,929,25,18,95,76,0.07872050816696914,0.4029209621993127,,,533,947
170,170,5,1,17,1,2,5,542,929,52,18,96,EPC:,0.08590441621294616,0.4029209621993127,,,594,947
171,171,4,1,17,1,3,0,286,961,250,19,-1,,0.06215970961887477,0.4168814432989691,,,536,980
172,172,5,1,17,1,3,1,286,961,124,19,92,12768483.5,0.05263157894736842,0.4168814432989691,,,410,980
173,173,5,1,17,1,3,2,417,961,7,19,74,/,0.06359649122807018,0.4168814432989691,,,424,980
174,174,5,1,17,1,3,3,432,961,11,19,95,2,0.066167574107683,0.4168814432989691,,,443,980
175,175,5,1,17,1,3,4,452,961,38,19,95,694,0.07123411978221415,0.4168814432989691,,,490,980
176,176,5,1,17,1,3,5,498,961,38,19,95,594,0.07819116757410768,0.4168814432989691,,,536,980
177,177,2,1,18,0,0,0,225,1025,338,57,-1,,0.05958862673926195,0.4525343642611684,,,563,1082
178,178,3,1,18,1,0,0,225,1025,338,57,-1,,0.05958862673926195,0.4525343642611684,,,563,1082
179,179,4,1,18,1,1,0,225,1025,290,26,-1,,0.0559588626739262,0.44587628865979384,,,515,1051
180,180,5,1,18,1,1,1,225,1025,45,26,95,(71),0.037431941923774956,0.44587628865979384,,,270,1051
181,181,5,1,18,1,1,2,285,1027,103,23,93,Applicant:,0.05089231699939504,0.44609106529209624,,,388,1050
182,182,5,1,18,1,1,3,396,1027,71,21,93,"Virdia,",0.06526013309134907,0.44566151202749144,applicant_line_1,"Virdia,",467,1048
183,183,5,1,18,1,1,4,477,1027,38,18,94,Inc.,0.0750151240169389,0.44501718213058417,applicant_line_1,Inc.,515,1045
184,184,4,1,18,1,2,0,286,1059,277,23,-1,,0.06420145190562614,0.45983676975945015,,,563,1082
185,185,5,1,18,1,2,1,286,1059,110,22,92,"Raceland,",0.051572897761645496,0.45962199312714774,,,396,1081
186,186,5,1,18,1,2,2,406,1059,29,19,96,LA,0.06359649122807018,0.45897766323024053,,,435,1078
187,187,5,1,18,1,2,3,443,1059,65,19,96,70394,0.07191470054446461,0.45897766323024053,,,508,1078
188,188,5,1,18,1,2,4,517,1059,46,23,96,(US),0.08166969147005444,0.45983676975945015,,,563,1082
189,189,2,1,19,0,0,0,844,614,4,533,-1,,0.1279491833030853,0.37822164948453607,,,848,1147
190,190,3,1,19,1,0,0,844,614,4,533,-1,,0.1279491833030853,0.37822164948453607,,,848,1147
191,191,4,1,19,1,1,0,844,614,4,533,-1,,0.1279491833030853,0.37822164948453607,,,848,1147
192,192,5,1,19,1,1,1,844,614,4,533,95, ,0.1279491833030853,0.37822164948453607,,,848,1147
193,193,2,1,20,0,0,0,862,631,347,157,-1,,0.15660919540229884,0.30476804123711343,,,1209,788
194,194,3,1,20,1,0,0,862,631,347,157,-1,,0.15660919540229884,0.30476804123711343,,,1209,788
195,195,4,1,20,1,1,0,862,631,162,27,-1,,0.1426194797338173,0.2768470790378007,,,1024,658
196,196,5,1,20,1,1,1,862,631,44,27,94,(72),0.1336963097398669,0.2768470790378007,,,906,658
197,197,5,1,20,1,1,2,923,633,101,19,94,Inventors:,0.1472323049001815,0.2759879725085911,,,1024,652
198,198,4,1,20,1,2,0,898,666,182,22,-1,,0.14957652752571082,0.29080756013745707,,,1080,688
199,199,5,1,20,1,2,1,898,671,7,8,1,¬´,0.13634301270417423,0.28994845360824745,,,905,679
200,200,5,1,20,1,2,2,923,666,67,22,96,"EYAL,",0.14466122202056866,0.29080756013745707,inventor_line_1,"EYAL,",990,688
201,201,5,1,20,1,2,3,998,666,82,18,96,Aharon,0.1571385359951603,0.28994845360824745,inventor_line_1,Aharon,1080,684
202,202,4,1,20,1,3,0,922,699,233,23,-1,,0.1570629159104658,0.30519759450171824,,,1155,722
203,203,5,1,20,1,3,1,922,699,64,18,96,93629,0.1442831215970962,0.30412371134020616,,,986,717
204,204,5,1,20,1,3,2,994,699,117,18,96,Jerusalem,0.15918027828191167,0.30412371134020616,,,1111,717
205,205,5,1,20,1,3,3,1120,699,35,23,94,(IL),0.1720356926799758,0.30519759450171824,,,1155,722
206,206,4,1,20,1,4,0,898,732,210,22,-1,,0.15169388989715668,0.31915807560137455,,,1108,754
207,207,5,1,20,1,4,1,898,737,7,8,62,¬´,0.13634301270417423,0.31829896907216493,,,905,745
208,208,5,1,20,1,4,2,922,732,94,18,96,"JANSEN,",0.14655172413793102,0.31829896907216493,,,1016,750
209,209,5,1,20,1,4,3,1019,732,89,22,96,Robert,0.16084392014519056,0.31915807560137455,,,1108,754
210,210,4,1,20,1,5,0,922,765,287,23,-1,,0.16114640048396855,0.3335481099656357,,,1209,788
211,211,5,1,20,1,5,1,922,765,130,21,96,"Collinsville,",0.14927404718693285,0.3331185567010309,,,1052,786
212,212,5,1,20,1,5,2,1062,765,19,18,95,IL,0.16205384150030247,0.3324742268041237,,,1081,783
213,213,5,1,20,1,5,3,1089,765,65,18,95,62234,0.16961584996975196,0.3324742268041237,,,1154,783
214,214,5,1,20,1,5,4,1162,765,47,23,96,(US),0.1792952208106473,0.3335481099656357,,,1209,788
215,215,2,1,21,0,0,0,862,828,342,124,-1,,0.15623109497882637,0.38230240549828176,,,1204,952
216,216,3,1,21,1,0,0,862,828,342,124,-1,,0.15623109497882637,0.38230240549828176,,,1204,952
217,217,4,1,21,1,1,0,862,828,342,26,-1,,0.15623109497882637,0.36125429553264604,,,1204,854
218,218,5,1,21,1,1,1,862,828,44,26,95,(74),0.1336963097398669,0.36125429553264604,,,906,854
219,219,5,1,21,1,1,2,923,830,163,23,96,Representative:,0.15192075015124018,0.36146907216494845,,,1086,853
220,220,5,1,21,1,1,3,1095,830,11,18,96,J,0.16643980641258319,0.3603951890034364,representative_line_1_eu,J,1106,848
221,221,5,1,21,1,1,4,1115,830,17,18,94,A,0.16991833030852996,0.3603951890034364,representative_line_1_eu,A,1132,848
222,222,5,1,21,1,1,5,1140,830,64,23,94,Kemp,0.17725347852389595,0.36146907216494845,representative_line_1_eu,Kemp,1204,853
223,223,4,1,21,1,2,0,923,863,185,23,-1,,0.15358439201451907,0.3756443298969072,,,1108,886
224,224,5,1,21,1,2,1,923,863,24,18,96,14,0.1414095583787054,0.3745704467353952,,,947,881
225,225,5,1,21,1,2,2,955,863,65,18,96,South,0.14934966727162735,0.3745704467353952,,,1020,881
226,226,5,1,21,1,2,3,1029,863,79,23,96,Square,0.1616001209921355,0.3756443298969072,,,1108,886
227,227,4,1,21,1,3,0,922,895,114,23,-1,,0.14806412583182094,0.3893900343642612,,,1036,918
228,228,5,1,21,1,3,1,922,895,72,23,92,Gray‚Äôs,0.14488808227465214,0.3893900343642612,,,994,918
229,229,5,1,21,1,3,2,1004,895,32,19,96,Inn,0.1542649727767695,0.38853092783505155,,,1036,914
230,230,4,1,21,1,4,0,923,929,266,23,-1,,0.15970961887477314,0.40399484536082475,,,1189,952
231,231,5,1,21,1,4,1,923,929,84,18,93,London,0.14594676346037508,0.4029209621993127,,,1007,947
232,232,5,1,21,1,4,2,1015,929,70,18,88,WC1R,0.1588021778584392,0.4029209621993127,,,1085,947
233,233,5,1,21,1,4,3,1093,929,37,18,92,5JJ,0.16810344827586207,0.4029209621993127,,,1130,947
234,234,5,1,21,1,4,4,1140,929,49,23,96,(GB),0.17611917725347853,0.40399484536082475,,,1189,952
235,235,2,1,22,0,0,0,862,994,99,18,-1,,0.13785541439806412,0.43084192439862545,,,961,1012
236,236,3,1,22,1,0,0,862,994,99,18,-1,,0.13785541439806412,0.43084192439862545,,,961,1012
237,237,4,1,22,1,1,0,862,994,99,18,-1,,0.13785541439806412,0.43084192439862545,,,961,1012
238,238,5,1,22,1,1,1,862,994,99,18,95,Remarks:,0.13785541439806412,0.43084192439862545,,,961,1012
239,239,2,1,23,0,0,0,922,1027,522,83,-1,,0.17891712038717483,0.45897766323024053,,,1444,1110
240,240,3,1,23,1,0,0,922,1027,522,83,-1,,0.17891712038717483,0.45897766323024053,,,1444,1110
241,241,4,1,23,1,1,0,922,1027,474,23,-1,,0.1752873563218391,0.44609106529209624,,,1396,1050
242,242,5,1,23,1,1,1,922,1027,43,18,96,This,0.1426950998185118,0.44501718213058417,,,965,1045
243,243,5,1,23,1,1,2,974,1027,111,23,96,application,0.15570175438596492,0.44609106529209624,,,1085,1050
244,244,5,1,23,1,1,3,1093,1031,42,14,96,was,0.16848154869933454,0.44587628865979384,,,1135,1045
245,245,5,1,23,1,1,4,1142,1027,43,18,96,filed,0.17596793708408953,0.44501718213058417,,,1185,1045
246,246,5,1,23,1,1,5,1193,1031,25,14,96,on,0.1823200241984271,0.44587628865979384,,,1218,1045
247,247,5,1,23,1,1,6,1226,1027,119,18,96,29.06.2018,0.19441923774954628,0.44501718213058417,,,1345,1045
248,248,5,1,23,1,1,7,1353,1031,24,14,95,as,0.20644283121597096,0.44587628865979384,,,1377,1045
249,249,5,1,23,1,1,8,1385,1031,11,14,95,a,0.2102994555353902,0.44587628865979384,,,1396,1045
250,250,4,1,23,1,2,0,922,1059,522,23,-1,,0.17891712038717483,0.45983676975945015,,,1444,1082
251,251,5,1,23,1,2,1,922,1059,96,19,96,divisional,0.14670296430732002,0.45897766323024053,,,1018,1078
252,252,5,1,23,1,2,2,1027,1059,111,23,96,application,0.16371748336358136,0.45983676975945015,,,1138,1082
253,253,5,1,23,1,2,3,1147,1060,19,18,96,to,0.17490925589836662,0.45919243986254293,,,1166,1078
254,254,5,1,23,1,2,4,1174,1059,31,19,96,the,0.17990018148820328,0.45897766323024053,,,1205,1078
255,255,5,1,23,1,2,5,1214,1059,112,23,96,application,0.19207501512401695,0.45983676975945015,,,1326,1082
256,256,5,1,23,1,2,6,1336,1059,108,19,96,mentioned,0.2102238354506957,0.45897766323024053,,,1444,1078
257,257,4,1,23,1,3,0,923,1092,209,18,-1,,0.15539927404718692,0.4729381443298969,,,1132,1110
258,258,5,1,23,1,3,1,923,1092,59,18,93,under,0.1440562613430127,0.4729381443298969,,,982,1110
259,259,5,1,23,1,3,2,991,1092,45,18,92,INID,0.15328191167574107,0.4729381443298969,,,1036,1110
260,260,5,1,23,1,3,3,1044,1092,50,18,96,code,0.16167574107683,0.4729381443298969,,,1094,1110
261,261,5,1,23,1,3,4,1103,1092,29,18,96,62.,0.16901088929219601,0.4729381443298969,,,1132,1110
262,262,2,1,24,0,0,0,224,1143,1243,6,-1,,0.1278735632183908,0.49226804123711343,,,1467,1149
263,263,3,1,24,1,0,0,224,1143,1243,6,-1,,0.1278735632183908,0.49226804123711343,,,1467,1149
264,264,4,1,24,1,1,0,224,1143,1243,6,-1,,0.1278735632183908,0.49226804123711343,,,1467,1149
265,265,5,1,24,1,1,1,224,1143,1243,6,95, ,0.1278735632183908,0.49226804123711343,,,1467,1149
266,266,2,1,25,0,0,0,225,1165,913,26,-1,,0.10307017543859649,0.5060137457044673,,,1138,1191
267,267,3,1,25,1,0,0,225,1165,913,26,-1,,0.10307017543859649,0.5060137457044673,,,1138,1191
268,268,4,1,25,1,1,0,225,1165,913,26,-1,,0.10307017543859649,0.5060137457044673,,,1138,1191
269,269,5,1,25,1,1,1,225,1165,45,26,76,(54),0.037431941923774956,0.5060137457044673,,,270,1191
270,270,5,1,25,1,1,2,316,1165,242,21,79,LIGNOCELLULOSE,0.06609195402298851,0.5049398625429553,title_line_1,LIGNOCELLULOSE,558,1186
271,271,5,1,25,1,1,3,568,1165,175,21,95,CONVERSION,0.09913793103448276,0.5049398625429553,title_line_1,CONVERSION,743,1186
272,272,5,1,25,1,1,4,755,1165,161,21,96,PROCESSES,0.12636116152450091,0.5049398625429553,title_line_1,PROCESSES,916,1186
273,273,5,1,25,1,1,5,925,1165,57,20,96,AND,0.1442075015124017,0.5047250859106529,title_line_1,AND,982,1185
274,274,5,1,25,1,1,6,992,1165,146,21,96,PRODUCTS,0.16107078039927405,0.5049398625429553,title_line_1,PRODUCTS,1138,1186
275,275,2,1,26,0,0,0,225,1239,1241,26,-1,,0.1278735632183908,0.5378006872852233,,,1466,1265
276,276,3,1,26,1,0,0,225,1239,1241,26,-1,,0.1278735632183908,0.5378006872852233,,,1466,1265
277,277,4,1,26,1,1,0,225,1239,1241,26,-1,,0.1278735632183908,0.5378006872852233,,,1466,1265
278,278,5,1,26,1,1,1,225,1239,45,26,93,(57),0.037431941923774956,0.5378006872852233,,,270,1265
279,279,5,1,26,1,1,2,316,1241,97,18,44,Processes,0.055127041742286755,0.5369415807560137,,,413,1259
280,280,5,1,26,1,1,3,415,1241,46,18,96,for,0.0662431941923775,0.5369415807560137,,,461,1259
281,281,5,1,26,1,1,4,470,1241,107,23,93,converting,0.07917422867513611,0.5380154639175257,,,577,1264
282,282,5,1,26,1,1,5,587,1241,141,23,92,lignocellulose,0.09944041137326073,0.5380154639175257,,,728,1264
283,283,5,1,26,1,1,6,736,1242,19,17,96,to,0.11274954627949184,0.5371563573883161,,,755,1259
284,284,5,1,26,1,1,7,763,1241,102,18,96,feedstock,0.12310949788263763,0.5369415807560137,,,865,1259
285,285,5,1,26,1,1,8,873,1241,38,18,96,and,0.13490623109497882,0.5369415807560137,,,911,1259
286,286,5,1,26,1,1,9,920,1241,128,18,96,downstream,0.14882032667876588,0.5369415807560137,,,1048,1259
287,287,5,1,26,1,1,10,1058,1241,89,23,96,products,0.16674228675136116,0.5380154639175257,,,1147,1264
288,288,5,1,26,1,1,11,1156,1246,33,13,96,are,0.17732909860859045,0.5380154639175257,,,1189,1259
289,289,5,1,26,1,1,12,1197,1241,104,18,96,disclosed.,0.18889897156684815,0.5369415807560137,,,1301,1259
290,290,5,1,26,1,1,13,1311,1241,39,18,96,The,0.20122504537205083,0.5369415807560137,,,1350,1259
291,291,5,1,26,1,1,14,1360,1246,106,18,96,processes,0.21370235934664247,0.5390893470790378,,,1466,1264
292,292,2,1,27,0,0,0,225,1274,1241,121,-1,,0.1278735632183908,0.5732388316151202,,,1466,1395
293,293,3,1,27,1,0,0,225,1274,1241,121,-1,,0.1278735632183908,0.5732388316151202,,,1466,1395
294,294,4,1,27,1,1,0,226,1274,1240,23,-1,,0.1279491833030853,0.5521907216494846,,,1466,1297
295,295,5,1,27,1,1,1,226,1278,30,14,96,may,0.03644888082274652,0.5519759450171822,,,256,1292
296,296,5,1,27,1,1,2,258,1274,93,23,96,include,0.046052631578947366,0.5521907216494846,,,351,1297
297,297,5,1,27,1,1,3,360,1274,42,18,96,acid,0.057622504537205084,0.5511168384879725,,,402,1292
298,298,5,1,27,1,1,4,411,1274,91,18,96,treatment,0.06904113732607381,0.5511168384879725,,,502,1292
299,299,5,1,27,1,1,5,505,1274,34,18,93,of,0.07894736842105263,0.5511168384879725,,,539,1292
300,300,5,1,27,1,1,6,547,1274,140,23,92,lignocellulose,0.09331518451300666,0.5521907216494846,,,687,1297
301,301,5,1,27,1,1,7,696,1274,19,18,96,to,0.10669993950393225,0.5511168384879725,,,715,1292
302,302,5,1,27,1,1,8,725,1274,83,23,96,produce,0.11592558983666061,0.5521907216494846,,,808,1297
303,303,5,1,27,1,1,9,817,1278,11,14,96,a,0.12439503932244404,0.5519759450171822,,,828,1292
304,304,5,1,27,1,1,10,836,1274,131,18,96,fermentation,0.13634301270417423,0.5511168384879725,,,967,1292
305,305,5,1,27,1,1,11,976,1274,107,18,96,feedstock.,0.15570175438596492,0.5511168384879725,,,1083,1292
306,306,5,1,27,1,1,12,1094,1274,17,18,96,In,0.16674228675136116,0.5511168384879725,,,1111,1292
307,307,5,1,27,1,1,13,1119,1274,76,18,96,various,0.1749848759830611,0.5511168384879725,,,1195,1292
308,308,5,1,27,1,1,14,1205,1274,104,21,96,"instances,",0.19010889292196007,0.5517611683848798,,,1309,1295
309,309,5,1,27,1,1,15,1318,1274,32,18,96,the,0.20175438596491227,0.5511168384879725,,,1350,1292
310,310,5,1,27,1,1,16,1360,1278,106,19,95,processes,0.21370235934664247,0.5530498281786942,,,1466,1297
311,311,4,1,27,1,2,0,226,1306,1239,23,-1,,0.1278735632183908,0.5659364261168385,,,1465,1329
312,312,5,1,27,1,2,1,226,1306,73,19,96,include,0.0397005444646098,0.5650773195876289,,,299,1325
313,313,5,1,27,1,2,2,309,1311,90,18,96,recovery,0.05353901996370236,0.5670103092783505,,,399,1329
314,314,5,1,27,1,2,3,408,1311,20,14,97,or,0.06321839080459771,0.5661512027491409,,,428,1325
315,315,5,1,27,1,2,4,438,1306,91,23,96,recycling,0.07312462189957653,0.5659364261168385,,,529,1329
316,316,5,1,27,1,2,5,539,1306,20,19,96,of,0.08303085299455536,0.5650773195876289,,,559,1325
317,317,5,1,27,1,2,6,567,1306,48,22,96,"acid,",0.08938294010889292,0.5657216494845361,,,615,1328
318,318,5,1,27,1,2,7,626,1306,48,19,96,such,0.09830611010284332,0.5650773195876289,,,674,1325
319,319,5,1,27,1,2,8,684,1311,24,14,96,as,0.10526315789473684,0.5661512027491409,,,708,1325
320,320,5,1,27,1,2,9,718,1311,90,18,96,recovery,0.11539624924379915,0.5670103092783505,,,808,1329
321,321,5,1,27,1,2,10,817,1306,20,19,96,of,0.1250756200846945,0.5650773195876289,,,837,1325
322,322,5,1,27,1,2,11,846,1306,127,23,96,hydrochloric,0.13755293405928615,0.5659364261168385,,,973,1329
323,323,5,1,27,1,2,12,982,1306,41,19,97,acid,0.15161826981246218,0.5650773195876289,,,1023,1325
324,324,5,1,27,1,2,13,1033,1306,46,19,96,from,0.15970961887477314,0.5650773195876289,,,1079,1325
325,325,5,1,27,1,2,14,1090,1306,135,19,96,concentrated,0.1750604960677556,0.5650773195876289,,,1225,1325
326,326,5,1,27,1,2,15,1235,1306,58,19,96,and/or,0.191167574107683,0.5650773195876289,,,1293,1325
327,327,5,1,27,1,2,16,1295,1306,72,19,96,dilute,0.2013006654567453,0.5650773195876289,,,1367,1325
328,328,5,1,27,1,2,17,1376,1307,89,18,96,streams.,0.2148366606170599,0.5652920962199313,,,1465,1325
329,329,4,1,27,1,3,0,226,1339,1239,23,-1,,0.1278735632183908,0.5801116838487973,,,1465,1362
330,330,5,1,27,1,3,1,226,1339,130,18,95,Downstream,0.04401088929219601,0.5790378006872853,,,356,1357
331,331,5,1,27,1,3,2,369,1339,89,23,96,products,0.06253781004234725,0.5801116838487973,,,458,1362
332,332,5,1,27,1,3,3,471,1344,43,18,96,may,0.07448578342407744,0.5811855670103093,,,514,1362
333,333,5,1,27,1,3,4,526,1339,73,18,96,include,0.08507259528130671,0.5790378006872853,,,599,1357
334,334,5,1,27,1,3,5,610,1339,67,23,96,acrylic,0.09732304900181488,0.5801116838487973,,,677,1362
335,335,5,1,27,1,3,6,688,1339,114,18,96,acid-based,0.11267392619479734,0.5790378006872853,,,802,1357
336,336,5,1,27,1,3,7,815,1339,89,23,96,products,0.12999092558983666,0.5801116838487973,,,904,1362
337,337,5,1,27,1,3,8,915,1339,48,18,96,such,0.14201451905626133,0.5790378006872853,,,963,1357
338,338,5,1,27,1,3,9,976,1344,23,13,96,as,0.14934966727162735,0.5801116838487973,,,999,1357
339,339,5,1,27,1,3,10,1010,1339,83,23,96,"diapers,",0.1590290381125227,0.5801116838487973,,,1093,1362
340,340,5,1,27,1,3,11,1107,1344,59,18,96,paper,0.17188445251058682,0.5811855670103093,,,1166,1362
341,341,5,1,27,1,3,12,1176,1339,37,18,96,and,0.18065638233514822,0.5790378006872853,,,1213,1357
342,342,5,1,27,1,3,13,1226,1339,132,23,96,paper-based,0.19540229885057472,0.5801116838487973,,,1358,1362
343,343,5,1,27,1,3,14,1371,1339,94,23,96,"products,",0.21445856019358742,0.5801116838487973,,,1465,1362
344,344,4,1,27,1,4,0,225,1372,733,23,-1,,0.08945856019358742,0.594286941580756,,,958,1395
345,345,5,1,27,1,4,1,225,1372,82,22,95,"ethanol,",0.040229885057471264,0.5940721649484536,,,307,1394
346,346,5,1,27,1,4,2,318,1372,79,19,96,biofuels,0.054068360556563826,0.5934278350515464,,,397,1391
347,347,5,1,27,1,4,3,406,1372,47,19,96,such,0.06495765275257108,0.5934278350515464,,,453,1391
348,348,5,1,27,1,4,4,463,1377,23,14,96,as,0.07176346037507562,0.5945017182130584,,,486,1391
349,349,5,1,27,1,4,5,496,1372,91,19,96,biodiesel,0.08189655172413793,0.5934278350515464,,,587,1391
350,350,5,1,27,1,4,6,596,1372,36,19,96,and,0.09286146400483969,0.5934278350515464,,,632,1391
351,351,5,1,27,1,4,7,641,1372,37,19,96,fuel,0.09974289171203872,0.5934278350515464,,,678,1391
352,352,5,1,27,1,4,8,686,1372,99,22,96,"additives,",0.11123714458560194,0.5940721649484536,,,785,1394
353,353,5,1,27,1,4,9,794,1372,38,19,96,and,0.12295825771324864,0.5934278350515464,,,832,1391
354,354,5,1,27,1,4,10,841,1372,117,23,96,detergents.,0.13604053236539626,0.594286941580756,,,958,1395
355,355,2,1,28,0,0,0,716,2270,259,16,-1,,0.1278735632183908,0.9785223367697594,,,975,2286
356,356,3,1,28,1,0,0,716,2270,259,16,-1,,0.1278735632183908,0.9785223367697594,,,975,2286
357,357,4,1,28,1,1,0,716,2270,259,16,-1,,0.1278735632183908,0.9785223367697594,,,975,2286
358,358,5,1,28,1,1,1,716,2270,49,12,96,Printed,0.11199334543254688,0.9776632302405498,,,765,2282
359,359,5,1,28,1,1,2,771,2270,15,16,96,by,0.1177404718693285,0.9785223367697594,,,786,2286
360,360,5,1,28,1,1,3,792,2270,45,14,96,"Jouve,",0.12318511796733213,0.9780927835051546,,,837,2284
361,361,5,1,28,1,1,4,843,2270,41,12,96,75001,0.13059588626739263,0.9776632302405498,,,884,2282
362,362,5,1,28,1,1,5,893,2270,46,12,96,PARIS,0.1385359951603146,0.9776632302405498,,,939,2282
363,363,5,1,28,1,1,6,945,2270,30,16,95,(FR),0.14519056261343014,0.9785223367697594,,,975,2286
