,Unnamed: 0,level,page_num,block_num,par_num,line_num,word_num,left,top,width,height,conf,text,x,y,label,target,right,bottom
0,0,1,1,0,0,0,0,0,0,1653,2328,-1,,0.125,0.5,,,1653,2328
1,1,2,1,1,0,0,0,144,1905,31,328,-1,,0.02412280701754386,0.8887457044673539,,,175,2233
2,2,3,1,1,1,0,0,144,1905,31,328,-1,,0.02412280701754386,0.8887457044673539,,,175,2233
3,3,4,1,1,1,1,0,144,1905,31,328,-1,,0.02412280701754386,0.8887457044673539,,,175,2233
4,4,5,1,1,1,1,1,144,2179,30,54,94,EP,0.024047186932849365,0.947594501718213,,,174,2233
5,5,5,1,1,1,1,2,144,2142,31,21,94,3,0.02412280701754386,0.9246134020618557,,,175,2163
6,6,5,1,1,1,1,3,144,2055,31,71,95,402,0.02412280701754386,0.8979810996563574,,,175,2126
7,7,5,1,1,1,1,4,144,1969,31,69,90,199,0.02412280701754386,0.8606099656357389,,,175,2038
8,8,5,1,1,1,1,5,144,1905,30,50,88,A1,0.024047186932849365,0.8290378006872853,,,174,1955
9,9,2,1,2,0,0,0,429,153,88,28,-1,,0.07153660012099214,0.07173539518900343,,,517,181
10,10,3,1,2,1,0,0,429,153,88,28,-1,,0.07153660012099214,0.07173539518900343,,,517,181
11,11,4,1,2,1,1,0,429,153,88,16,-1,,0.07153660012099214,0.06915807560137457,,,517,169
12,12,5,1,2,1,1,1,429,153,88,16,84,Europaisches,0.07153660012099214,0.06915807560137457,,,517,169
13,13,4,1,2,1,2,0,429,170,71,11,-1,,0.07025105868118572,0.07538659793814433,,,500,181
14,14,5,1,2,1,2,1,429,170,71,11,96,Patentamt,0.07025105868118572,0.07538659793814433,,,500,181
15,15,2,1,3,0,0,0,429,196,63,15,-1,,0.06964609800362977,0.08741408934707903,,,492,211
16,16,3,1,3,1,0,0,429,196,63,15,-1,,0.06964609800362977,0.08741408934707903,,,492,211
17,17,4,1,3,1,1,0,429,196,63,15,-1,,0.06964609800362977,0.08741408934707903,,,492,211
18,18,5,1,3,1,1,1,429,196,63,15,95,European,0.06964609800362977,0.08741408934707903,,,492,211
19,19,2,1,4,0,0,0,429,212,89,12,-1,,0.07161222020568662,0.0936426116838488,,,518,224
20,20,3,1,4,1,0,0,429,212,89,12,-1,,0.07161222020568662,0.0936426116838488,,,518,224
21,21,4,1,4,1,1,0,429,212,89,12,-1,,0.07161222020568662,0.0936426116838488,,,518,224
22,22,5,1,4,1,1,1,429,213,43,11,97,Patent,0.06813369630973987,0.0938573883161512,,,472,224
23,23,5,1,4,1,1,2,478,212,40,12,96,Office,0.07531760435571688,0.0936426116838488,,,518,224
24,24,2,1,5,0,0,0,429,239,109,28,-1,,0.07312462189957653,0.10867697594501718,,,538,267
25,25,3,1,5,1,0,0,429,239,109,28,-1,,0.07312462189957653,0.10867697594501718,,,538,267
26,26,4,1,5,1,1,0,429,239,109,15,-1,,0.07312462189957653,0.10588487972508591,,,538,254
27,27,5,1,5,1,1,1,429,239,40,12,93,Office,0.06790683605565638,0.1052405498281787,,,469,251
28,28,5,1,5,1,1,2,474,239,64,15,93,europ√©en,0.0765275257108288,0.10588487972508591,,,538,254
29,29,4,1,5,1,2,0,429,255,77,12,-1,,0.0707047791893527,0.11211340206185567,,,506,267
30,30,5,1,5,1,2,1,429,255,22,12,95,des,0.06654567453115548,0.11211340206185567,,,451,267
31,31,5,1,5,1,2,2,457,255,49,12,82,brevets,0.07282214156079855,0.11211340206185567,,,506,267
32,32,2,1,6,0,0,0,281,136,274,150,-1,,0.06321839080459771,0.09063573883161512,,,555,286
33,33,3,1,6,1,0,0,281,136,274,150,-1,,0.06321839080459771,0.09063573883161512,,,555,286
34,34,4,1,6,1,1,0,281,136,274,150,-1,,0.06321839080459771,0.09063573883161512,,,555,286
35,35,5,1,6,1,1,1,281,136,274,150,95, ,0.06321839080459771,0.09063573883161512,,,555,286
36,36,2,1,7,0,0,0,225,324,45,26,-1,,0.037431941923774956,0.14475945017182132,,,270,350
37,37,3,1,7,1,0,0,225,324,45,26,-1,,0.037431941923774956,0.14475945017182132,,,270,350
38,38,4,1,7,1,1,0,225,324,45,26,-1,,0.037431941923774956,0.14475945017182132,,,270,350
39,39,5,1,7,1,1,1,225,324,45,26,96,(12),0.037431941923774956,0.14475945017182132,,,270,350
40,40,2,1,8,0,0,0,225,395,378,53,-1,,0.06261343012704174,0.18105670103092783,,,603,448
41,41,3,1,8,1,0,0,225,395,378,53,-1,,0.06261343012704174,0.18105670103092783,,,603,448
42,42,4,1,8,1,1,0,225,395,262,26,-1,,0.05384150030248034,0.17525773195876287,,,487,421
43,43,5,1,8,1,1,1,225,395,45,26,95,(43),0.037431941923774956,0.17525773195876287,,,270,421
44,44,5,1,8,1,1,2,286,397,48,18,95,Date,0.04688445251058681,0.17439862542955326,,,334,415
45,45,5,1,8,1,1,3,342,397,20,18,96,of,0.05323653962492438,0.17439862542955326,,,362,415
46,46,5,1,8,1,1,4,370,397,117,23,96,publication:,0.0648064125831821,0.17547250859106528,,,487,420
47,47,4,1,8,1,2,0,287,430,316,18,-1,,0.06730187537810042,0.18857388316151202,,,603,448
48,48,5,1,8,1,2,1,287,430,116,18,95,14.11.2018,0.052177858439201454,0.18857388316151202,publication_date,14.11.2018,403,448
49,49,5,1,8,1,2,2,426,430,84,18,95,Bulletin,0.07078039927404718,0.18857388316151202,,,510,448
50,50,5,1,8,1,2,3,519,430,84,18,96,2018/46,0.08484573502722323,0.18857388316151202,,,603,448
51,51,2,1,9,0,0,0,225,493,402,26,-1,,0.06442831215970962,0.21735395189003437,,,627,519
52,52,3,1,9,1,0,0,225,493,402,26,-1,,0.06442831215970962,0.21735395189003437,,,627,519
53,53,4,1,9,1,1,0,225,493,402,26,-1,,0.06442831215970962,0.21735395189003437,,,627,519
54,54,5,1,9,1,1,1,225,493,45,26,95,(21),0.037431941923774956,0.21735395189003437,,,270,519
55,55,5,1,9,1,1,2,285,495,115,23,96,Application,0.051799758015728975,0.21756872852233677,,,400,518
56,56,5,1,9,1,1,3,410,495,83,18,93,number:,0.06828493647912885,0.21649484536082475,,,493,513
57,57,5,1,9,1,1,4,505,495,122,18,93,18181663.8,0.08560193587416817,0.21649484536082475,application_number,18181663.8,627,513
58,58,2,1,10,0,0,0,225,559,325,26,-1,,0.05860556563823351,0.24570446735395188,,,550,585
59,59,3,1,10,1,0,0,225,559,325,26,-1,,0.05860556563823351,0.24570446735395188,,,550,585
60,60,4,1,10,1,1,0,225,559,325,26,-1,,0.05860556563823351,0.24570446735395188,,,550,585
61,61,5,1,10,1,1,1,225,559,45,26,96,(22),0.037431941923774956,0.24570446735395188,,,270,585
62,62,5,1,10,1,1,2,286,561,48,18,96,Date,0.04688445251058681,0.24484536082474226,,,334,579
63,63,5,1,10,1,1,3,342,566,12,13,96,of,0.05263157894736842,0.24591924398625428,,,354,579
64,64,5,1,10,1,1,4,355,561,67,23,96,filing:,0.058756805807622506,0.24591924398625428,,,422,584
65,65,5,1,10,1,1,5,432,561,118,18,96,20.04.2012,0.07425892316999395,0.24484536082474226,filing_date,20.04.2012,550,579
66,66,2,1,11,0,0,0,1002,245,458,38,-1,,0.18617664851784635,0.1134020618556701,,,1460,283
67,67,3,1,11,1,0,0,1002,245,458,38,-1,,0.18617664851784635,0.1134020618556701,,,1460,283
68,68,4,1,11,1,1,0,1002,245,458,38,-1,,0.18617664851784635,0.1134020618556701,,,1460,283
69,69,5,1,11,1,1,1,1002,256,44,27,74,(11),0.15486993345432548,0.11576460481099657,,,1046,283
70,70,5,1,11,1,1,2,1146,245,52,32,94,EP,0.17725347852389595,0.11211340206185567,number,EP,1198,277
71,71,5,1,11,1,1,3,1214,245,20,32,94,3,0.1851179673321234,0.11211340206185567,number,3,1234,277
72,72,5,1,11,1,1,4,1248,245,69,32,94,402,0.1939655172413793,0.11211340206185567,number,402,1317,277
73,73,5,1,11,1,1,5,1333,245,66,32,91,199,0.20659407138535996,0.11211340206185567,number,199,1399,277
74,74,5,1,11,1,1,6,1413,245,47,32,88,A1,0.21725650332728372,0.11211340206185567,number,A1,1460,277
75,75,2,1,12,0,0,0,577,319,537,26,-1,,0.1278735632183908,0.14261168384879724,,,1114,345
76,76,3,1,12,1,0,0,577,319,537,26,-1,,0.1278735632183908,0.14261168384879724,,,1114,345
77,77,4,1,12,1,1,0,577,319,537,26,-1,,0.1278735632183908,0.14261168384879724,,,1114,345
78,78,5,1,12,1,1,1,577,319,156,26,95,EUROPEAN,0.09906231094978826,0.14261168384879724,,,733,345
79,79,5,1,12,1,1,2,735,320,135,24,95,PATENT,0.12137023593466424,0.14261168384879724,,,870,344
80,80,5,1,12,1,1,3,873,319,241,26,96,APPLICATION,0.1502571082879613,0.14261168384879724,,,1114,345
81,81,2,1,13,0,0,0,862,395,272,173,-1,,0.15093768905021174,0.20682989690721648,,,1134,568
82,82,3,1,13,1,0,0,862,395,272,173,-1,,0.15093768905021174,0.20682989690721648,,,1134,568
83,83,4,1,13,1,1,0,862,395,126,26,-1,,0.13989715668481548,0.17525773195876287,,,988,421
84,84,5,1,13,1,1,1,862,395,44,26,67,(51),0.1336963097398669,0.17525773195876287,,,906,421
85,85,5,1,13,1,1,2,923,397,25,18,93,Int,0.1414851784633999,0.17439862542955326,,,948,415
86,86,5,1,13,1,1,3,955,397,33,18,65,Cl:,0.14692982456140352,0.17439862542955326,,,988,415
87,87,4,1,13,1,2,0,922,425,212,21,-1,,0.15547489413188142,0.1870704467353952,,,1134,446
88,88,5,1,13,1,2,1,922,428,61,18,58,HO4N,0.1440562613430127,0.1877147766323024,,,983,446
89,89,5,1,13,1,2,2,992,428,70,18,84,19/176,0.15532365396249243,0.1877147766323024,class_international,19/176,1062,446
90,90,5,1,13,1,2,3,1067,425,67,16,73,(2014.07),0.16643980641258319,0.18599656357388317,,,1134,441
91,91,4,1,13,1,3,0,922,455,212,21,-1,,0.15547489413188142,0.19995704467353953,,,1134,476
92,92,5,1,13,1,3,1,922,458,61,18,74,HO4N,0.1440562613430127,0.20060137457044674,,,983,476
93,93,5,1,13,1,3,2,992,458,70,18,89,19/463,0.15532365396249243,0.20060137457044674,,,1062,476
94,94,5,1,13,1,3,3,1067,455,67,16,67,(2014.07),0.16643980641258319,0.19888316151202748,,,1134,471
95,95,4,1,13,1,4,0,922,486,199,21,-1,,0.15449183303085298,0.21327319587628865,,,1121,507
96,96,5,1,13,1,4,1,922,488,61,19,92,HO4N,0.1440562613430127,0.21370274914089346,class_international,H04N,983,507
97,97,5,1,13,1,4,2,992,488,57,19,70,19/60,0.154340592861464,0.21370274914089346,,,1049,507
98,98,5,1,13,1,4,3,1054,486,67,15,92,(2014.00),0.16447368421052633,0.21198453608247422,,,1121,501
99,99,4,1,13,1,5,0,922,516,199,21,-1,,0.15449183303085298,0.226159793814433,,,1121,537
100,100,5,1,13,1,5,1,922,519,61,18,83,HOAN,0.1440562613430127,0.2268041237113402,,,983,537
101,101,5,1,13,1,5,2,992,519,57,18,68,19/44,0.154340592861464,0.2268041237113402,,,1049,537
102,102,5,1,13,1,5,3,1054,516,67,16,68,(201400,0.16447368421052633,0.22508591065292097,,,1121,532
103,103,4,1,13,1,6,0,922,547,212,21,-1,,0.15547489413188142,0.23947594501718214,,,1134,568
104,104,5,1,13,1,6,1,922,550,61,18,79,HOAN,0.1440562613430127,0.24012027491408935,,,983,568
105,105,5,1,13,1,6,2,992,550,70,18,69,191157,0.15532365396249243,0.24012027491408935,,,1062,568
106,106,5,1,13,1,6,3,1067,547,67,16,69,(201400),0.16643980641258319,0.23840206185567012,,,1134,563
107,107,2,1,14,0,0,0,1193,425,212,112,-1,,0.19646098003629764,0.20661512027491408,,,1405,537
108,108,3,1,14,1,0,0,1193,425,212,112,-1,,0.19646098003629764,0.20661512027491408,,,1405,537
109,109,4,1,14,1,1,0,1193,425,212,21,-1,,0.19646098003629764,0.1870704467353952,,,1405,446
110,110,5,1,14,1,1,1,1193,428,61,18,53,HO4N,0.1850423472474289,0.1877147766323024,,,1254,446
111,111,5,1,14,1,1,2,1263,428,70,18,69,19/196,0.19630973986690864,0.1877147766323024,,,1333,446
112,112,5,1,14,1,1,3,1338,425,67,16,55,(2014.91),0.2074258923169994,0.18599656357388317,,,1405,441
113,113,4,1,14,1,2,0,1193,455,212,21,-1,,0.19646098003629764,0.19995704467353953,,,1405,476
114,114,5,1,14,1,2,1,1193,458,61,18,71,HO4N,0.1850423472474289,0.20060137457044674,,,1254,476
115,115,5,1,14,1,2,2,1263,458,70,18,69,191124,0.19630973986690864,0.20060137457044674,,,1333,476
116,116,5,1,14,1,2,3,1338,455,67,16,79,(2014.91),0.2074258923169994,0.19888316151202748,,,1405,471
117,117,4,1,14,1,3,0,1193,486,212,21,-1,,0.19646098003629764,0.21327319587628865,,,1405,507
118,118,5,1,14,1,3,1,1193,488,61,19,46,HO4N,0.1850423472474289,0.21370274914089346,,,1254,507
119,119,5,1,14,1,3,2,1263,488,70,19,90,191593,0.19630973986690864,0.21370274914089346,,,1333,507
120,120,5,1,14,1,3,3,1338,486,67,15,64,(2014.91),0.2074258923169994,0.21198453608247422,,,1405,501
121,121,4,1,14,1,4,0,1193,516,199,21,-1,,0.1954779189352692,0.226159793814433,,,1392,537
122,122,5,1,14,1,4,1,1193,519,61,18,71,HOAN,0.1850423472474289,0.2268041237113402,,,1254,537
123,123,5,1,14,1,4,2,1263,519,56,18,87,19/11,0.19525105868118572,0.2268041237113402,,,1319,537
124,124,5,1,14,1,4,3,1325,516,67,16,84,(2014.00),0.20545977011494254,0.22508591065292097,,,1392,532
125,125,2,1,15,0,0,0,224,612,1243,6,-1,,0.1278735632183908,0.26417525773195877,,,1467,618
126,126,3,1,15,1,0,0,224,612,1243,6,-1,,0.1278735632183908,0.26417525773195877,,,1467,618
127,127,4,1,15,1,1,0,224,612,1243,6,-1,,0.1278735632183908,0.26417525773195877,,,1467,618
128,128,5,1,15,1,1,1,224,612,1243,6,95, ,0.1278735632183908,0.26417525773195877,,,1467,618
129,129,2,1,16,0,0,0,225,631,599,119,-1,,0.07932546884452511,0.296606529209622,,,824,750
130,130,3,1,16,1,0,0,225,631,599,119,-1,,0.07932546884452511,0.296606529209622,,,824,750
131,131,4,1,16,1,1,0,225,631,388,27,-1,,0.0633696309739867,0.2768470790378007,,,613,658
132,132,5,1,16,1,1,1,225,631,45,27,96,(84),0.037431941923774956,0.2768470790378007,,,270,658
133,133,5,1,16,1,1,2,286,633,118,23,96,Designated,0.052177858439201454,0.2768470790378007,,,404,656
134,134,5,1,16,1,1,3,413,633,119,23,96,Contracting,0.07146098003629764,0.2768470790378007,,,532,656
135,135,5,1,16,1,1,4,542,633,71,19,96,States:,0.08734119782214156,0.2759879725085911,,,613,652
136,136,4,1,16,1,2,0,285,666,537,18,-1,,0.08371143375680581,0.28994845360824745,,,822,684
137,137,5,1,16,1,2,1,285,666,31,18,94,AL,0.04544767090139141,0.28994845360824745,,,316,684
138,138,5,1,16,1,2,2,323,666,31,18,94,AT,0.05119479733817302,0.28994845360824745,,,354,684
139,139,5,1,16,1,2,3,363,666,30,18,96,BE,0.05716878402903811,0.28994845360824745,,,393,684
140,140,5,1,16,1,2,4,403,666,32,18,96,BG,0.0633696309739867,0.28994845360824745,,,435,684
141,141,5,1,16,1,2,5,445,666,31,18,96,CH,0.06964609800362977,0.28994845360824745,,,476,684
142,142,5,1,16,1,2,6,486,666,32,18,95,CY,0.07592256503327284,0.28994845360824745,,,518,684
143,143,5,1,16,1,2,7,526,666,30,18,93,CZ,0.08182093163944344,0.28994845360824745,,,556,684
144,144,5,1,16,1,2,8,565,666,30,18,93,DE,0.08771929824561403,0.28994845360824745,,,595,684
145,145,5,1,16,1,2,9,605,666,32,18,95,DK,0.09392014519056262,0.28994845360824745,,,637,684
146,146,5,1,16,1,2,10,646,666,29,18,95,EE,0.0998941318814277,0.28994845360824745,,,675,684
147,147,5,1,16,1,2,11,684,666,29,18,93,ES,0.10564125831820932,0.28994845360824745,,,713,684
148,148,5,1,16,1,2,12,723,666,57,18,90,FIFR,0.11365698729582577,0.28994845360824745,,,780,684
149,149,5,1,16,1,2,13,788,666,34,18,95,GB,0.12174833635813673,0.28994845360824745,,,822,684
150,150,4,1,16,1,3,0,285,699,539,18,-1,,0.0838626739261948,0.30412371134020616,,,824,717
151,151,5,1,16,1,3,1,285,699,297,18,83,GRHRHUIEISITLILTLU,0.06556261343012704,0.30412371134020616,,,582,717
152,152,5,1,16,1,3,2,591,699,28,18,85,LV,0.09150030248033877,0.30412371134020616,,,619,717
153,153,5,1,16,1,3,3,627,699,35,18,85,MC,0.09747428917120388,0.30412371134020616,,,662,717
154,154,5,1,16,1,3,4,670,699,35,18,94,MK,0.10397761645493044,0.30412371134020616,,,705,717
155,155,5,1,16,1,3,5,713,699,32,18,91,MT,0.11025408348457351,0.30412371134020616,,,745,717
156,156,5,1,16,1,3,6,753,699,29,18,49,NL,0.11607683000604961,0.30412371134020616,,,782,717
157,157,5,1,16,1,3,7,791,699,33,18,49,NO,0.1221264367816092,0.30412371134020616,,,824,717
158,158,4,1,16,1,4,0,286,732,336,18,-1,,0.06866303690260134,0.31829896907216493,,,622,750
159,159,5,1,16,1,4,1,286,732,28,18,93,PL,0.045372050816696916,0.31829896907216493,,,314,750
160,160,5,1,16,1,4,2,323,732,29,18,92,PT,0.05104355716878403,0.31829896907216493,,,352,750
161,161,5,1,16,1,4,3,360,732,58,18,92,RORS,0.058832425892317,0.31829896907216493,,,418,750
162,162,5,1,16,1,4,4,420,732,52,18,92,SE,0.06745311554748941,0.31829896907216493,,,472,750
163,163,5,1,16,1,4,5,480,732,20,18,95,SI,0.07410768300060495,0.31829896907216493,,,500,750
164,164,5,1,16,1,4,6,510,732,31,18,93,SK,0.0794767090139141,0.31829896907216493,,,541,750
165,165,5,1,16,1,4,7,550,732,72,18,90,SMTR,0.08862673926194797,0.31829896907216493,,,622,750
166,166,2,1,17,0,0,0,225,795,479,53,-1,,0.07025105868118572,0.35287800687285226,,,704,848
167,167,3,1,17,1,0,0,225,795,479,53,-1,,0.07025105868118572,0.35287800687285226,,,704,848
168,168,4,1,17,1,1,0,225,795,479,27,-1,,0.07025105868118572,0.3472938144329897,,,704,822
169,169,5,1,17,1,1,1,225,795,45,27,96,(30),0.037431941923774956,0.3472938144329897,,,270,822
170,170,5,1,17,1,1,2,286,797,77,23,94,Priority:,0.04907743496672716,0.3472938144329897,,,363,820
171,171,5,1,17,1,1,3,383,797,116,19,94,24.10.2011,0.06669691470054447,0.34643470790378006,,,499,816
172,172,5,1,17,1,1,4,520,797,32,19,93,KR,0.08106473079249849,0.34643470790378006,,,552,816
173,173,5,1,17,1,1,5,560,797,144,19,93,20110108456,0.0955837870538415,0.34643470790378006,,,704,816
174,174,4,1,17,1,2,0,383,830,321,18,-1,,0.08219903206291591,0.3603951890034364,,,704,848
175,175,5,1,17,1,2,1,383,830,116,18,92,24.10.2011,0.06669691470054447,0.3603951890034364,priority_date_eu,24.10.2011,499,848
176,176,5,1,17,1,2,2,520,830,32,18,92,KR,0.08106473079249849,0.3603951890034364,,,552,848
177,177,5,1,17,1,2,3,560,830,144,18,96,20110108460,0.0955837870538415,0.3603951890034364,,,704,848
178,178,2,1,18,0,0,0,225,893,596,87,-1,,0.07909860859044163,0.4022766323024055,,,821,980
179,179,3,1,18,1,0,0,225,893,596,87,-1,,0.07909860859044163,0.4022766323024055,,,821,980
180,180,4,1,18,1,1,0,225,893,596,27,-1,,0.07909860859044163,0.3893900343642612,,,821,920
181,181,5,1,18,1,1,1,225,893,45,27,96,(62),0.037431941923774956,0.3893900343642612,,,270,920
182,182,5,1,18,1,1,2,286,895,107,19,96,Document,0.05134603750756201,0.38853092783505155,,,393,914
183,183,5,1,18,1,1,3,402,895,105,23,95,number(s),0.06873865698729582,0.3893900343642612,,,507,918
184,184,5,1,18,1,1,4,516,895,20,19,96,of,0.07955232909860858,0.38853092783505155,,,536,914
185,185,5,1,18,1,1,5,542,895,32,19,96,the,0.08439201451905626,0.38853092783505155,,,574,914
186,186,5,1,18,1,1,6,582,895,66,19,96,earlier,0.09301270417422867,0.38853092783505155,,,648,914
187,187,5,1,18,1,1,7,655,895,140,23,95,application(s),0.10964912280701754,0.3893900343642612,,,795,918
188,188,5,1,18,1,1,8,805,895,16,19,96,in,0.12295825771324864,0.38853092783505155,,,821,914
189,189,4,1,18,1,2,0,286,929,308,18,-1,,0.06654567453115548,0.4029209621993127,,,594,947
190,190,5,1,18,1,2,1,286,929,121,18,96,accordance,0.05240471869328494,0.4029209621993127,,,407,947
191,191,5,1,18,1,2,2,415,929,40,18,96,with,0.06578947368421052,0.4029209621993127,,,455,947
192,192,5,1,18,1,2,3,464,929,35,18,95,Art.,0.07282214156079855,0.4029209621993127,,,499,947
193,193,5,1,18,1,2,4,508,929,25,18,95,76,0.07872050816696914,0.4029209621993127,,,533,947
194,194,5,1,18,1,2,5,542,929,52,18,96,EPC:,0.08590441621294616,0.4029209621993127,,,594,947
195,195,4,1,18,1,3,0,286,961,250,19,-1,,0.06215970961887477,0.4168814432989691,,,536,980
196,196,5,1,18,1,3,1,286,961,124,19,87,12843637.5,0.05263157894736842,0.4168814432989691,,,410,980
197,197,5,1,18,1,3,2,417,961,7,19,87,/,0.06359649122807018,0.4168814432989691,,,424,980
198,198,5,1,18,1,3,3,432,961,11,19,74,2,0.066167574107683,0.4168814432989691,,,443,980
199,199,5,1,18,1,3,4,451,961,38,19,74,773,0.07108287961282517,0.4168814432989691,,,489,980
200,200,5,1,18,1,3,5,499,961,37,19,92,117,0.07826678765880218,0.4168814432989691,,,536,980
201,201,2,1,19,0,0,0,225,1025,387,26,-1,,0.0632940108892922,0.44587628865979384,,,612,1051
202,202,3,1,19,1,0,0,225,1025,387,26,-1,,0.0632940108892922,0.44587628865979384,,,612,1051
203,203,4,1,19,1,1,0,225,1025,387,26,-1,,0.0632940108892922,0.44587628865979384,,,612,1051
204,204,5,1,19,1,1,1,225,1025,45,26,96,(71),0.037431941923774956,0.44587628865979384,,,270,1051
205,205,5,1,19,1,1,2,285,1027,103,23,93,Applicant:,0.05089231699939504,0.44609106529209624,,,388,1050
206,206,5,1,19,1,1,3,397,1027,115,23,92,Infobridge,0.06873865698729582,0.44609106529209624,applicant_line_1,Infobridge,512,1050
207,207,5,1,19,1,1,4,521,1027,41,18,96,Pte.,0.08189655172413793,0.44501718213058417,applicant_line_1,Pte.,562,1045
208,208,5,1,19,1,1,5,572,1027,40,18,96,Ltd.,0.08953418027828192,0.44501718213058417,applicant_line_1,Ltd.,612,1045
209,209,2,1,20,0,0,0,844,614,4,500,-1,,0.1279491833030853,0.3711340206185567,,,848,1114
210,210,3,1,20,1,0,0,844,614,4,500,-1,,0.1279491833030853,0.3711340206185567,,,848,1114
211,211,4,1,20,1,1,0,844,614,4,500,-1,,0.1279491833030853,0.3711340206185567,,,848,1114
212,212,5,1,20,1,1,1,844,614,4,500,95, ,0.1279491833030853,0.3711340206185567,,,848,1114
213,213,2,1,21,0,0,0,862,631,316,58,-1,,0.1542649727767695,0.28350515463917525,,,1178,689
214,214,3,1,21,1,0,0,862,631,316,58,-1,,0.1542649727767695,0.28350515463917525,,,1178,689
215,215,4,1,21,1,1,0,862,631,316,27,-1,,0.1542649727767695,0.2768470790378007,,,1178,658
216,216,5,1,21,1,1,1,862,631,44,27,94,(72),0.1336963097398669,0.2768470790378007,,,906,658
217,217,5,1,21,1,1,2,923,633,89,19,94,Inventor:,0.14632486388384755,0.2759879725085911,,,1012,652
218,218,5,1,21,1,1,3,1022,633,66,19,96,"PARK,",0.15955837870538414,0.2759879725085911,inventor_line_1,"PARK,",1088,652
219,219,5,1,21,1,1,4,1090,633,48,23,95,Shin,0.16848154869933454,0.2768470790378007,inventor_line_1,Shin,1138,656
220,220,5,1,21,1,1,5,1140,633,38,19,95,Ji,0.1752873563218391,0.2759879725085911,inventor_line_1,Ji,1178,652
221,221,4,1,21,1,2,0,923,666,213,23,-1,,0.15570175438596492,0.29102233676975947,,,1136,689
222,222,5,1,21,1,2,1,923,666,84,18,95,156-855,0.14594676346037508,0.28994845360824745,,,1007,684
223,223,5,1,21,1,2,2,1016,666,56,18,96,Seoul,0.15789473684210525,0.28994845360824745,,,1072,684
224,224,5,1,21,1,2,3,1075,666,61,23,96,(KR),0.16719600725952813,0.29102233676975947,,,1136,689
225,225,2,1,22,0,0,0,862,730,489,156,-1,,0.16734724742891713,0.3470790378006873,,,1351,886
226,226,3,1,22,1,0,0,862,730,489,156,-1,,0.16734724742891713,0.3470790378006873,,,1351,886
227,227,4,1,22,1,1,0,862,730,489,26,-1,,0.16734724742891713,0.31915807560137455,,,1351,756
228,228,5,1,22,1,1,1,862,730,44,26,96,(74),0.1336963097398669,0.31915807560137455,,,906,756
229,229,5,1,22,1,1,2,923,732,163,23,93,Representative:,0.15192075015124018,0.31937285223367695,,,1086,755
230,230,5,1,22,1,1,3,1095,732,120,18,84,Griinecker,0.17468239564428312,0.31829896907216493,representative_line_1_eu,Grunecker,1215,750
231,231,5,1,22,1,1,4,1223,732,78,18,92,Patent-,0.190865093768905,0.31829896907216493,representative_line_1_eu,Patent-,1301,750
232,232,5,1,22,1,1,5,1310,732,41,18,96,und,0.20122504537205083,0.31829896907216493,representative_line_1_eu,und,1351,750
233,233,4,1,22,1,2,0,923,765,164,18,-1,,0.15199637023593465,0.3324742268041237,,,1087,783
234,234,5,1,22,1,2,1,923,765,164,18,81,Rechtsanwalte,0.15199637023593465,0.3324742268041237,,,1087,783
235,235,4,1,22,1,3,0,923,797,121,19,-1,,0.14874470659407138,0.34643470790378006,,,1044,816
236,236,5,1,22,1,3,1,923,797,61,19,92,PartG,0.1442075015124017,0.34643470790378006,,,984,816
237,237,5,1,22,1,3,2,994,797,50,19,93,mbB,0.1541137326073805,0.34643470790378006,,,1044,816
238,238,4,1,22,1,4,0,923,830,182,23,-1,,0.15335753176043557,0.36146907216494845,,,1105,853
239,239,5,1,22,1,4,1,923,830,162,23,87,LeopoldstraRe,0.15184513006654568,0.36146907216494845,,,1085,853
240,240,5,1,22,1,4,2,1093,830,12,18,97,4,0.16621294615849969,0.3603951890034364,,,1105,848
241,241,4,1,22,1,5,0,922,863,231,23,-1,,0.15691167574107684,0.3756443298969072,,,1153,886
242,242,5,1,22,1,5,1,922,863,64,18,93,80802,0.1442831215970962,0.3745704467353952,,,986,881
243,243,5,1,22,1,5,2,996,863,101,18,85,Miinchen,0.15827283726557773,0.3745704467353952,,,1097,881
244,244,5,1,22,1,5,3,1107,863,46,23,95,(DE),0.17090139140955837,0.3756443298969072,,,1153,886
245,245,2,1,23,0,0,0,862,929,99,18,-1,,0.13785541439806412,0.4029209621993127,,,961,947
246,246,3,1,23,1,0,0,862,929,99,18,-1,,0.13785541439806412,0.4029209621993127,,,961,947
247,247,4,1,23,1,1,0,862,929,99,18,-1,,0.13785541439806412,0.4029209621993127,,,961,947
248,248,5,1,23,1,1,1,862,929,99,18,96,Remarks:,0.13785541439806412,0.4029209621993127,,,961,947
249,249,2,1,24,0,0,0,922,961,522,84,-1,,0.17891712038717483,0.43084192439862545,,,1444,1045
250,250,3,1,24,1,0,0,922,961,522,84,-1,,0.17891712038717483,0.43084192439862545,,,1444,1045
251,251,4,1,24,1,1,0,922,961,474,23,-1,,0.1752873563218391,0.4177405498281787,,,1396,984
252,252,5,1,24,1,1,1,922,961,43,19,96,This,0.1426950998185118,0.4168814432989691,,,965,980
253,253,5,1,24,1,1,2,974,961,111,23,96,application,0.15570175438596492,0.4177405498281787,,,1085,984
254,254,5,1,24,1,1,3,1093,966,42,14,96,was,0.16848154869933454,0.4179553264604811,,,1135,980
255,255,5,1,24,1,1,4,1142,961,43,19,96,filed,0.17596793708408953,0.4168814432989691,,,1185,980
256,256,5,1,24,1,1,5,1193,966,25,14,96,on,0.1823200241984271,0.4179553264604811,,,1218,980
257,257,5,1,24,1,1,6,1227,961,118,19,96,04.07.2018,0.19449485783424078,0.4168814432989691,,,1345,980
258,258,5,1,24,1,1,7,1353,966,24,14,96,as,0.20644283121597096,0.4179553264604811,,,1377,980
259,259,5,1,24,1,1,8,1385,966,11,14,96,a,0.2102994555353902,0.4179553264604811,,,1396,980
260,260,4,1,24,1,2,0,922,994,522,23,-1,,0.17891712038717483,0.4319158075601375,,,1444,1017
261,261,5,1,24,1,2,1,922,994,96,18,96,divisional,0.14670296430732002,0.43084192439862545,,,1018,1012
262,262,5,1,24,1,2,2,1026,994,112,23,96,application,0.16364186327888688,0.4319158075601375,,,1138,1017
263,263,5,1,24,1,2,3,1147,995,19,17,96,to,0.17490925589836662,0.43105670103092786,,,1166,1012
264,264,5,1,24,1,2,4,1174,994,31,18,96,the,0.17990018148820328,0.43084192439862545,,,1205,1012
265,265,5,1,24,1,2,5,1214,994,112,23,96,application,0.19207501512401695,0.4319158075601375,,,1326,1017
266,266,5,1,24,1,2,6,1336,994,108,18,96,mentioned,0.2102238354506957,0.43084192439862545,,,1444,1012
267,267,4,1,24,1,3,0,923,1027,209,18,-1,,0.15539927404718692,0.44501718213058417,,,1132,1045
268,268,5,1,24,1,3,1,923,1027,50,18,92,under,0.14337568058076225,0.44501718213058417,,,973,1045
269,269,5,1,24,1,3,2,975,1027,61,18,85,INID,0.15207199032062915,0.44501718213058417,,,1036,1045
270,270,5,1,24,1,3,3,1044,1027,50,18,96,code,0.16167574107683,0.44501718213058417,,,1094,1045
271,271,5,1,24,1,3,4,1103,1027,29,18,96,62.,0.16901088929219601,0.44501718213058417,,,1132,1045
272,272,2,1,25,0,0,0,224,1110,1243,6,-1,,0.1278735632183908,0.47809278350515466,,,1467,1116
273,273,3,1,25,1,0,0,224,1110,1243,6,-1,,0.1278735632183908,0.47809278350515466,,,1467,1116
274,274,4,1,25,1,1,0,224,1110,1243,6,-1,,0.1278735632183908,0.47809278350515466,,,1467,1116
275,275,5,1,25,1,1,1,224,1110,1243,6,95, ,0.1278735632183908,0.47809278350515466,,,1467,1116
276,276,2,1,26,0,0,0,225,1059,582,174,-1,,0.0780399274047187,0.49226804123711343,,,807,1233
277,277,3,1,26,1,0,0,225,1059,582,174,-1,,0.0780399274047187,0.49226804123711343,,,807,1233
278,278,4,1,26,1,1,0,286,1059,257,23,-1,,0.06268905021173624,0.45983676975945015,,,543,1082
279,279,5,1,26,1,1,1,286,1059,114,23,96,Singapore,0.051875378100423475,0.45983676975945015,,,400,1082
280,280,5,1,26,1,1,2,409,1059,77,19,96,079903,0.0676799758015729,0.45897766323024053,,,486,1078
281,281,5,1,26,1,1,3,495,1059,48,23,96,(SG),0.07849364791288566,0.45983676975945015,,,543,1082
282,282,4,1,26,1,2,0,225,1131,448,27,-1,,0.06790683605565638,0.49162371134020616,,,673,1158
283,283,5,1,26,1,2,1,225,1131,45,27,84,(54),0.037431941923774956,0.49162371134020616,,,270,1158
284,284,5,1,26,1,2,2,316,1131,84,21,84,IMAGE,0.05414398064125832,0.49033505154639173,title_line_1,IMAGE,400,1152
285,285,5,1,26,1,2,3,411,1131,139,21,96,DECODING,0.07267090139140955,0.49033505154639173,title_line_1,DECODING,550,1152
286,286,5,1,26,1,2,4,561,1131,112,21,96,METHOD,0.09331518451300666,0.49033505154639173,title_line_1,METHOD,673,1152
287,287,4,1,26,1,3,0,225,1206,582,27,-1,,0.0780399274047187,0.523840206185567,,,807,1233
288,288,5,1,26,1,3,1,225,1206,45,27,89,(57),0.037431941923774956,0.523840206185567,,,270,1233
289,289,5,1,26,1,3,2,0,0,1653,2328,27,‚Äî,0.125,0.5,,,1653,2328
290,290,5,1,26,1,3,3,315,1208,27,19,96,An,0.049682395644283124,0.5229810996563574,,,342,1227
291,291,5,1,26,1,3,4,357,1208,62,23,96,image,0.05868118572292801,0.523840206185567,,,419,1231
292,292,5,1,26,1,3,5,431,1208,95,23,96,decoding,0.07236842105263158,0.523840206185567,,,526,1231
293,293,5,1,26,1,3,6,540,1208,77,19,96,method,0.08749243799153054,0.5229810996563574,,,617,1227
294,294,5,1,26,1,3,7,630,1208,101,23,96,according,0.1029189352692075,0.523840206185567,,,731,1231
295,295,5,1,26,1,3,8,744,1209,19,18,96,to,0.11395946763460375,0.5231958762886598,,,763,1227
296,296,5,1,26,1,3,9,775,1208,32,19,96,the,0.11963097398669087,0.5229810996563574,,,807,1227
297,297,2,1,27,0,0,0,224,1241,584,285,-1,,0.0780399274047187,0.594286941580756,,,808,1526
298,298,3,1,27,1,0,0,224,1241,584,285,-1,,0.0780399274047187,0.594286941580756,,,808,1526
299,299,4,1,27,1,1,0,226,1241,581,23,-1,,0.07811554748941318,0.5380154639175257,,,807,1264
300,300,5,1,27,1,1,1,226,1242,78,22,96,present,0.04007864488808228,0.5382302405498282,,,304,1264
301,301,5,1,27,1,1,2,318,1241,93,18,95,invention,0.055127041742286755,0.5369415807560137,,,411,1259
302,302,5,1,27,1,1,3,426,1241,112,23,96,comprises:,0.07289776164549304,0.5380154639175257,,,538,1264
303,303,5,1,27,1,1,4,554,1241,110,23,96,generating,0.09210526315789473,0.5380154639175257,,,664,1264
304,304,5,1,27,1,1,5,679,1246,11,13,96,a,0.10352389594676346,0.5380154639175257,,,690,1259
305,305,5,1,27,1,1,6,706,1241,101,23,96,prediction,0.11441318814277072,0.5380154639175257,,,807,1264
306,306,4,1,27,1,2,0,226,1274,581,23,-1,,0.07811554748941318,0.5521907216494846,,,807,1297
307,307,5,1,27,1,2,1,226,1274,54,18,96,block,0.0382637628554144,0.5511168384879725,,,280,1292
308,308,5,1,27,1,2,2,288,1274,23,23,96,by,0.04529643073200242,0.5521907216494846,,,311,1297
309,309,5,1,27,1,2,3,319,1274,147,23,96,reconstructing,0.05936176648517846,0.5521907216494846,,,466,1297
310,310,5,1,27,1,2,4,475,1274,31,18,96,the,0.07418330308529945,0.5511168384879725,,,506,1292
311,311,5,1,27,1,2,5,515,1274,44,18,96,intra,0.08121597096188747,0.5511168384879725,,,559,1292
312,312,5,1,27,1,2,6,568,1274,100,23,96,prediction,0.09346642468239565,0.5521907216494846,,,668,1297
313,313,5,1,27,1,2,7,677,1274,58,18,95,mode,0.10677555958862674,0.5511168384879725,,,735,1292
314,314,5,1,27,1,2,8,743,1274,37,18,95,and,0.11516938898971567,0.5511168384879725,,,780,1292
315,315,5,1,27,1,2,9,788,1274,19,18,96,to,0.1206140350877193,0.5511168384879725,,,807,1292
316,316,4,1,27,1,3,0,225,1306,582,23,-1,,0.0780399274047187,0.5659364261168385,,,807,1329
317,317,5,1,27,1,3,1,225,1307,86,18,96,recreate,0.04053236539624924,0.5652920962199313,,,311,1325
318,318,5,1,27,1,3,2,323,1311,12,14,96,a,0.04975801572897762,0.5661512027491409,,,335,1325
319,319,5,1,27,1,3,3,349,1306,100,23,96,prediction,0.0603448275862069,0.5659364261168385,,,449,1329
320,320,5,1,27,1,3,4,463,1306,54,19,96,block,0.07410768300060495,0.5650773195876289,,,517,1325
321,321,5,1,27,1,3,5,529,1306,20,19,96,of,0.08151845130066546,0.5650773195876289,,,549,1325
322,322,5,1,27,1,3,6,560,1306,32,19,96,the,0.08711433756805807,0.5650773195876289,,,592,1325
323,323,5,1,27,1,3,7,605,1307,73,18,96,current,0.0970205686630369,0.5652920962199313,,,678,1325
324,324,5,1,27,1,3,8,691,1306,58,22,96,"block,",0.1088929219600726,0.5657216494845361,,,749,1328
325,325,5,1,27,1,3,9,763,1311,21,14,94,or,0.11698427102238354,0.5661512027491409,,,784,1325
326,326,5,1,27,1,3,10,796,1311,11,14,95,a,0.12121899576527526,0.5661512027491409,,,807,1325
327,327,4,1,27,1,4,0,225,1339,582,23,-1,,0.0780399274047187,0.5801116838487973,,,807,1362
328,328,5,1,27,1,4,1,225,1339,89,18,92,sub-block,0.04075922565033273,0.5790378006872853,,,314,1357
329,329,5,1,27,1,4,2,316,1339,35,18,93,of,0.05043859649122807,0.5790378006872853,,,351,1357
330,330,5,1,27,1,4,3,353,1339,33,18,93,the,0.0558832425892317,0.5790378006872853,,,386,1357
331,331,5,1,27,1,4,4,391,1344,65,13,95,current,0.06405021173623715,0.5801116838487973,,,456,1357
332,332,5,1,27,1,4,5,458,1339,70,22,95,block;,0.07456140350877193,0.5798969072164949,,,528,1361
333,333,5,1,27,1,4,6,535,1344,77,13,95,reverse,0.0867362371445856,0.5801116838487973,,,612,1357
334,334,5,1,27,1,4,7,617,1339,93,23,95,scanning,0.10034785238959468,0.5801116838487973,,,710,1362
335,335,5,1,27,1,4,8,716,1339,27,18,92,for,0.110329703569268,0.5790378006872853,,,743,1357
336,336,5,1,27,1,4,9,748,1340,59,17,92,trans-,0.1175892316999395,0.5792525773195877,,,807,1357
337,337,4,1,27,1,5,0,224,1372,583,23,-1,,0.0779643073200242,0.594286941580756,,,807,1395
338,338,5,1,27,1,5,1,224,1372,78,23,96,forming,0.03977616454930429,0.594286941580756,,,302,1395
339,339,5,1,27,1,5,2,313,1372,81,19,96,residual,0.05346339987900786,0.5934278350515464,,,394,1391
340,340,5,1,27,1,5,3,405,1372,72,23,96,signals,0.06669691470054447,0.594286941580756,,,477,1395
341,341,5,1,27,1,5,4,488,1372,35,19,96,into,0.0764519056261343,0.5934278350515464,,,523,1391
342,342,5,1,27,1,5,5,533,1377,12,14,96,a,0.08151845130066546,0.5945017182130584,,,545,1391
343,343,5,1,27,1,5,6,555,1372,171,19,93,two-dimensional,0.09686932849364792,0.5934278350515464,,,726,1391
344,344,5,1,27,1,5,7,736,1372,71,23,92,quanti-,0.11668179068360557,0.594286941580756,,,807,1395
345,345,4,1,27,1,6,0,225,1405,583,23,-1,,0.07811554748941318,0.6084621993127147,,,808,1428
346,346,5,1,27,1,6,1,225,1405,61,18,96,zation,0.03864186327888687,0.6073883161512027,,,286,1423
347,347,5,1,27,1,6,2,298,1405,59,22,96,block;,0.04953115547489413,0.6082474226804123,,,357,1427
348,348,5,1,27,1,6,3,369,1410,77,13,96,reverse,0.06163036902601331,0.6084621993127147,,,446,1423
349,349,5,1,27,1,6,4,457,1405,106,23,96,quantizing,0.07713248638838476,0.6084621993127147,,,563,1428
350,350,5,1,27,1,6,5,573,1405,32,18,96,the,0.08908045977011494,0.6073883161512027,,,605,1423
351,351,5,1,27,1,6,6,616,1405,126,23,96,quantization,0.10269207501512402,0.6084621993127147,,,742,1428
352,352,5,1,27,1,6,7,754,1405,54,18,96,block,0.11811857229280097,0.6073883161512027,,,808,1423
353,353,4,1,27,1,7,0,226,1438,581,23,-1,,0.07811554748941318,0.6226374570446735,,,807,1461
354,354,5,1,27,1,7,1,226,1438,54,23,96,using,0.0382637628554144,0.6226374570446735,,,280,1461
355,355,5,1,27,1,7,2,288,1442,12,14,96,a,0.04446460980036298,0.6224226804123711,,,300,1456
356,356,5,1,27,1,7,3,309,1438,126,23,96,quantization,0.056261343012704176,0.6226374570446735,,,435,1461
357,357,5,1,27,1,7,4,445,1438,112,23,96,parameter;,0.07577132486388385,0.6226374570446735,,,557,1461
358,358,5,1,27,1,7,5,567,1438,37,18,96,and,0.08855111917725347,0.6215635738831615,,,604,1456
359,359,5,1,27,1,7,6,614,1442,77,14,93,reverse,0.09868421052631579,0.6224226804123711,,,691,1456
360,360,5,1,27,1,7,7,700,1438,107,18,91,transform-,0.11395946763460375,0.6215635738831615,,,807,1456
361,361,4,1,27,1,8,0,226,1470,581,23,-1,,0.07811554748941318,0.6363831615120275,,,807,1493
362,362,5,1,27,1,8,1,226,1470,28,23,96,ing,0.036297640653357534,0.6363831615120275,,,254,1493
363,363,5,1,27,1,8,2,263,1470,31,19,96,the,0.042120387174833636,0.6355240549828178,,,294,1489
364,364,5,1,27,1,8,3,303,1475,78,14,96,reverse,0.05172413793103448,0.6365979381443299,,,381,1489
365,365,5,1,27,1,8,4,389,1470,126,23,96,quantization,0.06836055656382335,0.6363831615120275,,,515,1493
366,366,5,1,27,1,8,5,524,1470,59,19,96,block.,0.08371143375680581,0.6355240549828178,,,583,1489
367,367,5,1,27,1,8,6,591,1470,40,19,96,The,0.09240774349667272,0.6355240549828178,,,631,1489
368,368,5,1,27,1,8,7,640,1470,126,23,93,quantization,0.10632183908045977,0.6363831615120275,,,766,1493
369,369,5,1,27,1,8,8,775,1475,32,18,93,pa-,0.11963097398669087,0.6374570446735395,,,807,1493
370,370,4,1,27,1,9,0,225,1503,582,23,-1,,0.0780399274047187,0.6505584192439863,,,807,1526
371,371,5,1,27,1,9,1,225,1504,82,17,96,rameter,0.040229885057471264,0.6496993127147767,,,307,1521
372,372,5,1,27,1,9,2,316,1503,96,23,96,"predictor,",0.055051421657592255,0.6505584192439863,,,412,1526
373,373,5,1,27,1,9,3,424,1503,49,18,96,used,0.06783121597096188,0.6494845360824743,,,473,1521
374,374,5,1,27,1,9,4,484,1504,18,17,96,to,0.07456140350877193,0.6496993127147767,,,502,1521
375,375,5,1,27,1,9,5,512,1504,117,17,96,reconstruct,0.08628251663641863,0.6496993127147767,,,629,1521
376,376,5,1,27,1,9,6,638,1503,32,18,96,the,0.09891107078039928,0.6494845360824743,,,670,1521
377,377,5,1,27,1,9,7,681,1503,126,23,96,quantization,0.11252268602540835,0.6505584192439863,,,807,1526
378,378,2,1,28,0,0,0,884,1208,584,281,-1,,0.17785843920145192,0.5792525773195877,,,1468,1489
379,379,3,1,28,1,0,0,884,1208,584,281,-1,,0.17785843920145192,0.5792525773195877,,,1468,1489
380,380,4,1,28,1,1,0,885,1208,581,23,-1,,0.17778281911675742,0.523840206185567,,,1466,1231
381,381,5,1,28,1,1,1,885,1209,112,22,96,"parameter,",0.14231699939503933,0.5240549828178694,,,997,1231
382,382,5,1,28,1,1,2,1010,1208,14,19,96,is,0.15381125226860254,0.5229810996563574,,,1024,1227
383,383,5,1,28,1,1,3,1035,1208,105,23,96,generated,0.16447368421052633,0.523840206185567,,,1140,1231
384,384,5,1,28,1,1,4,1153,1208,23,23,96,by,0.17611917725347853,0.523840206185567,,,1176,1231
385,385,5,1,28,1,1,5,1188,1208,54,23,96,using,0.1837568058076225,0.523840206185567,,,1242,1231
386,386,5,1,28,1,1,6,1253,1208,31,19,96,the,0.19184815486993345,0.5229810996563574,,,1284,1227
387,387,5,1,28,1,1,7,1295,1208,126,23,93,quantization,0.20538415003024804,0.523840206185567,,,1421,1231
388,388,5,1,28,1,1,8,1434,1213,32,18,93,pa-,0.21929824561403508,0.5249140893470791,,,1466,1231
389,389,4,1,28,1,2,0,885,1241,580,18,-1,,0.17770719903206292,0.5369415807560137,,,1465,1259
390,390,5,1,28,1,2,1,885,1242,80,17,96,rameters,0.13989715668481548,0.5371563573883161,,,965,1259
391,391,5,1,28,1,2,2,966,1241,39,18,96,of,0.14904718693284935,0.5369415807560137,,,1005,1259
392,392,5,1,28,1,2,3,1012,1241,31,18,96,the,0.15539927404718692,0.5369415807560137,,,1043,1259
393,393,5,1,28,1,2,4,1053,1241,65,18,96,blocks,0.16417120387174833,0.5369415807560137,,,1118,1259
394,394,5,1,28,1,2,5,1128,1241,30,18,96,left,0.17286751361161526,0.5369415807560137,,,1158,1259
395,395,5,1,28,1,2,6,1165,1241,38,18,96,and,0.17906836055656383,0.5369415807560137,,,1203,1259
396,396,5,1,28,1,2,7,1212,1241,63,18,96,above,0.1880671506352087,0.5369415807560137,,,1275,1259
397,397,5,1,28,1,2,8,1284,1241,32,18,96,the,0.19661222020568664,0.5369415807560137,,,1316,1259
398,398,5,1,28,1,2,9,1325,1246,64,13,96,current,0.20523290986085904,0.5380154639175257,,,1389,1259
399,399,5,1,28,1,2,10,1392,1241,73,18,96,block.,0.2160465819721718,0.5369415807560137,,,1465,1259
400,400,4,1,28,1,3,0,884,1274,583,23,-1,,0.17778281911675742,0.5521907216494846,,,1467,1297
401,401,5,1,28,1,3,1,884,1274,108,21,96,"Therefore,",0.14186327888687236,0.5517611683848798,,,992,1295
402,402,5,1,28,1,3,2,1002,1274,32,18,96,the,0.15396249243799154,0.5511168384879725,,,1034,1292
403,403,5,1,28,1,3,3,1045,1274,63,23,96,image,0.16281004234724744,0.5521907216494846,,,1108,1297
404,404,5,1,28,1,3,4,1117,1274,68,23,96,quality,0.17407743496672717,0.5521907216494846,,,1185,1297
405,405,5,1,28,1,3,5,1196,1274,14,18,96,is,0.18194192377495463,0.5511168384879725,,,1210,1292
406,406,5,1,28,1,3,6,1221,1274,95,23,95,improved,0.19184815486993345,0.5521907216494846,,,1316,1297
407,407,5,1,28,1,3,7,1328,1274,23,23,96,by,0.2025862068965517,0.5521907216494846,,,1351,1297
408,408,5,1,28,1,3,8,1360,1274,107,23,95,adaptively,0.21377797943133697,0.5521907216494846,,,1467,1297
409,409,4,1,28,1,4,0,885,1306,583,23,-1,,0.1779340592861464,0.5659364261168385,,,1468,1329
410,410,5,1,28,1,4,1,885,1306,105,23,96,controlling,0.14178765880217786,0.5659364261168385,,,990,1329
411,411,5,1,28,1,4,2,1001,1306,31,19,97,the,0.15373563218390804,0.5650773195876289,,,1032,1325
412,412,5,1,28,1,4,3,1043,1306,126,23,96,quantization,0.16727162734422263,0.5659364261168385,,,1169,1329
413,413,5,1,28,1,4,4,1180,1307,118,22,96,parameters,0.18738656987295826,0.5661512027491409,,,1298,1329
414,414,5,1,28,1,4,5,1307,1311,25,14,96,on,0.19956140350877194,0.5661512027491409,,,1332,1325
415,415,5,1,28,1,4,6,1343,1306,31,19,96,the,0.20545977011494254,0.5650773195876289,,,1374,1325
416,416,5,1,28,1,4,7,1385,1306,53,19,96,basis,0.21347549909255897,0.5650773195876289,,,1438,1325
417,417,5,1,28,1,4,8,1448,1306,20,19,96,of,0.22050816696914702,0.5650773195876289,,,1468,1325
418,418,4,1,28,1,5,0,884,1339,582,23,-1,,0.17770719903206292,0.5801116838487973,,,1466,1362
419,419,5,1,28,1,5,1,884,1339,32,18,96,the,0.13611615245009073,0.5790378006872853,,,916,1357
420,420,5,1,28,1,5,2,923,1339,95,23,96,encoding,0.14677858439201452,0.5801116838487973,,,1018,1362
421,421,5,1,28,1,5,3,1026,1339,47,22,96,"size,",0.1587265577737447,0.5798969072164949,,,1073,1361
422,422,5,1,28,1,5,4,1080,1339,38,18,96,and,0.16621294615849969,0.5790378006872853,,,1118,1357
423,423,5,1,28,1,5,5,1126,1339,19,18,96,the,0.17173321234119782,0.5790378006872853,,,1145,1357
424,424,5,1,28,1,5,6,1147,1339,117,23,96,efficiency,0.1823200241984271,0.5801116838487973,,,1264,1362
425,425,5,1,28,1,5,7,1271,1339,20,18,96,of,0.19373865698729584,0.5790378006872853,,,1291,1357
426,426,5,1,28,1,5,8,1299,1339,62,23,92,image,0.20114942528735633,0.5801116838487973,,,1361,1362
427,427,5,1,28,1,5,9,1369,1344,97,18,92,compres-,0.21438294010889292,0.5811855670103093,,,1466,1362
428,428,4,1,28,1,6,0,884,1372,584,23,-1,,0.17785843920145192,0.594286941580756,,,1468,1395
429,429,5,1,28,1,6,1,884,1372,41,19,95,sion,0.1367967332123412,0.5934278350515464,,,925,1391
430,430,5,1,28,1,6,2,937,1372,14,19,96,is,0.14277071990320628,0.5934278350515464,,,951,1391
431,431,5,1,28,1,6,3,962,1372,95,23,96,improved,0.15267695099818512,0.594286941580756,,,1057,1395
432,432,5,1,28,1,6,4,1068,1372,23,23,96,by,0.16326376285541438,0.594286941580756,,,1091,1395
433,433,5,1,28,1,6,5,1101,1372,81,19,96,efficient,0.17264065335753176,0.5934278350515464,,,1182,1391
434,434,5,1,28,1,6,6,1191,1372,94,23,96,encoding,0.18723532970356926,0.594286941580756,,,1285,1395
435,435,5,1,28,1,6,7,1295,1372,38,19,96,and,0.1987295825771325,0.5934278350515464,,,1333,1391
436,436,5,1,28,1,6,8,1343,1372,94,23,96,decoding,0.2102238354506957,0.594286941580756,,,1437,1395
437,437,5,1,28,1,6,9,1448,1372,20,19,96,of,0.22050816696914702,0.5934278350515464,,,1468,1391
438,438,4,1,28,1,7,0,884,1405,583,23,-1,,0.17778281911675742,0.6084621993127147,,,1467,1428
439,439,5,1,28,1,7,1,884,1405,32,18,96,the,0.13611615245009073,0.6073883161512027,,,916,1423
440,440,5,1,28,1,7,2,926,1405,127,23,96,quantization,0.14965214761040532,0.6084621993127147,,,1053,1428
441,441,5,1,28,1,7,3,1065,1406,118,22,96,parameters,0.16999395039322443,0.6086769759450171,,,1183,1428
442,442,5,1,28,1,7,4,1192,1405,60,18,96,which,0.18481548699334543,0.6073883161512027,,,1252,1423
443,443,5,1,28,1,7,5,1263,1405,71,18,96,reduce,0.19638535995160314,0.6073883161512027,,,1334,1423
444,444,5,1,28,1,7,6,1344,1405,32,18,96,the,0.205686630369026,0.6073883161512027,,,1376,1423
445,445,5,1,28,1,7,7,1388,1405,79,18,96,number,0.21589534180278283,0.6073883161512027,,,1467,1423
446,446,4,1,28,1,8,0,884,1438,582,23,-1,,0.17770719903206292,0.6226374570446735,,,1466,1461
447,447,5,1,28,1,8,1,884,1438,20,18,96,of,0.13520871143375682,0.6215635738831615,,,904,1456
448,448,5,1,28,1,8,2,913,1438,35,18,96,bits,0.14072897761645492,0.6215635738831615,,,948,1456
449,449,5,1,28,1,8,3,959,1442,106,19,96,necessary,0.1530550514216576,0.6234965635738832,,,1065,1461
450,450,5,1,28,1,8,4,1073,1438,28,18,96,for,0.16439806412583183,0.6215635738831615,,,1101,1456
451,451,5,1,28,1,8,5,1110,1438,121,23,96,transmitting,0.17702661826981247,0.6226374570446735,,,1231,1461
452,452,5,1,28,1,8,6,1242,1438,126,23,93,quantization,0.19736842105263158,0.6226374570446735,,,1368,1461
453,453,5,1,28,1,8,7,1380,1442,86,19,91,parame-,0.21521476104053236,0.6234965635738832,,,1466,1461
454,454,4,1,28,1,9,0,884,1471,44,18,-1,,0.13702359346642468,0.6357388316151202,,,928,1489
455,455,5,1,28,1,9,1,884,1471,44,18,95,ters.,0.13702359346642468,0.6357388316151202,,,928,1489
456,456,2,1,29,0,0,0,815,1578,97,32,-1,,0.13059588626739263,0.6847079037800687,,,912,1610
457,457,3,1,29,1,0,0,815,1578,97,32,-1,,0.13059588626739263,0.6847079037800687,,,912,1610
458,458,4,1,29,1,1,0,815,1578,97,32,-1,,0.13059588626739263,0.6847079037800687,,,912,1610
459,459,5,1,29,1,1,1,815,1578,62,32,90,FIG.,0.1279491833030853,0.6847079037800687,,,877,1610
460,460,5,1,29,1,1,2,894,1578,18,31,96,2,0.1365698729582577,0.6844931271477663,,,912,1609
461,461,2,1,30,0,0,0,554,1766,263,17,-1,,0.10367513611615245,0.7622422680412371,,,817,1783
462,462,3,1,30,1,0,0,554,1766,263,17,-1,,0.10367513611615245,0.7622422680412371,,,817,1783
463,463,4,1,30,1,1,0,554,1766,263,17,-1,,0.10367513611615245,0.7622422680412371,,,817,1783
464,464,5,1,30,1,1,1,554,1768,22,15,86,210,0.08545069570477919,0.7626718213058419,,,576,1783
465,465,5,1,30,1,1,2,795,1766,22,15,96,220,0.12189957652752571,0.7618127147766323,,,817,1781
466,466,2,1,31,0,0,0,702,1824,103,61,-1,,0.11395946763460375,0.7966065292096219,,,805,1885
467,467,3,1,31,1,0,0,702,1824,103,61,-1,,0.11395946763460375,0.7966065292096219,,,805,1885
468,468,4,1,31,1,1,0,726,1824,54,15,-1,,0.11388384754990925,0.7867268041237113,,,780,1839
469,469,5,1,31,1,1,1,726,1824,54,15,96,INVERSE,0.11388384754990925,0.7867268041237113,,,780,1839
470,470,4,1,31,1,2,0,702,1847,103,18,-1,,0.11395946763460375,0.7972508591065293,,,805,1865
471,471,5,1,31,1,2,1,702,1847,103,18,92,QUANTIZATION,0.11395946763460375,0.7972508591065293,,,805,1865
472,472,4,1,31,1,3,0,728,1871,57,14,-1,,0.11441318814277072,0.8067010309278351,,,785,1885
473,473,5,1,31,1,3,1,728,1871,57,14,92,MODULE,0.11441318814277072,0.8067010309278351,,,785,1885
474,474,2,1,32,0,0,0,376,1783,318,110,-1,,0.0809134906231095,0.7895189003436426,,,694,1893
475,475,3,1,32,1,0,0,376,1783,318,110,-1,,0.0809134906231095,0.7895189003436426,,,694,1893
476,476,4,1,32,1,1,0,544,1783,150,17,-1,,0.09361766485178463,0.7695446735395189,,,694,1800
477,477,5,1,32,1,1,1,544,1783,150,17,95, ,0.09361766485178463,0.7695446735395189,,,694,1800
478,478,4,1,32,1,2,0,442,1800,140,19,-1,,0.07743496672716274,0.7772766323024055,,,582,1819
479,479,5,1,32,1,2,1,442,1800,140,19,95, ,0.07743496672716274,0.7772766323024055,,,582,1819
480,480,4,1,32,1,3,0,442,1819,10,12,-1,,0.06760435571687841,0.7839347079037801,,,452,1831
481,481,5,1,32,1,3,1,442,1819,10,12,95,  ,0.06760435571687841,0.7839347079037801,,,452,1831
482,482,4,1,32,1,4,0,432,1831,20,23,-1,,0.06684815486993345,0.7914518900343642,,,452,1854
483,483,5,1,32,1,4,1,432,1831,20,23,95,  ,0.06684815486993345,0.7914518900343642,,,452,1854
484,484,4,1,32,1,5,0,376,1854,76,25,-1,,0.06261343012704174,0.8017611683848798,,,452,1879
485,485,5,1,32,1,5,1,376,1854,76,25,95,    ,0.06261343012704174,0.8017611683848798,,,452,1879
486,486,4,1,32,1,6,0,442,1879,43,14,-1,,0.07009981851179674,0.8101374570446735,,,485,1893
487,487,5,1,32,1,6,1,442,1879,43,14,95, ,0.07009981851179674,0.8101374570446735,,,485,1893
488,488,2,1,33,0,0,0,587,1807,96,39,-1,,0.09603750756200848,0.7845790378006873,,,683,1846
489,489,3,1,33,1,0,0,587,1807,96,39,-1,,0.09603750756200848,0.7845790378006873,,,683,1846
490,490,4,1,33,1,1,0,603,1807,63,15,-1,,0.09596188747731398,0.7794243986254296,,,666,1822
491,491,5,1,33,1,1,1,603,1807,63,15,96,RESIDUAL,0.09596188747731398,0.7794243986254296,,,666,1822
492,492,4,1,33,1,2,0,587,1830,96,16,-1,,0.09603750756200848,0.7895189003436426,,,683,1846
493,493,5,1,33,1,2,1,587,1830,96,16,95,INFORMATION,0.09603750756200848,0.7895189003436426,,,683,1846
494,494,2,1,34,0,0,0,543,1800,185,92,-1,,0.09611312764670296,0.7929553264604811,,,728,1892
495,495,3,1,34,1,0,0,543,1800,185,92,-1,,0.09611312764670296,0.7929553264604811,,,728,1892
496,496,4,1,34,1,1,0,684,1800,10,31,-1,,0.10420447670901391,0.7798539518900344,,,694,1831
497,497,5,1,34,1,1,1,684,1800,10,31,95,  ,0.10420447670901391,0.7798539518900344,,,694,1831
498,498,4,1,34,1,2,0,683,1831,11,23,-1,,0.10412885662431942,0.7914518900343642,,,694,1854
499,499,5,1,34,1,2,1,683,1831,11,23,95,   ,0.10412885662431942,0.7914518900343642,,,694,1854
500,500,4,1,34,1,3,0,573,1854,121,25,-1,,0.09581064730792499,0.8017611683848798,,,694,1879
501,501,5,1,34,1,3,1,573,1854,121,25,95,    ,0.09581064730792499,0.8017611683848798,,,694,1879
502,502,4,1,34,1,4,0,543,1879,185,13,-1,,0.09611312764670296,0.8099226804123711,,,728,1892
503,503,5,1,34,1,4,1,543,1879,185,13,95, ,0.09611312764670296,0.8099226804123711,,,728,1892
504,504,2,1,35,0,0,0,381,1815,48,37,-1,,0.061252268602540835,0.7875859106529209,,,429,1852
505,505,3,1,35,1,0,0,381,1815,48,37,-1,,0.061252268602540835,0.7875859106529209,,,429,1852
506,506,4,1,35,1,1,0,383,1815,42,14,-1,,0.06110102843315184,0.7826460481099656,,,425,1829
507,507,5,1,35,1,1,1,383,1815,42,14,96,INPUT,0.06110102843315184,0.7826460481099656,,,425,1829
508,508,4,1,35,1,2,0,381,1838,48,14,-1,,0.061252268602540835,0.7925257731958762,,,429,1852
509,509,5,1,35,1,2,1,381,1838,48,14,76,SIGNAL,0.061252268602540835,0.7925257731958762,,,429,1852
510,510,2,1,36,0,0,0,546,1819,41,35,-1,,0.08567755595886267,0.7888745704467354,,,587,1854
511,511,3,1,36,1,0,0,546,1819,41,35,-1,,0.08567755595886267,0.7888745704467354,,,587,1854
512,512,4,1,36,1,1,0,546,1819,39,12,-1,,0.08552631578947369,0.7839347079037801,,,585,1831
513,513,5,1,36,1,1,1,546,1819,39,12,95,  ,0.08552631578947369,0.7839347079037801,,,585,1831
514,514,4,1,36,1,2,0,573,1831,14,23,-1,,0.08771929824561403,0.7914518900343642,,,587,1854
515,515,5,1,36,1,2,1,573,1831,14,23,95,  ,0.08771929824561403,0.7914518900343642,,,587,1854
516,516,2,1,37,0,0,0,477,1826,72,60,-1,,0.07758620689655173,0.7972508591065293,,,549,1886
517,517,3,1,37,1,0,0,477,1826,72,60,-1,,0.07758620689655173,0.7972508591065293,,,549,1886
518,518,4,1,37,1,1,0,484,1826,62,14,-1,,0.0778886872353297,0.7873711340206185,,,546,1840
519,519,5,1,37,1,1,1,484,1826,62,14,92,ENTROPY,0.0778886872353297,0.7873711340206185,,,546,1840
520,520,4,1,37,1,2,0,477,1849,72,15,-1,,0.07758620689655173,0.7974656357388317,,,549,1864
521,521,5,1,37,1,2,1,477,1849,72,15,96,DECODING,0.07758620689655173,0.7974656357388317,,,549,1864
522,522,4,1,37,1,3,0,485,1872,58,14,-1,,0.07773744706594071,0.8071305841924399,,,543,1886
523,523,5,1,37,1,3,1,485,1872,58,14,94,MODULE,0.07773744706594071,0.8071305841924399,,,543,1886
524,524,2,1,38,0,0,0,537,2037,228,15,-1,,0.0984573502722323,0.8782216494845361,,,765,2052
525,525,3,1,38,1,0,0,537,2037,228,15,-1,,0.0984573502722323,0.8782216494845361,,,765,2052
526,526,4,1,38,1,1,0,537,2037,228,15,-1,,0.0984573502722323,0.8782216494845361,,,765,2052
527,527,5,1,38,1,1,1,537,2038,41,14,95,INTRA,0.08431639443436177,0.8784364261168385,,,578,2052
528,528,5,1,38,1,1,2,584,2037,78,15,96,PREDICTION,0.09422262552934059,0.8782216494845361,,,662,2052
529,529,5,1,38,1,1,3,668,2037,97,14,93,INFORMATION,0.10836358136721114,0.8780068728522337,,,765,2051
530,530,2,1,39,0,0,0,538,2173,225,16,-1,,0.0983817301875378,0.9368556701030928,,,763,2189
531,531,3,1,39,1,0,0,538,2173,225,16,-1,,0.0983817301875378,0.9368556701030928,,,763,2189
532,532,4,1,39,1,1,0,538,2173,225,16,-1,,0.0983817301875378,0.9368556701030928,,,763,2189
533,533,5,1,39,1,1,1,538,2174,38,15,96,INTER,0.08424077434966727,0.9370704467353952,,,576,2189
534,534,5,1,39,1,1,2,582,2173,79,15,95,PREDICTION,0.0939957652752571,0.9366408934707904,,,661,2188
535,535,5,1,39,1,1,3,667,2173,96,15,95,INFORMATION,0.10813672111312765,0.9366408934707904,,,763,2188
536,536,2,1,40,0,0,0,515,1897,2,297,-1,,0.0780399274047187,0.8786512027491409,,,517,2194
537,537,3,1,40,1,0,0,515,1897,2,297,-1,,0.0780399274047187,0.8786512027491409,,,517,2194
538,538,4,1,40,1,1,0,515,1897,2,297,-1,,0.0780399274047187,0.8786512027491409,,,517,2194
539,539,5,1,40,1,1,1,515,1897,2,297,95, ,0.0780399274047187,0.8786512027491409,,,517,2194
540,540,2,1,41,0,0,0,969,1764,279,34,-1,,0.1676497277676951,0.7650343642611683,,,1248,1798
541,541,3,1,41,1,0,0,969,1764,279,34,-1,,0.1676497277676951,0.7650343642611683,,,1248,1798
542,542,4,1,41,1,1,0,969,1764,279,16,-1,,0.1676497277676951,0.761168384879725,,,1248,1780
543,543,5,1,41,1,1,1,969,1766,24,14,93,230,0.1483666061705989,0.7615979381443299,,,993,1780
544,544,5,1,41,1,1,2,1225,1764,23,16,96,260,0.1870084694494858,0.761168384879725,,,1248,1780
545,545,4,1,41,1,2,0,1040,1783,15,15,-1,,0.15842407743496673,0.7691151202749141,,,1055,1798
546,546,5,1,41,1,2,1,1040,1783,15,15,77,80,0.15842407743496673,0.7691151202749141,,,1055,1798
547,547,2,1,42,0,0,0,785,1816,119,75,-1,,0.1277223230490018,0.7961769759450171,,,904,1891
548,548,3,1,42,1,0,0,785,1816,119,75,-1,,0.1277223230490018,0.7961769759450171,,,904,1891
549,549,4,1,42,1,1,0,814,1816,90,31,-1,,0.12991530550514216,0.7867268041237113,,,904,1847
550,550,5,1,42,1,1,1,814,1816,90,31,95,    ,0.12991530550514216,0.7867268041237113,,,904,1847
551,551,4,1,42,1,2,0,814,1847,55,8,-1,,0.12726860254083486,0.7951030927835051,,,869,1855
552,552,5,1,42,1,2,1,814,1847,55,8,95,  ,0.12726860254083486,0.7951030927835051,,,869,1855
553,553,4,1,42,1,3,0,814,1855,55,19,-1,,0.12726860254083486,0.8009020618556701,,,869,1874
554,554,5,1,42,1,3,1,814,1855,55,19,95,   ,0.12726860254083486,0.8009020618556701,,,869,1874
555,555,4,1,42,1,4,0,785,1874,117,17,-1,,0.12757108287961283,0.8086340206185567,,,902,1891
556,556,5,1,42,1,4,1,785,1874,117,17,95,  ,0.12757108287961283,0.8086340206185567,,,902,1891
557,557,2,1,43,0,0,0,442,1816,841,156,-1,,0.13044464609800363,0.813573883161512,,,1283,1972
558,558,3,1,43,1,0,0,442,1816,841,156,-1,,0.13044464609800363,0.813573883161512,,,1283,1972
559,559,4,1,43,1,1,0,958,1816,291,39,-1,,0.16689352692075016,0.7884450171821306,,,1249,1855
560,560,5,1,43,1,1,1,958,1816,291,39,95,       ,0.16689352692075016,0.7884450171821306,,,1249,1855
561,561,4,1,43,1,2,0,442,1893,841,79,-1,,0.13044464609800363,0.8301116838487973,,,1283,1972
562,562,5,1,43,1,2,1,442,1893,841,79,95,  ,0.13044464609800363,0.8301116838487973,,,1283,1972
563,563,2,1,44,0,0,0,1231,1826,84,28,-1,,0.1925287356321839,0.7903780068728522,,,1315,1854
564,564,3,1,44,1,0,0,1231,1826,84,28,-1,,0.1925287356321839,0.7903780068728522,,,1315,1854
565,565,4,1,44,1,1,0,1231,1826,80,21,-1,,0.19222625529340592,0.7888745704467354,,,1311,1847
566,566,5,1,44,1,1,1,1231,1826,80,21,95,    ,0.19222625529340592,0.7888745704467354,,,1311,1847
567,567,4,1,44,1,2,0,1237,1847,78,7,-1,,0.19298245614035087,0.7948883161512027,,,1315,1854
568,568,5,1,44,1,2,1,1237,1847,78,7,95, ,0.19298245614035087,0.7948883161512027,,,1315,1854
569,569,2,1,45,0,0,0,885,1823,84,61,-1,,0.14019963702359348,0.7961769759450171,,,969,1884
570,570,3,1,45,1,0,0,885,1823,84,61,-1,,0.14019963702359348,0.7961769759450171,,,969,1884
571,571,4,1,45,1,1,0,904,1823,54,15,-1,,0.14080459770114942,0.7862972508591065,,,958,1838
572,572,5,1,45,1,1,1,904,1823,54,15,96,INVERSE,0.14080459770114942,0.7862972508591065,,,958,1838
573,573,4,1,45,1,2,0,885,1846,84,15,-1,,0.14019963702359348,0.7961769759450171,,,969,1861
574,574,5,1,45,1,2,1,885,1846,84,15,93,TRANSFORM,0.14019963702359348,0.7961769759450171,,,969,1861
575,575,4,1,45,1,3,0,902,1869,58,15,-1,,0.14080459770114942,0.8060567010309279,,,960,1884
576,576,5,1,45,1,3,1,902,1869,58,15,96,MODULE,0.14080459770114942,0.8060567010309279,,,960,1884
577,577,2,1,46,0,0,0,1108,1833,123,39,-1,,0.17687537810042347,0.7957474226804123,,,1231,1872
578,578,3,1,46,1,0,0,1108,1833,123,39,-1,,0.17687537810042347,0.7957474226804123,,,1231,1872
579,579,4,1,46,1,1,0,1108,1833,123,15,-1,,0.17687537810042347,0.7905927835051546,,,1231,1848
580,580,5,1,46,1,1,1,1108,1833,123,15,96,POST-PROCESSING,0.17687537810042347,0.7905927835051546,,,1231,1848
581,581,4,1,46,1,2,0,1137,1857,58,15,-1,,0.176346037507562,0.8009020618556701,,,1195,1872
582,582,5,1,46,1,2,1,1137,1857,58,15,96,MODULE,0.176346037507562,0.8009020618556701,,,1195,1872
583,583,2,1,47,0,0,0,1237,1854,78,20,-1,,0.19298245614035087,0.8006872852233677,,,1315,1874
584,584,3,1,47,1,0,0,1237,1854,78,20,-1,,0.19298245614035087,0.8006872852233677,,,1315,1874
585,585,4,1,47,1,1,0,1237,1854,78,20,-1,,0.19298245614035087,0.8006872852233677,,,1315,1874
586,586,5,1,47,1,1,1,1237,1854,78,20,95,    ,0.19298245614035087,0.8006872852233677,,,1315,1874
587,587,2,1,48,0,0,0,967,1969,194,144,-1,,0.16091954022988506,0.8767182130584192,,,1161,2113
588,588,3,1,48,1,0,0,967,1969,194,144,-1,,0.16091954022988506,0.8767182130584192,,,1161,2113
589,589,4,1,48,1,1,0,967,1969,194,144,-1,,0.16091954022988506,0.8767182130584192,,,1161,2113
590,590,5,1,48,1,1,1,967,1969,194,144,95,    ,0.16091954022988506,0.8767182130584192,,,1161,2113
591,591,2,1,49,0,0,0,877,1950,244,64,-1,,0.15108892921960074,0.8513745704467354,,,1121,2014
592,592,3,1,49,1,0,0,877,1950,244,64,-1,,0.15108892921960074,0.8513745704467354,,,1121,2014
593,593,4,1,49,1,1,0,877,1950,78,15,-1,,0.1385359951603146,0.8408505154639175,,,955,1965
594,594,5,1,49,1,1,1,877,1950,78,15,96,PREDICTION,0.1385359951603146,0.8408505154639175,,,955,1965
595,595,4,1,49,1,2,0,894,1973,172,17,-1,,0.1482153660012099,0.851159793814433,,,1066,1990
596,596,5,1,49,1,2,1,894,1973,43,15,95,BLOCK,0.1384603750756201,0.8507302405498282,,,937,1988
597,597,5,1,49,1,2,2,1026,1976,40,14,94,INTRA,0.15819721718088325,0.8518041237113402,,,1066,1990
598,598,4,1,49,1,3,0,978,1999,143,15,-1,,0.1587265577737447,0.8618986254295533,,,1121,2014
599,599,5,1,49,1,3,1,978,1999,79,15,96,PREDICTION,0.15388687235329704,0.8618986254295533,,,1057,2014
600,600,5,1,49,1,3,2,1064,1999,57,14,96,MODULE,0.16522988505747127,0.8616838487972509,,,1121,2013
601,601,2,1,50,0,0,0,963,1972,320,193,-1,,0.16984271022383546,0.8885309278350515,,,1283,2165
602,602,3,1,50,1,0,0,963,1972,320,193,-1,,0.16984271022383546,0.8885309278350515,,,1283,2165
603,603,4,1,50,1,1,0,1121,1972,162,49,-1,,0.18179068360556563,0.8576030927835051,,,1283,2021
604,604,5,1,50,1,1,1,1121,1972,162,49,95,    ,0.18179068360556563,0.8576030927835051,,,1283,2021
605,605,4,1,50,1,2,0,1122,2021,161,111,-1,,0.18186630369026013,0.8919673539518901,,,1283,2132
606,606,5,1,50,1,2,1,1122,2021,161,111,95,   ,0.18186630369026013,0.8919673539518901,,,1283,2132
607,607,4,1,50,1,3,0,963,2132,189,33,-1,,0.1599364791288566,0.9228951890034365,,,1152,2165
608,608,5,1,50,1,3,1,963,2132,189,33,95,   ,0.1599364791288566,0.9228951890034365,,,1152,2165
609,609,2,1,51,0,0,0,1182,2047,60,37,-1,,0.18330308529945555,0.8872422680412371,,,1242,2084
610,610,3,1,51,1,0,0,1182,2047,60,37,-1,,0.18330308529945555,0.8872422680412371,,,1242,2084
611,611,4,1,51,1,1,0,1186,2047,54,14,-1,,0.18345432546884452,0.8823024054982818,,,1240,2061
612,612,5,1,51,1,1,1,1186,2047,54,14,96,PICTURE,0.18345432546884452,0.8823024054982818,,,1240,2061
613,613,4,1,51,1,2,0,1182,2069,60,15,-1,,0.18330308529945555,0.8919673539518901,,,1242,2084
614,614,5,1,51,1,2,1,1182,2069,60,15,63,MEMORY.,0.18330308529945555,0.8919673539518901,,,1242,2084
615,615,2,1,52,0,0,0,870,1945,2,188,-1,,0.13173018753781005,0.8758591065292096,,,872,2133
616,616,3,1,52,1,0,0,870,1945,2,188,-1,,0.13173018753781005,0.8758591065292096,,,872,2133
617,617,4,1,52,1,1,0,870,1945,2,188,-1,,0.13173018753781005,0.8758591065292096,,,872,2133
618,618,5,1,52,1,1,1,870,1945,2,188,95, ,0.13173018753781005,0.8758591065292096,,,872,2133
619,619,2,1,53,0,0,0,978,2113,144,37,-1,,0.1588021778584392,0.9155927835051546,,,1122,2150
620,620,3,1,53,1,0,0,978,2113,144,37,-1,,0.1588021778584392,0.9155927835051546,,,1122,2150
621,621,4,1,53,1,1,0,1027,2113,38,13,-1,,0.15819721718088325,0.9104381443298969,,,1065,2126
622,622,5,1,53,1,1,1,1027,2113,38,13,96,INTER,0.15819721718088325,0.9104381443298969,,,1065,2126
623,623,4,1,53,1,2,0,978,2135,144,15,-1,,0.1588021778584392,0.9203178694158075,,,1122,2150
624,624,5,1,53,1,2,1,978,2135,79,15,96,PREDICTION,0.15388687235329704,0.9203178694158075,,,1057,2150
625,625,5,1,53,1,2,2,1065,2135,57,15,94,MODULE,0.16538112522686024,0.9203178694158075,,,1122,2150
626,626,2,1,54,0,0,0,870,2131,97,2,-1,,0.13891409558378706,0.915807560137457,,,967,2133
627,627,3,1,54,1,0,0,870,2131,97,2,-1,,0.13891409558378706,0.915807560137457,,,967,2133
628,628,4,1,54,1,1,0,870,2131,97,2,-1,,0.13891409558378706,0.915807560137457,,,967,2133
629,629,5,1,54,1,1,1,870,2131,97,2,95, ,0.13891409558378706,0.915807560137457,,,967,2133
630,630,2,1,55,0,0,0,965,1968,3,189,-1,,0.14617362371445855,0.8859536082474226,,,968,2157
631,631,3,1,55,1,0,0,965,1968,3,189,-1,,0.14617362371445855,0.8859536082474226,,,968,2157
632,632,4,1,55,1,1,0,965,1968,3,189,-1,,0.14617362371445855,0.8859536082474226,,,968,2157
633,633,5,1,55,1,1,1,965,1968,3,189,95, ,0.14617362371445855,0.8859536082474226,,,968,2157
634,634,2,1,56,0,0,0,716,2270,259,16,-1,,0.1278735632183908,0.9785223367697594,,,975,2286
635,635,3,1,56,1,0,0,716,2270,259,16,-1,,0.1278735632183908,0.9785223367697594,,,975,2286
636,636,4,1,56,1,1,0,716,2270,259,16,-1,,0.1278735632183908,0.9785223367697594,,,975,2286
637,637,5,1,56,1,1,1,716,2270,49,12,96,Printed,0.11199334543254688,0.9776632302405498,,,765,2282
638,638,5,1,56,1,1,2,771,2270,15,16,96,by,0.1177404718693285,0.9785223367697594,,,786,2286
639,639,5,1,56,1,1,3,792,2270,45,14,96,"Jouve,",0.12318511796733213,0.9780927835051546,,,837,2284
640,640,5,1,56,1,1,4,843,2270,41,12,96,75001,0.13059588626739263,0.9776632302405498,,,884,2282
641,641,5,1,56,1,1,5,893,2270,46,12,96,PARIS,0.1385359951603146,0.9776632302405498,,,939,2282
642,642,5,1,56,1,1,6,945,2270,30,16,95,(FR),0.14519056261343014,0.9785223367697594,,,975,2286
